year,stco_code,frominstate_edu_baplus,frominstate_total,fromdiffstate_edu_baplus,fromdiffstate_total,fromabroad_edu_baplus,fromabroad_total,movein_edu_baplus,movein_total,pct_newcomer,newcomer_pct_edu_baplus
2009,01001,188,1116,584,1090,45,63,629,1153,0.0366392322603197,0.545533391153513
2009,01003,609,2600,1681,5393,165,335,1846,5728,0.0483029050891765,0.322276536312849
2009,01005,34,1449,86,475,0,1,86,476,0.0240513364660704,0.180672268907563
2009,01007,8,820,0,130,0,7,0,137,0.00945544896128097,0
2009,01009,83,1452,131,451,0,260,131,711,0.0184809731752963,0.184247538677918
2009,01011,25,136,0,86,0,0,0,86,0.012087139845397,0
2009,01013,28,119,49,131,0,27,49,158,0.0118104350426073,0.310126582278481
2009,01015,188,1502,442,1580,79,168,521,1748,0.0230269657888844,0.298054919908467
2009,01017,49,470,63,674,0,20,63,694,0.0290364419898749,0.0907780979827089
2009,01019,174,491,35,399,21,36,56,435,0.0244987609822032,0.128735632183908
2009,01021,99,869,69,244,0,49,69,293,0.0103948628800511,0.235494880546075
2009,01023,0,114,17,152,0,0,17,152,0.015578558983294,0.111842105263158
2009,01025,41,433,114,325,52,90,166,415,0.0246480964542377,0.4
2009,01027,55,323,0,168,0,21,0,189,0.0191334278193966,0
2009,01029,20,240,48,488,0,0,48,488,0.0484704012713548,0.0983606557377049
2009,01031,274,1465,544,1388,107,321,651,1709,0.0543143174956301,0.380924517261556
2009,01033,154,1077,128,930,23,57,151,987,0.0260814417461618,0.152988855116515
2009,01035,0,61,12,55,0,0,12,55,0.00625213140843469,0.218181818181818
2009,01037,0,470,0,103,0,0,0,103,0.0133074935400517,0
2009,01039,62,498,87,552,0,21,87,573,0.0226625533934504,0.151832460732984
2009,01041,6,224,2,183,0,0,2,183,0.0194950463406839,0.0109289617486339
2009,01043,164,1676,71,1079,0,119,71,1198,0.0217458387032365,0.0592654424040067
2009,01045,187,1199,523,2124,68,319,591,2443,0.0783816735112936,0.241915677445763
2009,01047,160,588,46,334,0,11,46,345,0.0127910425626576,0.133333333333333
2009,01049,102,763,147,754,0,307,147,1061,0.0231210093922291,0.138548539114043
2009,01051,534,4354,230,1126,8,109,238,1235,0.0241834416855957,0.192712550607287
2009,01053,55,667,95,601,41,209,136,810,0.0319829424307036,0.167901234567901
2009,01055,331,2105,352,1356,6,58,358,1414,0.0200832303606176,0.253182461103253
2009,01057,27,410,69,106,0,3,69,109,0.00892857142857143,0.63302752293578
2009,01059,75,488,73,399,0,73,73,472,0.02287708414114,0.154661016949153
2009,01061,78,448,0,389,4,15,4,404,0.022542126994755,0.0099009900990099
2009,01063,23,186,0,69,0,0,0,69,0.0115577889447236,0
2009,01065,36,445,26,169,0,5,26,174,0.0150727650727651,0.149425287356322
2009,01067,25,278,52,233,0,33,52,266,0.0239920627762244,0.195488721804511
2009,01069,266,1259,458,1977,53,169,511,2146,0.0330764488286067,0.2381174277726
2009,01071,88,608,74,525,0,15,74,540,0.0146858852325265,0.137037037037037
2009,01073,2716,8914,3822,8433,323,995,4145,9428,0.0213405041773335,0.439647857445906
2009,01075,18,183,46,246,0,32,46,278,0.0273030838735023,0.165467625899281
2009,01077,286,1904,245,1195,0,68,245,1263,0.0206359061499248,0.193982581155978
2009,01079,84,409,46,165,0,22,46,187,0.00804889596694357,0.245989304812834
2009,01081,513,2144,1118,2928,318,601,1436,3529,0.051207266817575,0.406914139982998
2009,01083,416,2438,140,960,13,81,153,1041,0.0206179441473559,0.146974063400576
2009,01085,109,283,46,57,0,0,46,57,0.00707283782106961,0.807017543859649
2009,01087,78,493,141,356,12,47,153,403,0.0317073170731707,0.379652605459057
2009,01089,1107,3623,3021,8069,673,1337,3694,9406,0.0455909225303301,0.392728045928131
2009,01091,95,436,66,221,0,0,66,221,0.0161008305405799,0.298642533936652
2009,01093,111,759,22,240,0,0,22,240,0.0115323626928067,0.0916666666666667
2009,01095,164,1355,344,1262,0,434,344,1696,0.0292232407471225,0.202830188679245
2009,01097,611,2462,1567,5280,209,975,1776,6255,0.0240537141934219,0.283932853717026
2009,01099,28,307,76,120,0,27,76,147,0.00987770460959548,0.517006802721088
2009,01101,801,3362,1750,4182,363,599,2113,4781,0.0337813012266124,0.441957749424807
2009,01103,279,2203,311,1076,7,84,318,1160,0.0150119059944094,0.274137931034483
2009,01105,21,81,1,40,0,0,1,40,0.00621793875330328,0.025
2009,01107,16,188,119,187,0,8,119,195,0.0149253731343284,0.61025641025641
2009,01109,17,444,139,407,45,52,184,459,0.0264355238150089,0.400871459694989
2009,01111,58,317,71,555,15,48,86,603,0.0394323829453309,0.142620232172471
2009,01113,12,435,116,1879,56,89,172,1968,0.0590689437824534,0.0873983739837398
2009,01115,307,2547,107,906,8,57,115,963,0.0182808762671324,0.119418483904465
2009,01117,2324,6272,1316,2911,148,345,1464,3256,0.0270093155593898,0.44963144963145
2009,01119,0,18,0,10,0,26,0,36,0.00438062788999757,0
2009,01121,204,1768,104,1101,23,111,127,1212,0.0224852510110942,0.104785478547855
2009,01123,215,1036,5,352,12,28,17,380,0.0134570436999788,0.0447368421052632
2009,01125,753,2777,1043,2296,473,627,1516,2923,0.0279237280039741,0.518645227505987
2009,01127,76,1048,76,517,18,41,94,558,0.0116563263771386,0.168458781362007
2009,01129,7,81,23,184,0,0,23,184,0.0162544169611307,0.125
2009,01131,16,80,4,68,0,17,4,85,0.0110432636091984,0.0470588235294118
2009,01133,73,495,72,314,0,4,72,318,0.018926318295441,0.226415094339623
2009,02013,0,18,33,487,0,47,33,534,0.238286479250335,0.0617977528089888
2009,02016,9,104,104,955,12,17,116,972,0.224066390041494,0.119341563786008
2009,02020,964,3137,3010,8227,633,1618,3643,9845,0.0568996208618458,0.370035551041138
2009,02050,59,247,99,130,0,11,99,141,0.0159142212189616,0.702127659574468
2009,02060,4,29,2,11,0,0,2,11,0.0269607843137255,0.181818181818182
2009,02068,4,11,44,96,0,15,44,111,0.0935130581297388,0.396396396396396
2009,02070,53,105,38,77,10,10,48,87,0.0315789473684211,0.551724137931034
2009,02090,188,1641,689,2921,284,599,973,3520,0.062646828504307,0.276420454545455
2009,02100,69,130,0,11,0,7,0,18,0.0102681118083286,0
2009,02105,0,32,12,12,14,14,26,26,0.0169934640522876,1
2009,02110,164,466,404,959,65,191,469,1150,0.0568631329113924,0.407826086956522
2009,02122,209,1183,326,1251,4,15,330,1266,0.036259487326364,0.260663507109005
2009,02130,0,299,70,255,0,4,70,259,0.029904168109918,0.27027027027027
2009,02150,61,399,70,620,0,7,70,627,0.080798969072165,0.111642743221691
2009,02164,6,20,10,28,0,2,10,30,0.0432276657060519,0.333333333333333
2009,02170,513,2201,443,2829,43,100,486,2929,0.0579013956430633,0.165926937521338
2009,02180,3,147,37,293,0,0,37,293,0.0587292042493486,0.126279863481229
2009,02185,34,133,105,154,10,10,115,164,0.0463276836158192,0.701219512195122
2009,02188,32,159,39,70,7,7,46,77,0.0204950758583977,0.597402597402597
2009,02195,16,117,4,66,17,17,21,83,0.0308894678079643,0.253012048192771
2009,02198,35,149,14,69,0,11,14,80,0.0220507166482911,0.175
2009,02220,14,184,125,248,20,47,145,295,0.050435971961019,0.491525423728814
2009,02230,0,13,40,51,0,20,40,71,0.102749638205499,0.563380281690141
2009,02240,35,229,89,289,8,18,97,307,0.0763301839880656,0.315960912052117
2009,02261,31,261,90,322,14,105,104,427,0.0695326494056343,0.243559718969555
2009,02270,20,105,92,127,5,5,97,132,0.0386756519191327,0.734848484848485
2009,02275,25,55,7,44,0,3,7,47,0.0333569907735983,0.148936170212766
2009,02282,9,9,0,0,0,0,0,0,0,NA
2009,02290,19,155,53,99,0,0,53,99,0.0278951817413356,0.535353535353535
2009,04001,100,739,131,828,0,95,131,923,0.0238273485298294,0.14192849404117
2009,04003,424,2439,1182,4647,255,804,1437,5451,0.0649106302916275,0.263621353880022
2009,04005,604,1889,1182,2565,104,310,1286,2875,0.0407223796033994,0.447304347826087
2009,04007,385,1615,169,753,0,64,169,817,0.0226315789473684,0.206854345165239
2009,04009,86,1356,39,556,10,102,49,658,0.0313946276062789,0.074468085106383
2009,04011,21,229,78,219,11,11,89,230,0.0476881608957081,0.38695652173913
2009,04012,2,348,49,599,3,89,52,688,0.045421535617614,0.0755813953488372
2009,04013,5284,21231,34083,97935,6513,21430,40596,119365,0.0488277894406147,0.340099694215222
2009,04015,148,2121,1360,10039,33,479,1393,10518,0.0766590138843337,0.132439627305571
2009,04017,406,3141,269,1489,88,176,357,1665,0.025752865296274,0.214414414414414
2009,04019,2106,9168,10044,25592,1844,5780,11888,31372,0.0476222281592306,0.378936631391049
2009,04021,2792,17022,2028,11474,222,1846,2250,13320,0.0685019568314245,0.168918918918919
2009,04023,62,222,41,320,59,221,100,541,0.0215092239185751,0.184842883548983
2009,04025,911,4066,2015,6470,165,433,2180,6903,0.0450569821025286,0.315804722584384
2009,04027,162,1655,890,5151,169,1280,1059,6431,0.0564296055806607,0.164671124241953
2009,05001,45,242,29,191,11,85,40,276,0.0210446054136485,0.144927536231884
2009,05003,0,228,11,85,0,8,11,93,0.00623199088655096,0.118279569892473
2009,05005,90,682,223,1732,67,100,290,1832,0.0585883782660143,0.158296943231441
2009,05007,991,3355,2328,7154,121,393,2449,7547,0.055917786701836,0.324499801245528
2009,05009,96,499,143,1028,10,19,153,1047,0.0419202434336963,0.146131805157593
2009,05011,16,68,12,61,0,33,12,94,0.0111216280170374,0.127659574468085
2009,05013,36,124,0,10,0,0,0,10,0.00273149412728763,0
2009,05015,68,474,69,494,10,20,79,514,0.0271311691739245,0.153696498054475
2009,05017,10,270,0,181,0,10,0,191,0.0232444931240112,0
2009,05019,43,333,30,762,23,38,53,800,0.0614439324116743,0.06625
2009,05021,2,131,17,296,0,7,17,303,0.0265696246930901,0.0561056105610561
2009,05023,90,992,99,590,0,0,99,590,0.0320721896064362,0.167796610169492
2009,05025,17,182,0,47,0,2,0,49,0.00847457627118644,0
2009,05027,130,328,4,255,0,17,4,272,0.0173193250557147,0.0147058823529412
2009,05029,132,449,30,315,0,24,30,339,0.0245812486404177,0.0884955752212389
2009,05031,152,1813,474,1261,39,138,513,1399,0.0236082282859988,0.366690493209435
2009,05033,57,1231,73,1305,0,0,73,1305,0.0342735581468642,0.0559386973180077
2009,05035,179,670,157,1423,0,15,157,1438,0.0453256004538864,0.109179415855355
2009,05037,28,202,46,290,0,58,46,348,0.0283018867924528,0.132183908045977
2009,05039,48,59,0,42,0,0,0,42,0.0075716603569497,0
2009,05041,0,125,0,123,0,62,0,185,0.0209726788345993,0
2009,05043,104,707,0,132,0,42,0,174,0.0143588050833471,0
2009,05045,435,2219,385,1624,29,135,414,1759,0.0295844055367745,0.235361000568505
2009,05047,61,433,6,101,3,3,9,104,0.00867823765020027,0.0865384615384615
2009,05049,59,284,2,256,0,0,2,256,0.0305744655440105,0.0078125
2009,05051,358,1478,454,2376,79,178,533,2554,0.036994655040051,0.208692247454973
2009,05053,41,517,16,133,17,67,33,200,0.0169319336268202,0.165
2009,05055,54,747,85,493,61,118,146,611,0.0227450396456092,0.238952536824877
2009,05057,131,523,43,249,0,25,43,274,0.0184115038301304,0.156934306569343
2009,05059,159,1142,81,265,16,16,97,281,0.0128786837160273,0.345195729537367
2009,05061,55,206,13,177,0,48,13,225,0.0241416309012876,0.0577777777777778
2009,05063,94,964,62,270,22,57,84,327,0.0140687518822871,0.256880733944954
2009,05065,24,387,56,463,0,4,56,467,0.0483887680033157,0.119914346895075
2009,05067,46,1521,31,271,0,2,31,273,0.0232182343936044,0.113553113553114
2009,05069,106,1819,102,933,22,98,124,1031,0.0200408202935174,0.120271580989331
2009,05071,36,460,52,179,0,21,52,200,0.0124626121635095,0.26
2009,05073,5,175,0,68,0,0,0,68,0.0130343109066513,0
2009,05075,6,282,19,198,0,2,19,200,0.0173490631505899,0.095
2009,05077,11,575,8,113,8,8,16,121,0.016738138055056,0.132231404958678
2009,05079,18,856,0,66,0,0,0,66,0.00721548048540505,0
2009,05081,37,149,28,313,0,0,28,313,0.0355399114340865,0.0894568690095847
2009,05083,33,402,51,417,0,27,51,444,0.0290728129910948,0.114864864864865
2009,05085,382,2081,275,1063,24,118,299,1181,0.029003659225423,0.253175275190517
2009,05087,60,315,105,365,0,10,105,375,0.0359229811284606,0.28
2009,05089,21,336,7,449,0,0,7,449,0.0364981303853032,0.0155902004454343
2009,05091,103,812,233,1833,0,60,233,1893,0.0660202978411746,0.123085050184892
2009,05093,22,612,103,602,104,120,207,722,0.0246172730062396,0.286703601108033
2009,05095,37,121,0,68,0,0,0,68,0.0116838487972509,0
2009,05097,26,232,72,277,0,0,72,277,0.043139697866376,0.259927797833935
2009,05099,7,125,0,106,0,0,0,106,0.0171938361719384,0
2009,05101,15,158,28,127,0,0,28,127,0.0215363744276751,0.220472440944882
2009,05103,55,412,148,320,0,2,148,322,0.01824569356301,0.459627329192547
2009,05105,25,268,0,62,0,0,0,62,0.00871031188536106,0
2009,05107,0,240,24,323,0,7,24,330,0.0246378975660744,0.0727272727272727
2009,05109,52,418,9,44,0,0,9,44,0.00597420230821453,0.204545454545455
2009,05111,69,562,2,287,9,37,11,324,0.0195310145276991,0.0339506172839506
2009,05113,112,369,31,397,13,13,44,410,0.0295900692840647,0.107317073170732
2009,05115,332,1528,153,982,17,71,170,1053,0.028075507918733,0.161443494776828
2009,05117,0,149,8,37,0,0,8,37,0.00607254226161169,0.216216216216216
2009,05119,1627,6185,2925,6983,669,964,3594,7947,0.0320967709364082,0.452246130615327
2009,05121,56,300,9,217,0,25,9,242,0.0195224265892223,0.0371900826446281
2009,05123,47,379,58,800,0,66,58,866,0.0499826849821078,0.0669745958429561
2009,05125,497,2950,600,1468,10,43,610,1511,0.0232561718894293,0.403706154864328
2009,05127,7,98,21,213,0,26,21,239,0.0329609709005654,0.0878661087866109
2009,05129,0,126,0,92,0,0,0,92,0.0157588215142172,0
2009,05131,312,1596,390,2492,55,174,445,2666,0.0338106048116067,0.166916729182296
2009,05133,4,66,0,160,0,67,0,227,0.0224042637189104,0
2009,05135,34,538,28,283,0,5,28,288,0.0223550415275945,0.0972222222222222
2009,05137,0,249,0,256,0,0,0,256,0.0297397769516729,0
2009,05139,107,540,71,582,0,11,71,593,0.0205602940156716,0.11973018549747
2009,05141,35,463,35,134,0,23,35,157,0.0133401308522389,0.222929936305732
2009,05143,1202,3835,1891,5320,140,657,2031,5977,0.0496465682650696,0.339802576543416
2009,05145,99,1804,173,1247,0,68,173,1315,0.0280103094979445,0.131558935361217
2009,05147,2,62,0,53,0,7,0,60,0.0115207373271889,0
2009,05149,69,609,0,144,0,24,0,168,0.0119445431923214,0
2009,06001,16327,35637,8348,14359,4757,10139,13105,24498,0.0247552566268664,0.534941627887991
2009,06003,3,10,3,17,0,0,3,17,0.0231292517006803,0.176470588235294
2009,06005,396,2251,62,204,0,22,62,226,0.00790237420888842,0.274336283185841
2009,06007,966,4235,613,1519,153,379,766,1898,0.0144613931091233,0.403582718651212
2009,06009,229,1219,85,304,18,66,103,370,0.0108552149039167,0.278378378378378
2009,06011,42,411,41,195,100,242,141,437,0.0347653142402546,0.322654462242563
2009,06013,10520,23456,3742,6756,2013,4509,5755,11265,0.0167901271369591,0.510874389702619
2009,06015,126,1589,96,264,26,26,122,290,0.0148649341329643,0.420689655172414
2009,06017,1844,5072,612,1519,180,496,792,2015,0.0168438827030461,0.393052109181141
2009,06019,2572,12678,1296,4555,597,2823,1893,7378,0.0141453725574404,0.256573597180808
2009,06021,74,659,21,77,0,51,21,128,0.00746442733846513,0.1640625
2009,06023,575,2618,520,1630,46,186,566,1816,0.0221406712914985,0.311674008810573
2009,06025,307,3889,341,894,156,1210,497,2104,0.0226472772676878,0.236216730038023
2009,06027,173,740,84,235,0,0,84,235,0.0192686126598885,0.357446808510638
2009,06029,2768,24872,1750,7112,448,2667,2198,9779,0.0215725766423197,0.224767358625626
2009,06031,546,7091,307,1756,43,836,350,2592,0.0297900217218908,0.135030864197531
2009,06033,376,2004,193,623,15,61,208,684,0.0152064204886508,0.304093567251462
2009,06035,219,3883,69,680,10,122,79,802,0.0327547478047784,0.0985037406483791
2009,06037,24172,66123,31884,59501,18000,46206,49884,105707,0.0168672734015128,0.471908199078585
2009,06039,617,6581,68,622,45,486,113,1108,0.0125683432019783,0.101985559566787
2009,06041,3929,9944,1325,2267,409,889,1734,3156,0.0175796263493867,0.549429657794677
2009,06043,61,602,51,295,0,18,51,313,0.0232299242986493,0.162939297124601
2009,06045,499,1318,163,772,48,139,211,911,0.0156097393807508,0.231613611416026
2009,06047,743,5012,265,1030,36,333,301,1363,0.0100024217161895,0.220836390315481
2009,06049,10,430,19,114,0,0,19,114,0.0173939578883125,0.166666666666667
2009,06051,282,928,0,248,50,100,50,348,0.0393709695666931,0.14367816091954
2009,06053,1843,8400,2397,4430,1010,2478,3407,6908,0.0277947661505778,0.493196294151708
2009,06055,641,3025,511,1056,249,770,760,1826,0.020481643915516,0.416210295728368
2009,06057,1155,2845,290,742,46,140,336,882,0.0124865507673141,0.380952380952381
2009,06059,18217,45603,11980,22170,7000,16120,18980,38290,0.0197127772672397,0.495690780882737
2009,06061,3662,12086,1327,2957,470,1020,1797,3977,0.0177222635657533,0.45184812672869
2009,06063,55,720,47,238,0,13,47,251,0.0162291478080952,0.187250996015936
2009,06065,14615,64007,5781,16106,2177,8002,7958,24108,0.0194411829219514,0.330097892815663
2009,06067,9225,32765,4434,11055,1771,5219,6205,16274,0.0183857505349424,0.38128302814305
2009,06069,98,1262,43,144,33,784,76,928,0.02774455871801,0.0818965517241379
2009,06071,8479,50577,3193,12718,1630,6473,4823,19191,0.0165884827126591,0.251315720910844
2009,06073,11309,30760,18592,41951,7532,19155,26124,61106,0.0317608822317132,0.427519392531012
2009,06075,12114,20153,9924,12679,4152,7367,14076,20046,0.0321405036724446,0.702184974558515
2009,06077,2748,15618,820,3620,359,2611,1179,6231,0.0157562945524337,0.189215214251324
2009,06079,1806,8113,798,1890,142,544,940,2434,0.0147759626533598,0.386195562859491
2009,06081,10495,21074,2543,3984,2599,4965,5142,8949,0.0183113981240485,0.574589339591016
2009,06083,2007,6367,1834,3641,586,1462,2420,5103,0.021586933623246,0.474230844601215
2009,06085,13652,26425,8468,13235,9509,16002,17977,29237,0.025352007644536,0.614871566850224
2009,06087,1771,5157,1274,2033,293,752,1567,2785,0.0177382885895354,0.562657091561939
2009,06089,662,3508,341,1134,38,279,379,1413,0.0117242924352177,0.268223637650389
2009,06091,78,146,0,13,0,0,0,13,0.00511006289308176,0
2009,06093,196,1048,241,773,17,34,258,807,0.0255914251284328,0.319702602230483
2009,06095,2725,11853,1092,2671,467,1722,1559,4393,0.016840579932377,0.354882768040064
2009,06097,2904,7721,1591,3704,369,1147,1960,4851,0.0153592370724047,0.404040404040404
2009,06099,1530,9667,823,2628,339,1594,1162,4222,0.013918329536726,0.275225011842729
2009,06101,427,2678,109,666,36,617,145,1283,0.0226570363960655,0.113016367887763
2009,06103,255,1991,63,393,0,90,63,483,0.0121268422506214,0.130434782608696
2009,06105,116,510,13,75,0,70,13,145,0.0138279610909784,0.0896551724137931
2009,06107,793,5592,266,1610,118,1028,384,2638,0.0112283509476847,0.145564821834723
2009,06109,383,4297,125,469,32,82,157,551,0.01338906033582,0.284936479128857
2009,06111,5493,14145,2200,6042,883,3066,3083,9108,0.0180747996650169,0.338493631971893
2009,06113,2285,6018,614,1512,489,885,1103,2397,0.0227167186330165,0.460158531497705
2009,06115,391,3274,108,689,114,394,222,1083,0.0257128611790403,0.204986149584488
2009,08001,3174,16106,1569,5984,320,1669,1889,7653,0.0290991912455275,0.246831307983797
2009,08003,56,333,21,231,10,31,31,262,0.0305646290247317,0.118320610687023
2009,08005,6069,18197,3835,9969,626,2161,4461,12130,0.0342133468720032,0.367765869744435
2009,08007,128,134,51,196,0,0,51,196,0.0363299351251158,0.260204081632653
2009,08009,6,24,2,34,0,10,2,44,0.015850144092219,0.0454545454545455
2009,08011,116,904,0,103,0,13,0,116,0.0247863247863248,0
2009,08013,2708,5622,4755,7140,844,1487,5599,8627,0.0472443100917833,0.649008925466559
2009,08014,1307,2892,639,1261,53,65,692,1326,0.0387549320473477,0.521870286576169
2009,08015,152,1011,180,397,0,13,180,410,0.0323624595469256,0.439024390243902
2009,08017,0,11,0,10,0,0,0,10,0.00904159132007233,0
2009,08019,124,302,105,196,20,20,125,216,0.0329821346770499,0.578703703703704
2009,08021,20,116,8,99,0,0,8,99,0.0196975726223637,0.0808080808080808
2009,08023,0,47,34,64,0,0,34,64,0.0269133725820017,0.53125
2009,08025,65,1238,3,50,8,192,11,242,0.0570351166627386,0.0454545454545455
2009,08027,0,80,26,79,13,13,39,92,0.0336626417855836,0.423913043478261
2009,08029,167,900,180,560,0,84,180,644,0.030308734939759,0.279503105590062
2009,08031,7608,22827,7596,13167,1248,3145,8844,16312,0.0410198636527092,0.542177538008828
2009,08033,0,18,0,78,0,0,0,78,0.0597701149425287,0
2009,08035,4118,9440,4721,8282,391,665,5112,8947,0.0520062544685155,0.571364703252487
2009,08037,681,1281,543,909,44,288,587,1197,0.0348837209302326,0.490392648287385
2009,08039,195,844,69,344,0,13,69,357,0.0231053006277911,0.19327731092437
2009,08041,1703,5262,7607,20286,1238,3614,8845,23900,0.0651787370051598,0.370083682008368
2009,08043,334,2083,335,1965,38,585,373,2550,0.0709891150023663,0.146274509803922
2009,08045,308,1186,401,1070,29,332,430,1402,0.0415345874685232,0.306704707560628
2009,08047,32,275,46,88,0,0,46,88,0.0228809152366095,0.522727272727273
2009,08049,63,265,49,182,75,112,124,294,0.0318561057536028,0.421768707482993
2009,08051,77,93,169,339,0,60,169,399,0.0457778797613584,0.423558897243108
2009,08053,0,0,0,0,0,0,0,0,0,NA
2009,08055,9,413,57,216,0,108,57,324,0.0551020408163265,0.175925925925926
2009,08057,3,9,0,47,0,0,0,47,0.0477157360406091,0
2009,08059,5055,17187,3924,9334,529,1174,4453,10508,0.0290631905895889,0.423772363913209
2009,08061,11,19,0,17,0,0,0,17,0.014026402640264,0
2009,08063,32,236,8,154,0,148,8,302,0.0557298394537738,0.0264900662251656
2009,08065,38,276,12,119,0,0,12,119,0.0229951690821256,0.100840336134454
2009,08067,79,483,770,1643,9,59,779,1702,0.0534312802159854,0.457696827262045
2009,08069,1618,4733,3458,7514,313,533,3771,8047,0.0456153279292557,0.468621846650926
2009,08071,46,364,56,425,0,4,56,429,0.0390106392652542,0.130536130536131
2009,08073,30,449,0,58,0,64,0,122,0.0316800830952999,0
2009,08075,173,961,74,522,2,51,76,573,0.0414107104141071,0.132635253054101
2009,08077,1115,2960,635,3185,84,232,719,3417,0.0370945329801555,0.210418495756512
2009,08079,4,40,0,6,0,0,0,6,0.00645855758880517,0
2009,08081,51,509,22,100,0,0,22,100,0.0113869278068777,0.22
2009,08083,129,391,139,536,0,0,139,536,0.0316579056169157,0.259328358208955
2009,08085,152,900,223,981,0,119,223,1100,0.0414906457453229,0.202727272727273
2009,08087,134,712,71,271,2,39,73,310,0.017855085819606,0.235483870967742
2009,08089,124,810,46,263,5,10,51,273,0.021864488226814,0.186813186813187
2009,08091,61,151,81,215,0,0,81,215,0.065052950075643,0.376744186046512
2009,08093,242,1109,94,538,19,19,113,557,0.0448398003542103,0.202872531418312
2009,08095,3,31,0,6,0,1,0,7,0.00240632519766243,0
2009,08097,23,259,383,476,110,171,493,647,0.0560027698433307,0.761978361669243
2009,08099,153,496,0,181,0,31,0,212,0.0255390916757017,0
2009,08101,432,3352,430,1924,50,338,480,2262,0.022339637548763,0.212201591511936
2009,08103,75,110,17,113,4,19,21,132,0.0334431213579934,0.159090909090909
2009,08105,22,255,20,185,17,23,37,208,0.0271753331591325,0.177884615384615
2009,08107,267,575,195,539,32,121,227,660,0.0418463099163074,0.343939393939394
2009,08109,22,238,12,50,25,93,37,143,0.0317073170731707,0.258741258741259
2009,08111,0,6,0,0,0,0,0,0,0,NA
2009,08113,75,102,291,510,5,67,296,577,0.104680696661829,0.512998266897747
2009,08115,6,82,4,19,0,0,4,19,0.0108695652173913,0.210526315789474
2009,08117,399,621,580,836,0,92,580,928,0.0505391569545801,0.625
2009,08119,175,689,180,564,19,151,199,715,0.04576,0.278321678321678
2009,08121,6,141,0,64,0,63,0,127,0.0391491985203453,0
2009,08123,1933,6314,1405,3670,37,294,1442,3964,0.0265471909134136,0.363773965691221
2009,08125,10,199,22,74,0,44,22,118,0.0186002522068096,0.186440677966102
2009,09001,1772,3850,9283,14368,2279,4614,11562,18982,0.0320351843601064,0.609103361078917
2009,09003,2801,9254,4951,9836,751,2411,5702,12247,0.020742439434177,0.465583408181595
2009,09005,1000,2935,726,1548,80,294,806,1842,0.0139692555039018,0.43756786102063
2009,09007,1119,3283,1089,2012,257,504,1346,2516,0.0219343364776036,0.534976152623211
2009,09009,3152,8886,4655,9083,1623,3176,6278,12259,0.0216515893845572,0.512113549229138
2009,09011,840,4250,1700,4857,360,1122,2060,5979,0.0333623489236332,0.344539220605452
2009,09013,735,3588,685,1474,221,304,906,1778,0.019492835451087,0.509561304836895
2009,09015,510,2441,449,1628,84,156,533,1784,0.0228612435286278,0.298766816143498
2009,10001,292,1428,664,2996,88,395,752,3391,0.0351180613090307,0.2217634915954
2009,10003,332,1671,6031,13661,952,2140,6983,15801,0.0453654124976673,0.441934054806658
2009,10005,218,1309,1769,5314,83,483,1852,5797,0.0438425992452145,0.319475590822839
2009,11001,0,0,17435,26440,3743,5148,21178,31588,0.0780831703922698,0.670444472584526
2009,12001,1609,5071,1741,2909,581,857,2322,3766,0.0296502747728597,0.616569304301646
2009,12003,82,1053,0,85,0,25,0,110,0.0067842605156038,0
2009,12005,304,2400,1314,5325,169,876,1483,6201,0.0561003854017768,0.239154975004032
2009,12007,59,1848,6,205,0,0,6,205,0.0102705410821643,0.0292682926829268
2009,12009,1846,7430,2943,10714,589,1499,3532,12213,0.0320531831411752,0.289200032751986
2009,12011,9165,31836,8986,25531,4853,13363,13839,38894,0.0322882180463362,0.3558132359747
2009,12013,54,1338,22,69,0,8,22,77,0.00822737471952132,0.285714285714286
2009,12015,864,4198,1224,4278,79,256,1303,4534,0.0365955042576375,0.287384208204676
2009,12017,495,3167,744,3448,15,237,759,3685,0.0342166839994057,0.205970149253731
2009,12019,1090,5314,1096,3236,195,616,1291,3852,0.0332217890778625,0.33515057113188
2009,12021,1075,4057,3265,7299,678,2387,3943,9686,0.0426995119929819,0.407082386950237
2009,12023,320,3204,159,1122,8,46,167,1168,0.0259942581176418,0.142979452054795
2009,12027,22,1011,61,543,24,281,85,824,0.0353997508269966,0.103155339805825
2009,12029,7,399,28,79,0,0,28,79,0.00798383021728146,0.354430379746835
2009,12031,3395,13115,5513,16806,924,2814,6437,19620,0.0356842760020516,0.328083588175331
2009,12033,926,5139,1970,7763,333,1043,2303,8806,0.0449579317105048,0.261526232114467
2009,12035,569,2254,617,3207,46,291,663,3498,0.0550614679909962,0.189536878216123
2009,12037,26,882,38,197,25,31,63,228,0.0275661951396445,0.276315789473684
2009,12039,117,2218,120,301,31,62,151,363,0.0115608777349597,0.415977961432507
2009,12041,2,508,0,92,0,49,0,141,0.0133459536204449,0
2009,12043,25,399,26,187,0,0,26,187,0.0231120998640465,0.13903743315508
2009,12045,193,1442,51,142,0,0,51,142,0.0121773432810222,0.359154929577465
2009,12047,55,984,4,294,0,0,4,294,0.0304347826086957,0.0136054421768707
2009,12049,64,846,21,355,26,277,47,632,0.0349770324865792,0.0743670886075949
2009,12051,157,1496,23,223,54,1123,77,1346,0.0579822520892565,0.0572065378900446
2009,12053,756,4812,728,4331,133,628,861,4959,0.0404146597882692,0.17362371445856
2009,12055,542,2340,222,2033,136,318,358,2351,0.0323148186329086,0.152275627392599
2009,12057,6155,19798,8631,23327,2131,5564,10762,28891,0.0377454874212193,0.372503547817659
2009,12059,40,859,62,317,0,3,62,320,0.0244162978788341,0.19375
2009,12061,639,2956,961,3047,85,278,1046,3325,0.0342529256634251,0.314586466165414
2009,12063,76,2650,67,756,14,61,81,817,0.0236256904080275,0.0991432068543452
2009,12065,59,478,12,82,0,21,12,103,0.0107001869935591,0.116504854368932
2009,12067,0,435,0,0,0,0,0,0,0,NA
2009,12069,1890,9466,1788,8242,262,996,2050,9238,0.0418037423354526,0.221909504221693
2009,12071,1899,9301,5424,17617,640,2295,6064,19912,0.0479312901393262,0.304539975893933
2009,12073,1204,4447,1569,3621,359,478,1928,4099,0.0292047251948644,0.470358624054647
2009,12075,205,1526,55,545,0,166,55,711,0.0262235827831667,0.0773558368495077
2009,12077,29,481,0,317,0,0,0,317,0.0647467320261438,0
2009,12079,95,1259,0,108,0,43,0,151,0.011898195571665,0
2009,12081,2164,6404,2619,8397,353,943,2972,9340,0.0414834554741284,0.318201284796574
2009,12083,1451,8055,1868,7527,85,650,1953,8177,0.0353561777105178,0.238840650605356
2009,12085,799,3790,1047,3462,254,532,1301,3994,0.0384963855421687,0.325738607911868
2009,12086,5034,20150,7989,19439,6928,24139,14917,43578,0.0263855310074492,0.342305750608105
2009,12087,326,1254,777,2222,43,349,820,2571,0.0450428353685243,0.318942045896538
2009,12089,225,1391,395,1199,74,107,469,1306,0.0276431368398772,0.359111791730475
2009,12091,575,2155,1611,5640,423,1259,2034,6899,0.0584007720177429,0.294825337005363
2009,12093,11,956,108,824,20,422,128,1246,0.0474052655607974,0.102728731942215
2009,12095,6743,23742,6514,18691,2529,8158,9043,26849,0.0391261073392236,0.336809564602034
2009,12097,1721,7867,1299,5617,362,1827,1661,7444,0.0461091530756985,0.223132724341752
2009,12099,5692,18122,10238,26356,2192,7364,12430,33720,0.0373963200335369,0.368623962040332
2009,12101,4799,17374,2546,11817,314,1479,2860,13296,0.0407613943977608,0.215102286401925
2009,12103,3715,12277,5985,19045,1745,4866,7730,23911,0.0353210893980599,0.323282171385555
2009,12105,2365,11860,2446,11862,660,2432,3106,14294,0.0375904653706976,0.217293969497691
2009,12107,239,1741,136,987,0,192,136,1179,0.0236414678163224,0.115351993214589
2009,12109,1525,5328,2756,5394,193,635,2949,6029,0.0493658344864856,0.489135843423453
2009,12111,1076,7313,1068,4991,447,890,1515,5881,0.0329023559228157,0.257609250127529
2009,12113,825,3879,1384,5102,417,834,1801,5936,0.0599680762936173,0.303402964959569
2009,12115,1800,6726,4007,10572,474,1497,4481,12069,0.0424049498793098,0.371281796337725
2009,12117,3924,13010,2594,7254,735,1685,3329,8939,0.032731480294836,0.372413021590782
2009,12119,105,2616,895,3117,158,650,1053,3767,0.0649370798138252,0.279532784709318
2009,12121,163,1719,46,414,0,0,46,414,0.0153123497429449,0.111111111111111
2009,12123,50,950,68,230,18,18,86,248,0.0177294824134973,0.346774193548387
2009,12125,64,1602,18,172,1,11,19,183,0.0180830039525692,0.103825136612022
2009,12127,2209,8748,1871,9743,459,1722,2330,11465,0.032354011869252,0.203227213257741
2009,12129,105,1970,75,218,0,0,75,218,0.0102951593860685,0.344036697247706
2009,12131,429,2890,648,1743,58,237,706,1980,0.0522234530780187,0.356565656565657
2009,12133,88,905,36,300,0,0,36,300,0.0187090739008419,0.12
2009,13001,0,134,0,57,0,0,0,57,0.0049547983310153,0
2009,13003,36,147,0,41,22,22,22,63,0.0132492113564669,0.349206349206349
2009,13005,10,525,9,175,0,0,9,175,0.025263461816082,0.0514285714285714
2009,13007,0,10,0,0,0,0,0,0,0,NA
2009,13009,175,1629,100,282,10,55,110,337,0.0119135998868738,0.326409495548961
2009,13011,110,591,15,95,0,47,15,142,0.0129020534254043,0.105633802816901
2009,13013,334,2611,62,734,0,86,62,820,0.0195624686881218,0.075609756097561
2009,13015,246,2396,196,1187,15,123,211,1310,0.0222414642014296,0.161068702290076
2009,13017,80,343,10,285,0,18,10,303,0.0272090517241379,0.033003300330033
2009,13019,0,489,32,305,0,38,32,343,0.0315925209542231,0.0932944606413994
2009,13021,579,3967,731,1863,104,235,835,2098,0.0213795844330538,0.397998093422307
2009,13023,39,186,0,27,0,12,0,39,0.00527811611855461,0
2009,13025,32,455,0,212,0,0,0,212,0.020988020988021,0
2009,13027,163,631,12,85,0,51,12,136,0.0126723816623183,0.0882352941176471
2009,13029,356,1052,322,841,111,169,433,1010,0.0547158567636383,0.428712871287129
2009,13031,274,1330,98,624,0,37,98,661,0.0201764292909252,0.148260211800303
2009,13033,37,495,0,124,0,0,0,124,0.00905373831775701,0
2009,13035,77,2032,9,73,0,24,9,97,0.00607731345153812,0.0927835051546392
2009,13037,22,641,11,44,0,0,11,44,0.0104811815150071,0.25
2009,13039,118,650,304,1246,54,176,358,1422,0.0516339869281046,0.251758087201125
2009,13043,0,188,28,96,0,0,28,96,0.0148606811145511,0.291666666666667
2009,13045,398,2535,409,1984,21,426,430,2410,0.0346588049183864,0.178423236514523
2009,13047,161,1036,435,1650,0,49,435,1699,0.0407277783104804,0.256032960565038
2009,13049,10,334,15,219,0,0,15,219,0.0307411566535654,0.0684931506849315
2009,13051,864,3816,2601,5606,280,843,2881,6449,0.0402273039160647,0.446735928050861
2009,13053,126,458,1242,2430,244,824,1486,3254,0.452887961029923,0.456668715427167
2009,13055,68,760,0,204,0,8,0,212,0.0117823598065915,0
2009,13057,1646,5842,1465,3523,137,614,1602,4137,0.0320511330621732,0.38723712835388
2009,13059,829,2056,911,1456,188,345,1099,1801,0.0327430732310377,0.610216546363132
2009,13061,0,62,31,43,0,0,31,43,0.0196167883211679,0.720930232558139
2009,13063,2133,11385,879,5893,187,866,1066,6759,0.0417018861172638,0.157715638408049
2009,13065,48,115,0,0,0,71,0,71,0.0161180476730988,0
2009,13067,8505,20403,7278,16858,1500,2984,8778,19842,0.0446210516373646,0.442394919866949
2009,13069,56,565,53,255,0,17,53,272,0.010793222491171,0.194852941176471
2009,13071,137,1154,27,436,41,116,68,552,0.0197354308187344,0.123188405797101
2009,13073,621,2652,955,2109,136,412,1091,2521,0.0368034569847735,0.432764775882586
2009,13075,46,417,53,83,0,0,53,83,0.00791833619538256,0.63855421686747
2009,13077,597,3224,728,2367,47,466,775,2833,0.0369814374853145,0.273561595481821
2009,13079,10,354,0,6,0,0,0,6,0.000717102904266762,0
2009,13081,0,349,14,376,0,0,14,376,0.0272069464544139,0.0372340425531915
2009,13083,9,239,41,329,47,47,88,376,0.0366614664586583,0.234042553191489
2009,13085,202,1353,69,457,0,43,69,500,0.0344922737306843,0.138
2009,13087,31,681,154,361,8,9,162,370,0.0204770601582821,0.437837837837838
2009,13089,10315,28660,6641,15229,2013,4137,8654,19366,0.0398849133039644,0.446865640813797
2009,13091,58,463,37,68,0,15,37,83,0.0066151271220212,0.44578313253012
2009,13093,10,551,0,32,0,0,0,32,0.00408997955010225,0
2009,13095,371,2457,268,1406,48,351,316,1757,0.0303244735933725,0.179852020489471
2009,13097,1117,6055,778,3358,37,114,815,3472,0.0456235791908122,0.234735023041475
2009,13099,29,98,0,0,0,0,0,0,0,NA
2009,13101,0,112,0,0,0,0,0,0,0,NA
2009,13103,229,1392,45,728,48,89,93,817,0.0260199369406669,0.113831089351285
2009,13105,36,446,30,93,0,14,30,107,0.00781820838813386,0.280373831775701
2009,13107,21,616,2,248,0,0,2,248,0.0174389986639477,0.00806451612903226
2009,13109,12,479,0,35,0,46,0,81,0.0115664715122091,0
2009,13111,86,345,54,171,0,36,54,207,0.0125996713129223,0.260869565217391
2009,13113,877,2765,1093,2347,144,248,1237,2595,0.038447292392029,0.476685934489403
2009,13115,228,1497,482,1101,42,378,524,1479,0.0240241703620681,0.354293441514537
2009,13117,2732,5538,1345,2707,262,471,1607,3178,0.0315368508797174,0.505663939584644
2009,13119,32,385,29,111,0,44,29,155,0.0107014636840652,0.187096774193548
2009,13121,11826,28452,12907,25296,3227,5618,16134,30914,0.0475824735682853,0.521899463026461
2009,13123,86,632,23,316,6,108,29,424,0.0216459056565244,0.0683962264150943
2009,13125,12,51,0,47,2,7,2,54,0.029379760609358,0.037037037037037
2009,13127,380,1789,579,1523,117,234,696,1757,0.035472018089316,0.396129766647695
2009,13129,136,910,62,600,0,17,62,617,0.0185435638505695,0.100486223662885
2009,13131,137,701,66,215,13,59,79,274,0.0173802727561053,0.288321167883212
2009,13133,184,471,2,179,0,0,2,179,0.0160509325681492,0.0111731843575419
2009,13135,5545,17875,5949,16970,1161,3174,7110,20144,0.0426856531366877,0.352958697378872
2009,13137,115,1279,119,368,0,23,119,391,0.0147820498279838,0.304347826086957
2009,13139,870,4282,748,1907,111,542,859,2449,0.022082559376747,0.35075541037158
2009,13141,0,329,0,63,0,0,0,63,0.0102991662579696,0
2009,13143,7,1162,0,353,0,0,0,353,0.0189581095596133,0
2009,13145,179,1109,261,624,7,42,268,666,0.0341398400656141,0.402402402402402
2009,13147,86,912,7,142,0,0,7,142,0.00852392100366168,0.0492957746478873
2009,13149,0,510,34,123,0,18,34,141,0.0188755020080321,0.24113475177305
2009,13151,1339,6655,900,3778,158,394,1058,4172,0.0371035733978407,0.2535953978907
2009,13153,974,2771,588,2681,49,254,637,2935,0.0360436699455968,0.217035775127768
2009,13155,50,680,0,341,0,196,0,537,0.0756977727657175,0
2009,13157,411,2593,135,629,28,38,163,667,0.0173026537653376,0.244377811094453
2009,13159,21,333,67,155,0,39,67,194,0.0220579874928937,0.345360824742268
2009,13161,42,419,6,31,20,20,26,51,0.00607432110528823,0.509803921568627
2009,13163,3,273,9,79,0,0,9,79,0.00752667682926829,0.113924050632911
2009,13165,0,102,0,0,0,0,0,0,0,NA
2009,13167,0,610,0,89,0,9,0,98,0.0157835400225479,0
2009,13169,153,756,20,222,25,25,45,247,0.0136471628266755,0.182186234817814
2009,13171,40,578,0,95,0,51,0,146,0.0132944818794391,0
2009,13173,3,341,0,53,0,26,0,79,0.0157905256845892,0
2009,13175,130,780,41,351,0,38,41,389,0.0127020408163265,0.105398457583548
2009,13177,77,1370,37,445,13,64,50,509,0.024797817402319,0.0982318271119843
2009,13179,189,1285,519,2670,146,1174,665,3844,0.125069139417602,0.172996878251821
2009,13181,15,120,0,51,0,0,0,51,0.0091611280761631,0
2009,13183,0,546,81,463,0,42,81,505,0.0798292760037939,0.16039603960396
2009,13185,243,1672,684,2056,42,281,726,2337,0.0408702191287316,0.310654685494223
2009,13187,138,1140,66,390,0,106,66,496,0.0294571801876707,0.133064516129032
2009,13189,85,623,19,229,0,68,19,297,0.0214285714285714,0.063973063973064
2009,13191,0,353,24,62,0,0,24,62,0.00841590878240804,0.387096774193548
2009,13193,12,460,6,32,0,19,6,51,0.00586813945460822,0.117647058823529
2009,13195,166,990,29,72,0,15,29,87,0.00471800433839479,0.333333333333333
2009,13197,4,114,14,65,0,49,14,114,0.0251433612704014,0.12280701754386
2009,13199,50,465,38,133,0,21,38,154,0.0102783154241474,0.246753246753247
2009,13201,2,162,14,57,0,3,14,60,0.0145243282498184,0.233333333333333
2009,13205,60,697,27,80,0,11,27,91,0.00593413759373981,0.296703296703297
2009,13207,170,942,65,174,0,12,65,186,0.0114033474342468,0.349462365591398
2009,13209,95,260,0,40,6,6,6,46,0.00838497994896099,0.130434782608696
2009,13211,138,631,12,116,0,0,12,116,0.00956937799043062,0.103448275862069
2009,13213,36,686,25,273,0,8,25,281,0.0109410894365923,0.0889679715302491
2009,13215,406,2740,1437,6225,282,976,1719,7201,0.0633361185628216,0.238716844882655
2009,13217,588,3510,284,1318,9,186,293,1504,0.0259776150338538,0.194813829787234
2009,13219,456,837,163,395,12,37,175,432,0.0219959266802444,0.405092592592593
2009,13221,53,292,0,21,0,0,0,21,0.00226512781792687,0
2009,13223,435,4158,347,1805,17,35,364,1840,0.0237067577143593,0.197826086956522
2009,13225,197,816,99,407,0,0,99,407,0.0258166825245798,0.243243243243243
2009,13227,181,796,84,343,0,28,84,371,0.0175471787352788,0.226415094339623
2009,13229,0,645,3,239,0,6,3,245,0.0209598768072547,0.0122448979591837
2009,13231,42,762,0,52,0,36,0,88,0.00807339449541284,0
2009,13233,50,887,29,285,0,20,29,305,0.0114429353943123,0.0950819672131148
2009,13235,11,342,0,61,0,0,0,61,0.00892595844307872,0
2009,13237,112,507,123,267,0,0,123,267,0.0187407875342177,0.460674157303371
2009,13239,0,0,0,44,0,0,0,44,0.0254777070063694,0
2009,13241,75,247,125,331,0,33,125,364,0.0306500505220613,0.343406593406593
2009,13243,0,53,18,18,0,0,18,18,0.00383549968037503,1
2009,13245,902,3772,929,4312,462,1344,1391,5656,0.0463674968437966,0.245933521923621
2009,13247,457,3332,358,1598,86,382,444,1980,0.0389572060993605,0.224242424242424
2009,13249,5,104,0,25,0,0,0,25,0.00957487552661815,0
2009,13251,74,285,0,104,7,7,7,111,0.0115312694784957,0.0630630630630631
2009,13253,18,161,5,80,0,35,5,115,0.0195378865103636,0.0434782608695652
2009,13255,166,2005,93,443,14,80,107,523,0.0129336993347677,0.204588910133843
2009,13257,80,612,47,228,0,17,47,245,0.0144936109796498,0.191836734693878
2009,13259,0,60,8,46,0,0,8,46,0.0156196943972835,0.173913043478261
2009,13261,175,730,102,229,10,59,112,288,0.0144658194786278,0.388888888888889
2009,13263,7,215,0,4,0,0,0,4,0.000879120879120879,0
2009,13265,12,80,0,0,0,0,0,0,0,NA
2009,13267,114,1424,56,251,17,32,73,283,0.0187952447366673,0.257950530035336
2009,13269,8,419,0,0,0,0,0,0,0,NA
2009,13271,0,141,10,200,0,51,10,251,0.0268047842802221,0.0398406374501992
2009,13273,0,241,0,92,0,0,0,92,0.0137580379841483,0
2009,13275,215,1013,85,792,117,141,202,933,0.0314968604415637,0.216505894962487
2009,13277,123,1078,108,534,121,343,229,877,0.0342859376832558,0.261117445838084
2009,13279,125,564,58,314,9,116,67,430,0.0246856880417934,0.155813953488372
2009,13281,54,189,28,190,0,0,28,190,0.0234915924826904,0.147368421052632
2009,13283,27,254,0,122,0,5,0,127,0.0275189599133261,0
2009,13285,132,1231,148,971,94,130,242,1101,0.0275622089821259,0.219800181653043
2009,13287,0,155,0,221,0,0,0,221,0.0380182349905384,0
2009,13289,0,38,0,102,0,32,0,134,0.0200688932155159,0
2009,13291,95,489,69,529,0,23,69,552,0.0350810295519542,0.125
2009,13293,115,786,78,284,0,47,78,331,0.0182038167519111,0.235649546827795
2009,13295,83,1413,217,1470,7,25,224,1495,0.0342434376288424,0.149832775919732
2009,13297,554,3448,154,667,15,65,169,732,0.0137395123599302,0.230874316939891
2009,13299,64,840,150,672,0,49,150,721,0.0307331628303495,0.208044382801664
2009,13301,14,122,0,7,0,0,0,7,0.00177935943060498,0
2009,13303,52,532,27,78,0,0,27,78,0.00577051120810831,0.346153846153846
2009,13305,75,820,53,661,0,74,53,735,0.0388806601777402,0.072108843537415
2009,13307,5,66,0,91,0,0,0,91,0.0614449696151249,0
2009,13309,89,526,0,13,0,11,0,24,0.0048810250152532,0
2009,13311,56,287,44,150,0,0,44,150,0.00882041632365048,0.293333333333333
2009,13313,147,1297,192,1043,158,243,350,1286,0.022699992939349,0.272161741835148
2009,13315,2,435,12,37,0,30,12,67,0.0109441359032996,0.17910447761194
2009,13317,58,207,11,54,0,0,11,54,0.00759600506400338,0.203703703703704
2009,13319,8,199,25,32,0,24,25,56,0.00864197530864197,0.446428571428571
2009,13321,63,443,66,295,0,0,66,295,0.0210368680025672,0.223728813559322
2009,15001,327,980,1321,4219,162,518,1483,4737,0.0405710957707395,0.313067342199704
2009,15003,472,1803,8811,21797,3077,8596,11888,30393,0.0499893912554339,0.391142697331622
2009,15005,0,6,0,0,0,0,0,0,0,NA
2009,15007,153,396,495,1210,82,331,577,1541,0.0356952583910495,0.374432186891629
2009,15009,243,1093,1479,3547,221,674,1700,4221,0.0432785473336683,0.402748163942194
2009,16001,1391,6349,4207,10432,659,1656,4866,12088,0.050584601993589,0.402547981469226
2009,16003,60,135,19,81,0,0,19,81,0.0318146111547526,0.234567901234568
2009,16005,225,1163,405,1346,135,166,540,1512,0.0334779913205208,0.357142857142857
2009,16007,3,49,17,111,6,7,23,118,0.0317545748116254,0.194915254237288
2009,16009,0,153,17,162,0,0,17,162,0.0259075643691028,0.104938271604938
2009,16011,71,740,63,496,0,18,63,514,0.0205427440949602,0.122568093385214
2009,16013,41,244,332,730,41,202,373,932,0.0625503355704698,0.400214592274678
2009,16015,18,125,4,116,0,0,4,116,0.0219489120151372,0.0344827586206897
2009,16017,153,356,184,1154,26,88,210,1242,0.0431294926554849,0.169082125603865
2009,16019,375,2050,541,1696,118,232,659,1928,0.0338530692512993,0.341804979253112
2009,16021,133,276,0,245,0,0,0,245,0.0343473994111874,0
2009,16023,5,96,0,51,0,0,0,51,0.0263565891472868,0
2009,16025,7,10,0,15,0,0,0,15,0.0215208034433286,0
2009,16027,730,3791,740,3524,101,767,841,4291,0.0410009937318453,0.195991610347238
2009,16029,0,112,38,93,0,0,38,93,0.0208801077682982,0.408602150537634
2009,16031,85,468,31,265,0,21,31,286,0.0236344103793075,0.108391608391608
2009,16033,0,6,0,11,0,0,0,11,0.0170278637770898,0
2009,16035,17,291,18,148,0,16,18,164,0.0262820512820513,0.109756097560976
2009,16037,82,145,31,49,0,4,31,53,0.0183963901423117,0.584905660377358
2009,16039,60,275,104,868,53,307,157,1175,0.0703803533992213,0.133617021276596
2009,16041,12,45,29,406,25,62,54,468,0.0666192170818505,0.115384615384615
2009,16043,43,164,82,172,0,54,82,226,0.0303233597209178,0.36283185840708
2009,16045,52,495,63,459,0,0,63,459,0.0416515426497278,0.137254901960784
2009,16047,54,196,19,92,0,21,19,113,0.0128074351127734,0.168141592920354
2009,16049,68,401,63,240,10,10,73,250,0.0230223777511741,0.292
2009,16051,162,727,42,267,2,15,44,282,0.0220140515222482,0.156028368794326
2009,16053,66,402,3,172,0,19,3,191,0.0162885894593212,0.0157068062827225
2009,16055,218,1002,1211,4154,68,149,1279,4303,0.048314114727777,0.297234487566814
2009,16057,216,696,544,1196,8,9,552,1205,0.0620845999278685,0.458091286307054
2009,16059,106,240,35,74,0,0,35,74,0.0134057971014493,0.472972972972973
2009,16061,12,141,5,63,0,7,5,70,0.0267686424474187,0.0714285714285714
2009,16063,2,92,9,36,0,6,9,42,0.0155440414507772,0.214285714285714
2009,16065,36,321,160,526,2,49,162,575,0.045609581978266,0.281739130434783
2009,16067,12,391,38,168,0,10,38,178,0.0154890358510268,0.213483146067416
2009,16069,170,680,323,1247,28,39,351,1286,0.04836950389288,0.27293934681182
2009,16071,21,87,26,113,0,0,26,113,0.0441233893010543,0.230088495575221
2009,16073,10,421,0,157,0,16,0,173,0.0249963878052305,0
2009,16075,30,466,83,585,0,73,83,658,0.0462176020228981,0.126139817629179
2009,16077,1,121,26,47,3,3,29,50,0.0110448420587586,0.58
2009,16079,14,189,23,378,0,7,23,385,0.0413533834586466,0.0597402597402597
2009,16081,41,58,177,350,10,20,187,370,0.0683161004431315,0.505405405405405
2009,16083,184,975,209,1194,5,353,214,1547,0.0336765570237499,0.138332255979315
2009,16085,84,297,89,244,6,6,95,250,0.0400512656199936,0.38
2009,16087,17,204,43,320,0,9,43,329,0.0479102956167176,0.130699088145897
2009,17001,134,668,166,806,68,80,234,886,0.0195796777971758,0.26410835214447
2009,17003,49,214,0,114,0,13,0,127,0.0230825154489277,0
2009,17005,127,487,51,176,0,0,51,176,0.0150298889837746,0.289772727272727
2009,17007,221,1405,212,595,0,24,212,619,0.018976088289393,0.34248788368336
2009,17009,22,1033,1,79,0,0,1,79,0.0169382504288165,0.0126582278481013
2009,17011,151,749,14,113,17,48,31,161,0.00677238884448744,0.192546583850932
2009,17013,27,78,5,5,0,10,5,15,0.00418060200668896,0.333333333333333
2009,17015,37,427,12,69,0,68,12,137,0.012021762021762,0.0875912408759124
2009,17017,68,453,9,93,0,132,9,225,0.0252865812542144,0.04
2009,17019,866,2235,1399,2768,853,1087,2252,3855,0.0383250320617972,0.584176394293126
2009,17021,149,1132,19,176,0,14,19,190,0.00800438134557863,0.1
2009,17023,27,275,77,156,0,27,77,183,0.0157826649417853,0.420765027322404
2009,17025,68,205,0,10,0,0,0,10,0.00105518624037143,0
2009,17027,159,1259,109,320,6,67,115,387,0.0156826194432062,0.297157622739018
2009,17029,133,1049,55,486,11,12,66,498,0.0175810209701334,0.132530120481928
2009,17031,11751,27818,30276,51768,10983,23960,41259,75728,0.0219175100726831,0.544831502218466
2009,17033,62,313,16,409,42,45,58,454,0.0339363133502766,0.127753303964758
2009,17035,64,350,2,64,0,0,2,64,0.00873720136518771,0.03125
2009,17037,793,2854,429,1079,52,271,481,1350,0.0245129192163129,0.356296296296296
2009,17039,97,546,27,121,0,0,27,121,0.0108940307913928,0.223140495867769
2009,17041,79,423,6,99,0,15,6,114,0.00901756051257712,0.0526315789473684
2009,17043,8787,20524,5739,10344,1427,3076,7166,13420,0.0221327602784572,0.53397913561848
2009,17045,51,288,37,197,7,7,44,204,0.0155062328975372,0.215686274509804
2009,17047,30,125,0,30,0,0,0,30,0.00643224699828473,0
2009,17049,75,381,59,164,0,8,59,172,0.00772998966338592,0.343023255813953
2009,17051,4,175,97,263,0,1,97,264,0.0184460592509782,0.367424242424242
2009,17053,94,469,26,115,0,2,26,117,0.0124124761298536,0.222222222222222
2009,17055,77,679,67,400,31,56,98,456,0.0166831302820766,0.214912280701754
2009,17057,69,1082,5,341,0,21,5,362,0.0138294621026895,0.0138121546961326
2009,17059,20,68,28,88,0,0,28,88,0.0205896116050538,0.318181818181818
2009,17061,15,248,12,57,0,6,12,63,0.00673364685763147,0.19047619047619
2009,17063,207,1548,107,348,25,54,132,402,0.0133364296851674,0.328358208955224
2009,17065,0,145,19,62,0,0,19,62,0.0107826086956522,0.306451612903226
2009,17067,57,183,85,297,3,6,88,303,0.0231227106227106,0.29042904290429
2009,17069,0,72,4,36,0,0,4,36,0.0110091743119266,0.111111111111111
2009,17071,19,96,0,26,0,0,0,26,0.0046973803071364,0
2009,17073,198,849,112,691,3,28,115,719,0.0212269721303732,0.159944367176634
2009,17075,125,932,55,253,19,19,74,272,0.0132942326490714,0.272058823529412
2009,17077,284,1099,369,740,106,212,475,952,0.0312736112479879,0.498949579831933
2009,17079,30,367,0,39,0,0,0,39,0.00592525068368277,0
2009,17081,98,950,147,488,10,75,157,563,0.0203793527836096,0.27886323268206
2009,17083,105,407,98,195,0,0,98,195,0.0130592017144388,0.502564102564103
2009,17085,83,231,42,305,0,19,42,324,0.0201643017176998,0.12962962962963
2009,17087,62,1438,33,121,0,0,33,121,0.0125168097651805,0.272727272727273
2009,17089,4053,14002,1385,3550,434,2269,1819,5819,0.0191909397920954,0.312596666093831
2009,17091,678,2788,101,906,50,123,151,1029,0.0145629006920562,0.146744412050535
2009,17093,1432,3946,446,1215,118,292,564,1507,0.02592286785702,0.374253483742535
2009,17095,143,1081,140,399,8,56,148,455,0.0126924793572863,0.325274725274725
2009,17097,5442,10966,3748,8775,1299,2868,5047,11643,0.0266688961372132,0.433479343811732
2009,17099,592,1910,226,816,16,80,242,896,0.0118535765786027,0.270089285714286
2009,17101,39,827,5,149,0,7,5,156,0.0133882595262616,0.032051282051282
2009,17103,166,968,102,239,33,45,135,284,0.0117954894712796,0.475352112676056
2009,17105,156,1756,23,260,0,48,23,308,0.0119333591631151,0.0746753246753247
2009,17107,115,1669,64,196,0,30,64,226,0.0114430379746835,0.283185840707965
2009,17109,158,583,90,118,59,99,149,217,0.0130322503152964,0.686635944700461
2009,17111,2263,6182,959,2245,69,516,1028,2761,0.0137313314070014,0.372328866352771
2009,17113,1028,2550,992,1512,326,471,1318,1983,0.0213971254693772,0.664649520927887
2009,17115,442,1568,344,992,176,214,520,1206,0.0164718094405594,0.431177446102819
2009,17117,171,1006,83,311,39,54,122,365,0.0111006356254372,0.334246575342466
2009,17119,490,2888,1114,3106,84,176,1198,3282,0.0183430861320233,0.365021328458257
2009,17121,103,654,51,294,0,13,51,307,0.0114143367043427,0.166123778501629
2009,17123,62,330,25,49,15,23,40,72,0.00797253903222235,0.555555555555556
2009,17125,32,260,0,49,0,2,0,51,0.00488178424428065,0
2009,17127,35,139,74,338,0,9,74,347,0.0329003508106571,0.213256484149856
2009,17129,101,367,9,64,0,12,9,76,0.00888577107447679,0.118421052631579
2009,17131,42,179,0,65,4,4,4,69,0.00602094240837696,0.0579710144927536
2009,17133,166,559,103,560,0,0,103,560,0.0258887707456891,0.183928571428571
2009,17135,65,1028,99,312,4,13,103,325,0.015665670490697,0.316923076923077
2009,17137,70,1069,39,239,0,43,39,282,0.0118437631247375,0.138297872340426
2009,17139,106,387,14,38,0,0,14,38,0.00390464447184546,0.368421052631579
2009,17141,254,1170,79,517,3,26,82,543,0.0149413901271256,0.151012891344383
2009,17143,681,3095,952,2103,297,438,1249,2541,0.0212394262596543,0.491538764266037
2009,17145,25,1094,15,56,0,25,15,81,0.00523019306515142,0.185185185185185
2009,17147,150,362,35,68,0,23,35,91,0.00793720017444396,0.384615384615385
2009,17149,13,344,19,263,0,7,19,270,0.0236800561305034,0.0703703703703704
2009,17151,6,34,0,141,0,0,0,141,0.0489753386592567,0
2009,17153,17,147,0,40,0,3,0,43,0.01002331002331,0
2009,17155,14,162,0,10,0,9,0,19,0.00458937198067633,0
2009,17157,78,1621,0,132,0,5,0,137,0.00587277091906721,0
2009,17159,21,117,12,164,57,57,69,221,0.0203386710841156,0.312217194570136
2009,17161,294,1976,743,2412,186,373,929,2785,0.0279553918271885,0.333572710951526
2009,17163,760,3336,1331,4134,354,728,1685,4862,0.0288604228746453,0.346565199506376
2009,17165,23,344,7,43,0,4,7,47,0.00265656794031201,0.148936170212766
2009,17167,863,3533,686,1902,85,282,771,2184,0.0166345502045044,0.353021978021978
2009,17169,5,150,0,22,0,0,0,22,0.00448796409628723,0
2009,17171,30,131,10,10,0,0,10,10,0.00273822562979189,1
2009,17173,31,354,35,66,0,31,35,97,0.00639124991763853,0.360824742268041
2009,17175,27,128,6,43,6,6,12,49,0.0116417201235448,0.244897959183673
2009,17177,177,592,102,471,0,10,102,481,0.0149820900171313,0.212058212058212
2009,17179,1037,3312,356,1253,41,103,397,1356,0.0150678386096696,0.292772861356932
2009,17181,40,344,13,163,12,35,25,198,0.0156237670638365,0.126262626262626
2009,17183,181,843,92,760,39,136,131,896,0.016494238061927,0.146205357142857
2009,17185,0,264,46,114,0,28,46,142,0.0168266382272781,0.323943661971831
2009,17187,75,331,54,121,0,0,54,121,0.0106177606177606,0.446280991735537
2009,17189,75,329,9,41,0,12,9,53,0.00524285290335345,0.169811320754717
2009,17191,0,246,0,87,0,8,0,95,0.00826733965712297,0
2009,17193,42,170,12,136,18,18,30,154,0.0144046394163315,0.194805194805195
2009,17195,34,790,61,535,0,6,61,541,0.0134818580542265,0.11275415896488
2009,17197,5091,16789,2219,4770,513,1570,2732,6340,0.0153248184709989,0.430914826498423
2009,17199,413,1831,371,1186,8,50,379,1236,0.0275702081149205,0.30663430420712
2009,17201,933,3779,1016,3202,177,548,1193,3750,0.019234714813295,0.318133333333333
2009,17203,242,965,113,255,63,79,176,334,0.0134455134656415,0.526946107784431
2009,18001,72,402,30,178,11,29,41,207,0.0100563544500583,0.198067632850242
2009,18003,615,2748,1022,3425,324,801,1346,4226,0.0189268231510966,0.318504495977283
2009,18005,259,1456,445,842,256,341,701,1183,0.023655741966446,0.592561284868977
2009,18007,45,325,0,89,0,0,0,89,0.0154809532092538,0
2009,18009,34,279,44,188,16,16,60,204,0.0222343324250681,0.294117647058824
2009,18011,358,1113,312,498,11,30,323,528,0.015177647464643,0.611742424242424
2009,18013,82,572,34,191,0,0,34,191,0.0176950157494905,0.178010471204188
2009,18015,24,475,73,178,0,29,73,207,0.0153049907578558,0.352657004830918
2009,18017,115,737,23,146,0,9,23,155,0.00595009596928983,0.148387096774194
2009,18019,337,2280,455,2336,26,209,481,2545,0.0353329908786739,0.188998035363458
2009,18021,29,309,33,184,9,9,42,193,0.0107281823235131,0.217616580310881
2009,18023,51,540,0,297,5,33,5,330,0.0151494284533811,0.0151515151515152
2009,18025,6,135,32,144,0,33,32,177,0.0236979515330031,0.180790960451977
2009,18027,12,468,28,268,0,38,28,306,0.0160242982823628,0.0915032679738562
2009,18029,35,568,112,1210,0,30,112,1240,0.0374384831375864,0.0903225806451613
2009,18031,69,588,140,342,50,50,190,392,0.0236943907156673,0.48469387755102
2009,18033,206,778,86,318,10,28,96,346,0.0126369612856099,0.277456647398844
2009,18035,459,1655,382,1056,128,241,510,1297,0.01902680182493,0.393215111796453
2009,18037,73,353,238,469,16,16,254,485,0.0178525416866051,0.523711340206186
2009,18039,435,2182,506,2326,185,603,691,2929,0.0237878664825794,0.235916695117788
2009,18041,45,484,0,137,16,36,16,173,0.0103277416273655,0.092485549132948
2009,18043,319,1319,261,1240,53,106,314,1346,0.0274755557370022,0.233283803863299
2009,18045,6,259,6,179,0,0,6,179,0.015241825613079,0.0335195530726257
2009,18047,142,434,22,173,7,37,29,210,0.0138230647709321,0.138095238095238
2009,18049,25,375,13,114,0,0,13,114,0.00828729281767956,0.114035087719298
2009,18051,119,544,138,353,0,0,138,353,0.0158331464453913,0.390934844192635
2009,18053,126,994,197,588,67,131,264,719,0.0158849391335086,0.367176634214186
2009,18055,160,824,69,274,8,25,77,299,0.0132965713523369,0.25752508361204
2009,18057,4380,8911,2699,4720,597,886,3296,5606,0.0335917932001486,0.587941491259365
2009,18059,630,1899,139,363,20,54,159,417,0.00954233409610984,0.381294964028777
2009,18061,29,250,95,403,0,27,95,430,0.0170655236734532,0.22093023255814
2009,18063,1017,4570,728,1778,63,120,791,1898,0.021515615258176,0.416754478398314
2009,18065,203,1771,35,419,0,9,35,428,0.0128428254215928,0.0817757009345794
2009,18067,220,1278,166,741,13,40,179,781,0.0137553277677974,0.229193341869398
2009,18069,39,391,114,315,0,39,114,354,0.0140364789849326,0.322033898305085
2009,18071,60,638,81,286,89,157,170,443,0.0156018877227583,0.383747178329571
2009,18073,164,843,69,174,0,26,69,200,0.00976038260699819,0.345
2009,18075,17,289,79,222,0,0,79,222,0.0158288770053476,0.355855855855856
2009,18077,115,822,94,367,8,44,102,411,0.019001386962552,0.248175182481752
2009,18079,13,690,23,258,0,18,23,276,0.0149277949050787,0.0833333333333333
2009,18081,946,5379,622,1773,27,131,649,1904,0.0214040807149682,0.340861344537815
2009,18083,44,450,94,292,0,18,94,310,0.0123683370571337,0.303225806451613
2009,18085,155,1258,441,938,70,134,511,1072,0.0216046272597191,0.476679104477612
2009,18087,65,589,151,437,12,31,163,468,0.0216326153277249,0.348290598290598
2009,18089,570,3218,1455,9642,213,612,1668,10254,0.03215065091429,0.162668227033353
2009,18091,382,2989,285,1167,67,122,352,1289,0.0172153589315526,0.273079906904577
2009,18093,11,440,79,359,17,27,96,386,0.0121555660525901,0.248704663212435
2009,18095,524,3045,221,1095,7,142,228,1237,0.0138431925513105,0.184316895715441
2009,18097,4463,15043,4842,11729,1158,3088,6000,14817,0.0259839785632615,0.404940271309982
2009,18099,70,1209,109,321,35,130,144,451,0.0149486244613855,0.319290465631929
2009,18101,0,111,0,78,19,25,19,103,0.0151004251576015,0.184466019417476
2009,18103,42,1444,83,288,0,0,83,288,0.0115551275878671,0.288194444444444
2009,18105,706,2046,1659,2556,591,780,2250,3336,0.0490033344595091,0.674460431654676
2009,18107,136,601,130,324,0,23,130,347,0.013808197373657,0.37463976945245
2009,18109,321,1917,48,419,0,0,48,419,0.00893314003070101,0.114558472553699
2009,18111,27,352,16,229,0,10,16,239,0.0246595130004127,0.0669456066945607
2009,18113,32,1163,57,445,15,33,72,478,0.0155989948764808,0.150627615062762
2009,18115,10,168,0,107,0,0,0,107,0.0259708737864078,0
2009,18117,38,449,14,191,0,3,14,194,0.0148148148148148,0.0721649484536082
2009,18119,38,408,18,142,0,12,18,154,0.0100633862641312,0.116883116883117
2009,18121,79,1208,58,216,20,20,78,236,0.0195364238410596,0.330508474576271
2009,18123,20,736,12,82,0,21,12,103,0.00783269961977186,0.116504854368932
2009,18125,24,318,0,32,0,0,0,32,0.00365380223795387,0
2009,18127,350,2868,544,1936,190,398,734,2334,0.0220315464559794,0.314481576692374
2009,18129,80,420,52,221,0,0,52,221,0.0124310946113174,0.235294117647059
2009,18131,74,446,26,98,0,27,26,125,0.0136017410228509,0.208
2009,18133,89,1568,55,304,12,22,67,326,0.0137055410745817,0.205521472392638
2009,18135,76,454,8,310,16,39,24,349,0.0196067415730337,0.0687679083094556
2009,18137,59,343,66,288,21,60,87,348,0.0193677649154052,0.25
2009,18139,47,292,28,53,0,0,28,53,0.00451332708847824,0.528301886792453
2009,18141,587,2321,1735,4090,110,466,1845,4556,0.0269542735775941,0.40496049165935
2009,18143,37,579,21,326,0,0,21,326,0.020273631840796,0.0644171779141104
2009,18145,67,923,85,306,12,61,97,367,0.0124137464483832,0.264305177111717
2009,18147,46,252,11,194,0,12,11,206,0.0150178610483342,0.0533980582524272
2009,18149,40,572,35,271,0,0,35,271,0.0172238464471844,0.129151291512915
2009,18151,124,637,94,534,0,3,94,537,0.0240969261835315,0.175046554934823
2009,18153,189,856,46,124,0,6,46,130,0.00886827205129954,0.353846153846154
2009,18155,83,375,20,88,0,4,20,92,0.014097456328532,0.217391304347826
2009,18157,390,2267,1311,2423,592,938,1903,3361,0.0401500400186355,0.566200535554894
2009,18159,28,407,10,68,0,0,10,68,0.00622482607103625,0.147058823529412
2009,18161,11,68,0,79,0,0,0,79,0.0164754953076121,0
2009,18163,753,2295,926,2460,15,120,941,2580,0.0220576919788657,0.364728682170543
2009,18165,67,560,0,110,0,2,0,112,0.00977227118052526,0
2009,18167,314,1111,224,1435,71,124,295,1559,0.0240060361553386,0.189223861449647
2009,18169,135,623,19,209,49,65,68,274,0.012354028585599,0.248175182481752
2009,18171,25,290,0,32,0,0,0,32,0.00542280969327233,0
2009,18173,228,1211,215,630,28,73,243,703,0.0182583175336987,0.345661450924609
2009,18175,35,614,35,292,0,0,35,292,0.0156174787399048,0.11986301369863
2009,18177,108,840,257,916,37,141,294,1057,0.0227993356484977,0.278145695364238
2009,18179,84,795,45,152,0,0,45,152,0.00818304172274563,0.296052631578947
2009,18181,103,449,63,145,0,148,63,293,0.0180074980025813,0.215017064846416
2009,18183,47,595,92,274,15,54,107,328,0.0150832336981514,0.326219512195122
2009,19001,15,109,14,45,0,0,14,45,0.00847298060628883,0.311111111111111
2009,19003,26,63,16,35,7,7,23,42,0.0141176470588235,0.547619047619048
2009,19005,63,293,20,143,0,37,20,180,0.0185452297547909,0.111111111111111
2009,19007,25,179,27,142,0,0,27,142,0.0156923416952149,0.190140845070423
2009,19009,21,89,1,39,0,12,1,51,0.0118659841786878,0.0196078431372549
2009,19011,134,733,11,117,6,23,17,140,0.00782254009051796,0.121428571428571
2009,19013,279,1356,410,1398,162,223,572,1621,0.0213730996927864,0.352868599629858
2009,19015,235,546,62,277,0,11,62,288,0.0159671785773687,0.215277777777778
2009,19017,151,517,77,160,4,7,81,167,0.0109278890197618,0.48502994011976
2009,19019,72,336,83,169,2,9,85,178,0.0132204396910279,0.47752808988764
2009,19021,36,146,118,305,30,52,148,357,0.0296659464849593,0.414565826330532
2009,19023,21,257,44,103,0,0,44,103,0.0100802505382658,0.427184466019417
2009,19025,41,490,6,65,0,18,6,83,0.011456176673568,0.072289156626506
2009,19027,248,569,48,153,3,3,51,156,0.011191620632757,0.326923076923077
2009,19029,49,331,33,182,0,4,33,186,0.0191831683168317,0.17741935483871
2009,19031,80,507,56,153,28,36,84,189,0.0151418041980452,0.444444444444444
2009,19033,224,682,173,484,0,25,173,509,0.0166367053440105,0.339882121807466
2009,19035,51,209,81,204,3,3,84,207,0.0251335599805731,0.405797101449275
2009,19037,5,232,2,38,0,16,2,54,0.00655817342725285,0.037037037037037
2009,19039,7,253,8,38,0,23,8,61,0.0100114885934679,0.131147540983607
2009,19041,52,323,22,134,0,1,22,135,0.0117595818815331,0.162962962962963
2009,19043,51,257,20,231,3,10,23,241,0.0196654426764586,0.0954356846473029
2009,19045,136,502,100,625,0,8,100,633,0.0191545374769268,0.157977883096367
2009,19047,23,154,36,136,0,6,36,142,0.0134114091424254,0.253521126760563
2009,19049,842,2111,875,1406,20,27,895,1433,0.0382735503859405,0.624563852058618
2009,19051,57,165,0,39,0,0,0,39,0.00697674418604651,0
2009,19053,7,168,11,118,0,6,11,124,0.0236325519344387,0.0887096774193548
2009,19055,40,291,4,43,0,12,4,55,0.00475737392959087,0.0727272727272727
2009,19057,128,520,138,495,0,25,138,520,0.0187421156965219,0.265384615384615
2009,19059,84,277,121,288,16,17,137,305,0.0251235584843493,0.449180327868852
2009,19061,194,707,430,941,0,11,430,952,0.0158698406347936,0.451680672268908
2009,19063,55,183,31,60,2,5,33,65,0.00945042163419599,0.507692307692308
2009,19065,28,420,64,299,0,21,64,320,0.0229868543926442,0.2
2009,19067,3,202,76,201,0,21,76,222,0.0201799836378511,0.342342342342342
2009,19069,68,213,2,84,21,57,23,141,0.0194993776794358,0.163120567375887
2009,19071,24,150,33,112,0,26,33,138,0.026604973973395,0.239130434782609
2009,19073,10,187,30,68,0,0,30,68,0.0103359173126615,0.441176470588235
2009,19075,60,277,0,29,0,9,0,38,0.00448854240491377,0
2009,19077,36,241,5,101,0,27,5,128,0.0165781634503303,0.0390625
2009,19079,42,232,0,121,0,9,0,130,0.0121586232697344,0
2009,19081,36,221,45,152,0,6,45,158,0.0202980472764645,0.284810126582278
2009,19083,59,304,25,110,1,47,26,157,0.0132949445338301,0.165605095541401
2009,19085,12,144,42,185,0,16,42,201,0.0190124858115778,0.208955223880597
2009,19087,117,458,58,268,0,90,58,358,0.0264714581484768,0.162011173184358
2009,19089,18,278,39,98,0,3,39,101,0.0155792071571803,0.386138613861386
2009,19091,29,152,12,85,0,0,12,85,0.0127761911919435,0.141176470588235
2009,19093,14,74,40,58,2,7,42,65,0.0135983263598326,0.646153846153846
2009,19095,76,294,4,105,10,10,14,115,0.0106996650539635,0.121739130434783
2009,19097,22,202,20,46,4,15,24,61,0.00445873839631606,0.39344262295082
2009,19099,106,1197,142,391,17,26,159,417,0.0164056967503344,0.381294964028777
2009,19101,32,261,79,263,190,223,269,486,0.0442099517875011,0.553497942386831
2009,19103,799,1830,1620,2404,433,614,2053,3018,0.0440577509817375,0.68025182239894
2009,19105,128,688,41,111,0,7,41,118,0.00833509924419015,0.347457627118644
2009,19107,27,287,43,121,0,4,43,125,0.0170230151164374,0.344
2009,19109,17,170,50,136,12,12,62,148,0.0136167080688196,0.418918918918919
2009,19111,73,441,247,745,6,23,253,768,0.0307877330126278,0.329427083333333
2009,19113,726,2762,902,2621,278,595,1180,3216,0.0236932257708034,0.366915422885572
2009,19115,69,383,10,120,0,30,10,150,0.0194628260023355,0.0666666666666667
2009,19117,5,154,0,73,19,40,19,113,0.0176287051482059,0.168141592920354
2009,19119,0,60,31,110,3,7,34,117,0.0157025902563414,0.290598290598291
2009,19121,64,435,2,36,0,15,2,51,0.00502611609342663,0.0392156862745098
2009,19123,59,341,16,167,3,18,19,185,0.0127025542433397,0.102702702702703
2009,19125,170,558,137,293,13,13,150,306,0.0143878126763212,0.490196078431373
2009,19127,165,587,179,444,0,42,179,486,0.0188065939168795,0.368312757201646
2009,19129,20,173,82,349,0,0,82,349,0.0341487279843444,0.234957020057307
2009,19131,70,141,25,72,0,0,25,72,0.00999583506872137,0.347222222222222
2009,19133,8,155,9,129,9,11,18,140,0.0213936430317848,0.128571428571429
2009,19135,14,183,20,67,6,6,26,73,0.0137865911237016,0.356164383561644
2009,19137,7,126,62,148,0,19,62,167,0.0221250662427133,0.37125748502994
2009,19139,211,631,130,557,30,35,160,592,0.0213264166576606,0.27027027027027
2009,19141,40,256,70,172,0,35,70,207,0.0215355805243446,0.338164251207729
2009,19143,9,112,2,42,0,0,2,42,0.00962861072902338,0.0476190476190476
2009,19145,51,708,26,266,4,4,30,270,0.0237216657880865,0.111111111111111
2009,19147,15,219,7,36,0,0,7,36,0.00556586270871985,0.194444444444444
2009,19149,61,310,43,167,4,6,47,173,0.010846394984326,0.271676300578035
2009,19151,39,159,27,72,13,15,40,87,0.0161380077907624,0.459770114942529
2009,19153,2310,6164,2591,6543,302,1019,2893,7562,0.0276620416942543,0.382570748479238
2009,19155,210,834,307,2098,7,58,314,2156,0.0359909188034188,0.145640074211503
2009,19157,33,296,47,127,0,0,47,127,0.0104457970060865,0.37007874015748
2009,19159,16,103,41,60,0,0,41,60,0.0167644593461861,0.683333333333333
2009,19161,18,116,12,100,0,2,12,102,0.0139821795750514,0.117647058823529
2009,19163,625,1428,1441,3493,117,389,1558,3882,0.0361422227187666,0.40133951571355
2009,19165,21,220,32,160,7,9,39,169,0.019990537023894,0.230769230769231
2009,19167,38,161,64,314,9,25,73,339,0.0181769436997319,0.215339233038348
2009,19169,433,1111,811,1494,222,313,1033,1807,0.043330216051603,0.571665744327615
2009,19171,112,374,38,73,4,13,42,86,0.00732538330494037,0.488372093023256
2009,19173,2,126,6,75,0,2,6,77,0.0171683389074693,0.0779220779220779
2009,19175,36,188,10,231,0,4,10,235,0.0285055798156235,0.0425531914893617
2009,19177,12,127,48,135,12,12,60,147,0.0274049217002237,0.408163265306122
2009,19179,77,706,73,319,24,49,97,368,0.0153846153846154,0.263586956521739
2009,19181,261,1333,226,465,20,51,246,516,0.0180092140164735,0.476744186046512
2009,19183,133,561,28,146,0,4,28,150,0.0105917243327214,0.186666666666667
2009,19185,25,146,4,67,0,3,4,70,0.0157197395014597,0.0571428571428571
2009,19187,109,512,124,416,0,52,124,468,0.0185082654433283,0.264957264957265
2009,19189,11,128,28,158,5,5,33,163,0.0223962627095356,0.202453987730061
2009,19191,67,198,53,157,7,40,60,197,0.0151771956856703,0.304568527918782
2009,19193,210,1013,368,1758,41,147,409,1905,0.0296585760769722,0.214698162729659
2009,19195,3,109,8,16,0,2,8,18,0.00335382895472331,0.444444444444444
2009,19197,9,191,10,40,0,20,10,60,0.00662397880326783,0.166666666666667
2009,20001,108,191,26,121,0,0,26,121,0.0133583572532568,0.214876033057851
2009,20003,62,187,0,9,2,2,2,11,0.00207664715876911,0.181818181818182
2009,20005,11,145,38,333,0,0,38,333,0.0323395163639895,0.114114114114114
2009,20007,13,94,19,116,0,1,19,117,0.0348733233979136,0.162393162393162
2009,20009,202,608,124,371,13,29,137,400,0.0219623345961676,0.3425
2009,20011,60,279,49,188,29,56,78,244,0.024741431758264,0.319672131147541
2009,20013,17,173,27,148,0,10,27,158,0.0235049092531985,0.170886075949367
2009,20015,331,1645,201,756,30,50,231,806,0.0198160987362935,0.286600496277916
2009,20017,4,21,0,13,0,13,0,26,0.0130456598093327,0
2009,20019,23,102,10,71,0,4,10,75,0.0270367700072098,0.133333333333333
2009,20021,0,201,70,506,0,3,70,509,0.0352346670358577,0.137524557956778
2009,20023,3,28,9,41,0,12,9,53,0.0255791505791506,0.169811320754717
2009,20025,4,28,0,35,0,0,0,35,0.022920759659463,0
2009,20027,24,137,0,51,0,51,0,102,0.0169576059850374,0
2009,20029,23,145,23,124,0,0,23,124,0.0194053208137715,0.185483870967742
2009,20031,30,252,23,99,0,0,23,99,0.0170660230994656,0.232323232323232
2009,20033,5,9,0,27,0,5,0,32,0.0239520958083832,0
2009,20035,58,1161,83,689,0,20,83,709,0.0319815959222337,0.117066290550071
2009,20037,67,316,155,446,25,31,180,477,0.0211764705882353,0.377358490566038
2009,20039,0,7,17,106,0,0,17,106,0.0462276493676406,0.160377358490566
2009,20041,167,360,23,298,0,48,23,346,0.0268946754760979,0.0664739884393064
2009,20043,15,55,35,264,0,24,35,288,0.0568720379146919,0.121527777777778
2009,20045,675,1828,918,1780,456,586,1374,2366,0.0391884057971014,0.58072696534235
2009,20047,37,75,2,28,3,3,5,31,0.014519906323185,0.161290322580645
2009,20049,63,150,3,38,0,0,3,38,0.0173199635369189,0.0789473684210526
2009,20051,115,594,174,423,0,0,174,423,0.0276488659389503,0.411347517730496
2009,20053,41,294,4,43,0,0,4,43,0.00957044291119519,0.0930232558139535
2009,20055,64,667,73,501,26,83,99,584,0.0251767546128643,0.169520547945205
2009,20057,160,539,142,736,0,19,142,755,0.0389999483444393,0.188079470198675
2009,20059,154,652,66,408,0,21,66,429,0.0252679938744257,0.153846153846154
2009,20061,121,466,282,1227,106,362,388,1589,0.0941964550358646,0.244178728760227
2009,20063,2,52,0,28,0,0,0,28,0.0152588555858311,0
2009,20065,0,45,14,25,0,10,14,35,0.0188882892606584,0.4
2009,20067,38,75,0,51,0,0,0,51,0.0106117353308365,0
2009,20069,27,199,42,116,0,3,42,119,0.0339418140330861,0.352941176470588
2009,20071,9,12,0,2,0,0,0,2,0.00240096038415366,0
2009,20073,0,171,2,23,0,4,2,27,0.00555441267228965,0.0740740740740741
2009,20075,14,41,14,66,0,6,14,72,0.0455696202531646,0.194444444444444
2009,20077,7,57,1,106,0,0,1,106,0.0261148066026115,0.00943396226415094
2009,20079,161,935,111,307,15,65,126,372,0.0170243924763169,0.338709677419355
2009,20081,33,116,0,21,4,8,4,29,0.0122259696458685,0.137931034482759
2009,20083,33,53,7,64,0,0,7,64,0.0467494521548576,0.109375
2009,20085,57,401,3,133,0,0,3,133,0.0154939422180801,0.0225563909774436
2009,20087,212,496,26,114,0,11,26,125,0.0100072051877352,0.208
2009,20089,15,33,4,25,0,4,4,29,0.0120481927710843,0.137931034482759
2009,20091,2410,5737,7521,14494,783,1828,8304,16322,0.0471904589808457,0.508761181227791
2009,20093,15,72,0,84,0,6,0,90,0.0363342753330642,0
2009,20095,32,151,0,8,0,0,0,8,0.00142780653221488,0
2009,20097,1,12,7,77,0,0,7,77,0.0427302996670366,0.0909090909090909
2009,20099,68,445,42,370,0,12,42,382,0.0262200562838905,0.109947643979058
2009,20101,0,2,2,45,0,0,2,45,0.0374064837905237,0.0444444444444444
2009,20103,547,2382,1495,3625,563,792,2058,4417,0.0913452590218178,0.465927099841521
2009,20105,10,63,0,30,0,4,0,34,0.0150243040212108,0
2009,20107,3,91,8,104,0,0,8,104,0.0156650097906311,0.0769230769230769
2009,20109,13,40,0,31,0,0,0,31,0.0165157165689931,0
2009,20111,78,597,103,511,19,82,122,593,0.0297481689575599,0.205733558178752
2009,20113,83,425,38,332,0,49,38,381,0.0199413796713074,0.0997375328083989
2009,20115,24,311,46,68,0,0,46,68,0.00820067534973468,0.676470588235294
2009,20117,4,58,41,83,0,7,41,90,0.0127316452114868,0.455555555555556
2009,20119,26,83,0,63,3,3,3,66,0.0235967107615302,0.0454545454545455
2009,20121,286,1028,11,265,0,0,11,265,0.013327968616406,0.0415094339622641
2009,20123,85,136,23,77,0,1,23,78,0.0179889298892989,0.294871794871795
2009,20125,101,507,228,882,5,11,233,893,0.0385462079682307,0.260918253079507
2009,20127,20,148,11,85,6,12,17,97,0.0229748934154429,0.175257731958763
2009,20129,3,56,1,115,17,17,18,132,0.0653465346534653,0.136363636363636
2009,20131,37,125,37,75,0,0,37,75,0.0113395827033565,0.493333333333333
2009,20133,22,289,0,104,0,135,0,239,0.0229763507017881,0
2009,20135,23,38,3,27,0,3,3,30,0.0141176470588235,0.1
2009,20137,50,402,12,145,39,42,51,187,0.0444391634980989,0.272727272727273
2009,20139,20,292,7,89,33,50,40,139,0.0125826016112972,0.287769784172662
2009,20141,28,64,4,57,0,0,4,57,0.0205850487540628,0.0701754385964912
2009,20143,8,107,15,49,0,1,15,50,0.0121921482565228,0.3
2009,20145,33,596,35,90,0,23,35,113,0.0246455834242094,0.309734513274336
2009,20147,23,38,8,44,0,3,8,47,0.0125366764470525,0.170212765957447
2009,20149,143,436,61,193,0,0,61,193,0.0157576747224037,0.316062176165803
2009,20151,61,642,7,93,9,19,16,112,0.0173428305977083,0.142857142857143
2009,20153,16,37,4,23,0,0,4,23,0.0123523093447905,0.173913043478261
2009,20155,248,1356,130,673,4,37,134,710,0.016612850390753,0.188732394366197
2009,20157,1,73,2,59,1,4,3,63,0.0173841059602649,0.0476190476190476
2009,20159,9,253,44,187,0,0,44,187,0.0292004996876952,0.235294117647059
2009,20161,382,957,561,1761,233,546,794,2307,0.0765148751285198,0.344169917641959
2009,20163,29,125,37,48,1,4,38,52,0.0146026397079472,0.730769230769231
2009,20165,9,64,3,53,0,0,3,53,0.0226883561643836,0.0566037735849057
2009,20167,85,206,4,21,0,1,4,22,0.00457951706910908,0.181818181818182
2009,20169,127,1100,189,706,0,47,189,753,0.0210405722588577,0.250996015936255
2009,20171,12,12,0,42,0,0,0,42,0.0123094958968347,0
2009,20173,1330,5635,2357,6885,485,1231,2842,8116,0.0268393343739252,0.350172498767866
2009,20175,0,301,190,781,13,52,203,833,0.0655131734172237,0.243697478991597
2009,20177,556,3053,695,2566,103,255,798,2821,0.0243382682817407,0.28287841191067
2009,20179,10,46,0,33,0,0,0,33,0.0184357541899441,0
2009,20181,0,36,0,145,0,0,0,145,0.0348222862632085,0
2009,20183,21,89,8,42,0,3,8,45,0.0149253731343284,0.177777777777778
2009,20185,37,99,11,16,0,0,11,16,0.0053138492195284,0.6875
2009,20187,5,127,0,14,8,8,8,22,0.0147750167897918,0.363636363636364
2009,20189,10,166,37,110,0,2,37,112,0.0338675536740248,0.330357142857143
2009,20191,108,765,27,181,2,2,29,183,0.0117413063005261,0.158469945355191
2009,20193,46,229,3,42,20,20,23,62,0.013876454789615,0.370967741935484
2009,20195,0,46,9,17,6,6,15,23,0.0106530801296897,0.652173913043478
2009,20197,63,146,14,44,4,6,18,50,0.0108554059921841,0.36
2009,20199,0,36,2,7,0,0,2,7,0.00664136622390892,0.285714285714286
2009,20201,25,54,0,11,0,3,0,14,0.00341713448865023,0
2009,20203,0,1,4,79,0,0,4,79,0.0531986531986532,0.0506329113924051
2009,20205,27,245,12,126,0,0,12,126,0.0190793458509994,0.0952380952380952
2009,20207,0,57,5,36,0,4,5,40,0.0166112956810631,0.125
2009,20209,749,2668,576,3362,83,498,659,3860,0.0399416396767418,0.170725388601036
2009,21001,104,547,19,324,0,8,19,332,0.0277429598061335,0.0572289156626506
2009,21003,15,316,0,271,0,0,0,271,0.021336902606094,0
2009,21005,93,590,33,88,0,0,33,88,0.00618151166057881,0.375
2009,21007,2,104,14,100,0,12,14,112,0.0193236714975845,0.125
2009,21009,54,498,75,482,13,59,88,541,0.0192897382870998,0.162661737523105
2009,21011,61,453,42,62,0,0,42,62,0.00783817951959545,0.67741935483871
2009,21013,31,316,47,339,0,14,47,353,0.0179042402109961,0.13314447592068
2009,21015,749,3370,908,2341,135,612,1043,2953,0.040630718639497,0.353200135455469
2009,21017,63,683,32,161,0,22,32,183,0.0137027330587795,0.174863387978142
2009,21019,131,794,202,1181,10,58,212,1239,0.0360352499781869,0.171105730427764
2009,21021,164,1243,112,472,0,13,112,485,0.0254941126997477,0.230927835051546
2009,21023,5,196,13,67,0,35,13,102,0.0174807197943445,0.127450980392157
2009,21025,6,333,0,16,0,8,0,24,0.00225776105362182,0
2009,21027,29,660,36,163,0,9,36,172,0.0132705809736903,0.209302325581395
2009,21029,263,1683,141,484,67,67,208,551,0.0110727060809453,0.377495462794918
2009,21031,0,233,7,81,10,155,17,236,0.0258431887866842,0.0720338983050847
2009,21033,0,182,12,55,0,39,12,94,0.0103058875123342,0.127659574468085
2009,21035,93,423,211,559,30,145,241,704,0.0331153864245731,0.342329545454545
2009,21037,280,1210,540,1504,31,82,571,1586,0.0272789817681459,0.360025220680958
2009,21039,1,65,3,15,0,0,3,15,0.00410733844468784,0.2
2009,21041,0,401,58,410,0,2,58,412,0.0590088799770839,0.140776699029126
2009,21043,32,178,13,138,0,9,13,147,0.00815443501414545,0.0884353741496599
2009,21045,54,373,18,106,0,0,18,106,0.00951696893517687,0.169811320754717
2009,21047,114,837,449,3058,69,835,518,3893,0.0903856423115321,0.133059337272027
2009,21049,233,778,231,590,0,13,231,603,0.0246716582791211,0.383084577114428
2009,21051,0,129,0,159,0,0,0,159,0.0097930524759793,0
2009,21053,0,146,0,89,0,24,0,113,0.0173765954174996,0
2009,21055,0,91,0,63,0,0,0,63,0.0100719424460432,0
2009,21057,0,30,0,56,0,0,0,56,0.0116134384072999,0
2009,21059,137,1633,254,897,0,30,254,927,0.0149040162063089,0.274002157497303
2009,21061,71,504,0,103,0,11,0,114,0.0136265837915372,0
2009,21063,28,416,0,154,0,0,0,154,0.0271796681962584,0
2009,21065,48,206,0,17,0,0,0,17,0.00164664858581945,0
2009,21067,1211,5810,2903,5836,561,1543,3464,7379,0.0408602865037571,0.469440303564169
2009,21069,23,48,9,227,0,57,9,284,0.0287915652879157,0.0316901408450704
2009,21071,108,936,16,398,13,13,29,411,0.0142396840245297,0.0705596107055961
2009,21073,283,1213,160,452,46,67,206,519,0.0156071450051122,0.396917148362235
2009,21075,0,90,22,170,0,12,22,182,0.0373946989932196,0.120879120879121
2009,21077,10,376,21,68,0,8,21,76,0.01500197394394,0.276315789473684
2009,21079,7,533,0,360,0,30,0,390,0.0333589940980241,0
2009,21081,201,865,52,304,0,26,52,330,0.0205902539464653,0.157575757575758
2009,21083,56,500,57,435,0,27,57,462,0.0181560952605518,0.123376623376623
2009,21085,33,282,0,142,0,12,0,154,0.00900374181478017,0
2009,21087,22,216,0,57,0,10,0,67,0.00822893637926799,0
2009,21089,38,536,28,525,0,14,28,539,0.0204066179532806,0.051948051948052
2009,21091,6,118,0,111,0,0,0,111,0.0194089875852422,0
2009,21093,226,1327,761,2844,242,710,1003,3554,0.0573614383937506,0.282217220033765
2009,21095,0,213,0,66,0,8,0,74,0.00351060296978035,0
2009,21097,59,569,39,110,0,4,39,114,0.00893627028298189,0.342105263157895
2009,21099,53,523,24,140,0,0,24,140,0.0112921438941765,0.171428571428571
2009,21101,94,633,173,628,0,39,173,667,0.0215105779153767,0.259370314842579
2009,21103,78,421,0,63,12,58,12,121,0.0111809277397893,0.0991735537190083
2009,21105,22,147,5,61,0,0,5,61,0.0174785100286533,0.0819672131147541
2009,21107,56,806,160,521,0,41,160,562,0.0175657935862974,0.284697508896797
2009,21109,81,394,0,263,0,0,0,263,0.0285962813961074,0
2009,21111,1687,7118,5332,13073,846,2318,6178,15391,0.0319416744319255,0.401403417581704
2009,21113,390,1637,407,810,69,81,476,891,0.0304657047117555,0.534231200897868
2009,21115,33,288,15,249,0,8,15,257,0.0158348736906962,0.0583657587548638
2009,21117,842,3515,1110,2998,59,145,1169,3143,0.030294267896558,0.371937639198218
2009,21119,15,488,42,189,0,0,42,189,0.0161566079671739,0.222222222222222
2009,21121,90,838,26,222,0,33,26,255,0.012022630834512,0.101960784313725
2009,21123,38,262,0,124,0,0,0,124,0.0131957007555603,0
2009,21125,306,1373,106,690,0,40,106,730,0.0190228013029316,0.145205479452055
2009,21127,28,188,5,286,0,27,5,313,0.0282720621443411,0.0159744408945687
2009,21129,35,198,0,125,0,0,0,125,0.0240708646254573,0
2009,21131,90,307,2,34,0,0,2,34,0.00415495539533179,0.0588235294117647
2009,21133,47,422,15,214,0,17,15,231,0.0138166158263054,0.0649350649350649
2009,21135,63,289,39,144,0,21,39,165,0.0174068994619686,0.236363636363636
2009,21137,104,541,0,53,0,23,0,76,0.0044827179426684,0
2009,21139,103,343,33,104,0,10,33,114,0.0162185232607768,0.289473684210526
2009,21141,58,351,31,672,0,102,31,774,0.0418672580732407,0.0400516795865633
2009,21143,21,635,8,55,0,0,8,55,0.00824711351027141,0.145454545454545
2009,21145,202,1495,411,1589,0,47,411,1636,0.036051918288195,0.251222493887531
2009,21147,68,354,23,375,0,0,23,375,0.0309533635988444,0.0613333333333333
2009,21149,0,120,11,49,0,0,11,49,0.00741974560872199,0.224489795918367
2009,21151,440,1969,311,900,20,133,331,1033,0.0214226462048942,0.320425943852856
2009,21153,0,167,23,67,0,0,23,67,0.00824311023622047,0.343283582089552
2009,21155,35,828,24,97,0,3,24,100,0.00791076655327901,0.24
2009,21157,122,486,103,595,0,12,103,607,0.027105474680718,0.169686985172982
2009,21159,0,221,22,266,0,0,22,266,0.0301075268817204,0.0827067669172932
2009,21161,32,400,23,325,26,26,49,351,0.0297029702970297,0.13960113960114
2009,21163,62,921,160,589,142,250,302,839,0.0469896387566508,0.359952324195471
2009,21165,16,119,0,105,0,0,0,105,0.0221099178774479,0
2009,21167,78,904,51,184,16,25,67,209,0.0139995980976623,0.320574162679426
2009,21169,0,201,6,89,0,19,6,108,0.0155799192152337,0.0555555555555556
2009,21171,10,67,16,68,15,15,31,83,0.0103607539633005,0.373493975903614
2009,21173,21,349,32,348,11,41,43,389,0.0230381995854309,0.110539845758355
2009,21175,68,507,132,213,0,0,132,213,0.0214761040532365,0.619718309859155
2009,21177,22,688,10,212,0,19,10,231,0.0105968163677233,0.0432900432900433
2009,21179,162,750,124,502,42,42,166,544,0.0194535831783722,0.305147058823529
2009,21181,34,182,11,33,0,0,11,33,0.00683088387497413,0.333333333333333
2009,21183,26,508,47,215,7,7,54,222,0.013876734591824,0.243243243243243
2009,21185,429,2548,421,821,58,100,479,921,0.0249019872921455,0.520086862106406
2009,21187,12,251,0,98,48,59,48,157,0.0203684483653347,0.305732484076433
2009,21189,0,78,14,92,0,0,14,92,0.0278281911675741,0.152173913043478
2009,21191,12,269,35,336,0,4,35,340,0.0346797225622195,0.102941176470588
2009,21193,15,347,30,228,0,31,30,259,0.0131072874493927,0.115830115830116
2009,21195,69,558,277,968,0,10,277,978,0.0213995011159249,0.283231083844581
2009,21197,41,224,31,238,0,0,31,238,0.0256603773584906,0.130252100840336
2009,21199,155,826,212,781,0,52,212,833,0.0199196518245731,0.254501800720288
2009,21201,0,74,0,0,0,5,0,5,0.00374251497005988,0
2009,21203,53,312,0,89,0,17,0,106,0.00926492439472074,0
2009,21205,141,277,30,189,0,0,30,189,0.0153098420413123,0.158730158730159
2009,21207,40,207,8,172,0,0,8,172,0.014421061457198,0.0465116279069767
2009,21209,438,1660,139,578,19,19,158,597,0.0219469156679656,0.26465661641541
2009,21211,389,1477,143,379,0,100,143,479,0.0178544803936186,0.298538622129436
2009,21213,41,359,66,484,0,10,66,494,0.0431026960998168,0.133603238866397
2009,21215,87,563,75,184,0,0,75,184,0.016157358623112,0.407608695652174
2009,21217,44,356,47,310,8,53,55,363,0.0226605905487234,0.151515151515152
2009,21219,16,214,42,236,0,34,42,270,0.0341815419673376,0.155555555555556
2009,21221,66,454,161,336,0,18,161,354,0.0373260227752003,0.454802259887006
2009,21223,48,281,56,270,14,14,70,284,0.0469343910097505,0.246478873239437
2009,21225,0,116,0,48,0,0,0,48,0.00527994720052799,0
2009,21227,280,1595,458,1494,49,231,507,1725,0.0277415930911372,0.293913043478261
2009,21229,32,353,4,38,0,15,4,53,0.00708272083389015,0.0754716981132075
2009,21231,49,293,19,290,0,27,19,317,0.0225976618192187,0.0599369085173502
2009,21233,2,289,0,216,12,33,12,249,0.026282457251425,0.0481927710843374
2009,21235,45,810,211,760,0,26,211,786,0.031480294777315,0.268447837150127
2009,21237,0,93,0,0,0,0,0,0,0,NA
2009,21239,262,976,140,334,47,59,187,393,0.0238601177827697,0.475826972010178
2009,22001,66,842,103,433,27,80,130,513,0.0138323401731065,0.253411306042885
2009,22003,58,1035,37,418,31,58,68,476,0.0287006331022008,0.142857142857143
2009,22005,801,2990,456,1561,0,56,456,1617,0.0261202468258327,0.282003710575139
2009,22007,0,413,0,19,0,8,0,27,0.00176217204020363,0
2009,22009,108,1627,39,209,0,61,39,270,0.0099078932883197,0.144444444444444
2009,22011,29,989,103,731,41,99,144,830,0.0367598210726782,0.173493975903614
2009,22013,36,302,0,45,0,0,0,45,0.00455419491954256,0
2009,22015,662,2765,634,2604,107,353,741,2957,0.0430534929093503,0.25059181602976
2009,22017,1313,4469,1142,3542,76,397,1218,3939,0.0241126850230781,0.309215536938309
2009,22019,513,2925,730,2929,136,367,866,3296,0.027710519235943,0.262742718446602
2009,22021,26,377,25,103,0,7,25,110,0.0158638592443034,0.227272727272727
2009,22023,60,301,15,47,0,22,15,69,0.013633669235329,0.217391304347826
2009,22025,11,529,46,188,0,17,46,205,0.0298311990686845,0.224390243902439
2009,22027,27,224,0,160,19,19,19,179,0.0161116111611161,0.106145251396648
2009,22029,48,516,72,396,0,0,72,396,0.0321794246708922,0.181818181818182
2009,22031,103,684,28,236,0,31,28,267,0.0156003505696757,0.104868913857678
2009,22033,2176,8649,1974,4351,381,616,2355,4967,0.0200800452781371,0.474129253070264
2009,22035,72,588,0,8,0,33,0,41,0.00782442748091603,0
2009,22037,115,922,0,63,17,17,17,80,0.00560734562276582,0.2125
2009,22039,116,812,32,420,3,157,35,577,0.0261559383499547,0.0606585788561525
2009,22041,10,618,25,209,0,0,25,209,0.0159177456207159,0.119617224880383
2009,22043,52,504,38,367,20,46,58,413,0.030745179781136,0.14043583535109
2009,22045,151,1133,103,500,16,77,119,577,0.0124224939717534,0.206239168110919
2009,22047,78,2026,40,416,0,7,40,423,0.0196982397317687,0.0945626477541371
2009,22049,26,234,0,152,0,13,0,165,0.0162737942597889,0
2009,22051,2940,12964,1850,6807,352,984,2202,7791,0.0261371908977761,0.282633808240277
2009,22053,74,614,69,243,14,31,83,274,0.0139624949041989,0.302919708029197
2009,22055,1704,4880,639,2011,126,501,765,2512,0.0191624075062934,0.30453821656051
2009,22057,358,1850,45,231,27,85,72,316,0.00523803209123458,0.227848101265823
2009,22059,28,382,0,72,0,13,0,85,0.00922909880564604,0
2009,22061,179,605,238,483,64,126,302,609,0.0291708578818796,0.495894909688013
2009,22063,564,3435,179,953,60,107,239,1060,0.0143615868198569,0.225471698113208
2009,22065,22,1011,14,48,0,0,14,48,0.00634500991407799,0.291666666666667
2009,22067,22,248,29,170,0,23,29,193,0.010244161358811,0.150259067357513
2009,22069,155,628,64,313,19,33,83,346,0.0157501820830299,0.239884393063584
2009,22071,2727,9564,3517,12267,403,783,3920,13050,0.0598816133620887,0.300383141762452
2009,22073,489,2248,448,1605,49,91,497,1696,0.0180839153382737,0.293042452830189
2009,22075,94,519,63,359,28,28,91,387,0.0273614253393665,0.235142118863049
2009,22077,129,398,0,71,0,69,0,140,0.00937960605654562,0
2009,22079,580,2582,343,1288,33,203,376,1491,0.0175628717827905,0.252179745137492
2009,22081,13,109,10,67,0,0,10,67,0.0116806136680614,0.149253731343284
2009,22083,70,960,35,167,5,11,40,178,0.0133884919142535,0.224719101123595
2009,22085,49,417,17,206,12,25,29,231,0.0147651006711409,0.125541125541126
2009,22087,151,2036,26,483,0,154,26,637,0.0257394536932277,0.0408163265306122
2009,22089,180,1054,76,281,47,88,123,369,0.0113336200012286,0.333333333333333
2009,22091,10,269,12,14,0,0,12,14,0.0019877892943348,0.857142857142857
2009,22093,50,226,79,170,4,4,83,174,0.0129695885509839,0.477011494252874
2009,22095,384,1789,60,297,0,24,60,321,0.0111326905736284,0.186915887850467
2009,22097,112,2048,22,258,24,63,46,321,0.00560493094236175,0.143302180685358
2009,22099,88,1765,13,206,0,51,13,257,0.00783656045128831,0.0505836575875486
2009,22101,127,769,32,324,5,213,37,537,0.0165925101965146,0.068901303538175
2009,22103,1456,5132,1260,4329,200,355,1460,4684,0.0317000541418517,0.311699402220324
2009,22105,382,2485,310,1368,36,135,346,1503,0.0209244048447724,0.23020625415835
2009,22107,9,233,3,45,0,0,3,45,0.0117126496616346,0.0666666666666667
2009,22109,272,1264,213,943,21,21,234,964,0.0141301320668983,0.242738589211618
2009,22111,30,294,0,113,0,0,0,113,0.00734768190389492,0
2009,22113,100,919,53,189,17,58,70,247,0.00690021231422505,0.283400809716599
2009,22115,123,546,539,1673,195,438,734,2111,0.079161510481119,0.347702510658456
2009,22117,81,932,111,591,0,0,111,591,0.0202827922300776,0.187817258883249
2009,22119,67,761,64,511,0,5,64,516,0.0189587390234045,0.124031007751938
2009,22121,98,913,31,247,19,51,50,298,0.0206757788107958,0.167785234899329
2009,22123,0,306,10,385,0,15,10,400,0.0510399387520735,0.025
2009,22125,0,304,8,132,0,19,8,151,0.0140976566146952,0.0529801324503311
2009,22127,37,450,0,101,0,0,0,101,0.00947644961531244,0
2009,23001,440,2277,410,1408,44,122,454,1530,0.0210471290615457,0.296732026143791
2009,23003,95,471,138,686,12,100,150,786,0.0153870247836811,0.190839694656489
2009,23005,1166,4495,3350,6090,158,497,3508,6587,0.0344823975919382,0.532564141490815
2009,23007,176,612,145,425,5,15,150,440,0.0216620716817645,0.340909090909091
2009,23009,231,599,280,916,35,61,315,977,0.0255298021897619,0.322415557830092
2009,23011,412,2132,172,989,89,168,261,1157,0.0138231780167264,0.225583405358686
2009,23013,101,812,350,760,22,25,372,785,0.026330795290645,0.473885350318471
2009,23015,103,637,237,489,47,59,284,548,0.0215248045877686,0.518248175182482
2009,23017,184,1032,142,716,10,30,152,746,0.0187366570388045,0.203753351206434
2009,23019,460,2344,756,2005,67,139,823,2144,0.0212090336238364,0.383861940298507
2009,23021,85,343,113,357,8,8,121,365,0.0296386520503451,0.331506849315069
2009,23023,283,1330,248,504,0,29,248,533,0.0208406647116325,0.465290806754221
2009,23025,135,853,136,637,5,9,141,646,0.0179784036513414,0.218266253869969
2009,23027,230,984,189,513,4,13,193,526,0.0195582657841898,0.366920152091255
2009,23029,54,362,113,448,0,32,113,480,0.020607934054611,0.235416666666667
2009,23031,608,2456,1498,4049,90,200,1588,4249,0.0301277006090773,0.373734996469758
2009,24001,115,1146,29,1003,0,52,29,1055,0.0216716994309895,0.0274881516587678
2009,24003,3966,12212,4157,9075,1088,2566,5245,11641,0.0339932836910498,0.450562666437591
2009,24005,6426,21635,5407,9690,1318,3089,6725,12779,0.0238407952031104,0.526254010485954
2009,24009,368,1486,449,1441,97,124,546,1565,0.027409976180468,0.34888178913738
2009,24011,111,712,12,241,11,45,23,286,0.0132616155058889,0.0804195804195804
2009,24013,1084,3014,532,1122,64,110,596,1232,0.0111113115315933,0.483766233766234
2009,24015,208,1301,791,2385,14,105,805,2490,0.038003663003663,0.323293172690763
2009,24017,431,2886,680,2158,158,274,838,2432,0.027166203098645,0.344572368421053
2009,24019,98,640,78,248,18,48,96,296,0.0132848615412235,0.324324324324324
2009,24021,1476,4565,1640,3683,281,701,1921,4384,0.0300278086001178,0.438184306569343
2009,24023,128,229,128,384,7,30,135,414,0.0201097780152523,0.326086956521739
2009,24025,1418,3900,1050,2477,210,940,1260,3417,0.0214993550822663,0.368744512730465
2009,24027,3631,7084,3629,5702,832,1321,4461,7023,0.0392070386208591,0.635198633062794
2009,24029,132,576,213,379,10,48,223,427,0.0302193913658882,0.522248243559719
2009,24031,3964,10031,15316,22921,4840,9752,20156,32673,0.0516278584701733,0.61690080494598
2009,24033,2918,9402,5907,18889,1443,4056,7350,22945,0.0426867043334121,0.320331226846808
2009,24035,218,1182,193,564,0,22,193,586,0.018333124765361,0.329351535836177
2009,24037,475,1821,859,2346,124,432,983,2778,0.0437397657135659,0.353851691864651
2009,24039,45,1455,169,279,7,17,176,296,0.0175179025862579,0.594594594594595
2009,24041,317,802,182,400,64,64,246,464,0.0176251614373623,0.530172413793103
2009,24043,528,3328,695,2434,95,234,790,2668,0.0270262056949523,0.296101949025487
2009,24045,261,1601,575,1686,119,302,694,1988,0.0325304359209321,0.349094567404427
2009,24047,261,1196,262,704,0,45,262,749,0.0205486968449931,0.349799732977303
2009,24510,3661,11572,5632,9155,1351,2793,6983,11948,0.0284163610504635,0.584449280214262
2009,25001,1141,2748,1370,2609,158,377,1528,2986,0.0179806945389511,0.511721366376423
2009,25003,267,882,787,1847,149,219,936,2066,0.0227182757862327,0.453049370764763
2009,25005,1717,7046,1865,5261,425,1528,2290,6789,0.0183928411778571,0.337310354986007
2009,25007,155,386,149,149,0,68,149,217,0.0193888491779843,0.686635944700461
2009,25009,3745,8799,3898,7868,868,2428,4766,10296,0.0207507850068726,0.462898212898213
2009,25011,511,1473,461,1005,40,140,501,1145,0.022351058015148,0.437554585152838
2009,25013,853,3425,1426,4845,364,1861,1790,6706,0.0218886375579775,0.266925141664181
2009,25015,911,2893,813,1385,344,508,1157,1893,0.0205506220552793,0.611199154780771
2009,25017,13363,25415,14763,20740,6535,10480,21298,31220,0.0307438696901093,0.682190903267136
2009,25019,41,104,0,112,0,57,0,169,0.0223841059602649,0
2009,25021,8976,16683,4802,7097,2194,3209,6996,10306,0.0228815779541125,0.678827867261789
2009,25023,2799,9664,1586,3060,260,1111,1846,4171,0.0127032179861242,0.442579717094222
2009,25025,11391,21551,10434,14785,4112,8146,14546,22931,0.0457443455432627,0.634337795996686
2009,25027,3577,9286,3030,6719,972,2261,4002,8980,0.0169475851578409,0.4456570155902
2009,26001,40,276,6,46,0,0,6,46,0.00517260766895311,0.130434782608696
2009,26003,48,449,4,48,0,6,4,54,0.00750938673341677,0.0740740740740741
2009,26005,465,2424,171,627,14,69,185,696,0.00941838750710439,0.265804597701149
2009,26007,71,442,60,289,11,49,71,338,0.0159411404046597,0.210059171597633
2009,26009,119,676,39,145,24,51,63,196,0.0114372410573613,0.321428571428571
2009,26011,78,747,7,78,0,21,7,99,0.00824313072439634,0.0707070707070707
2009,26013,18,527,0,12,0,10,0,22,0.003511011809767,0
2009,26015,276,1293,25,207,27,76,52,283,0.00709539927290962,0.183745583038869
2009,26017,369,1633,120,493,73,104,193,597,0.00798512653148574,0.323283082077052
2009,26019,94,429,84,213,11,27,95,240,0.0193158953722334,0.395833333333333
2009,26021,316,1394,903,2108,106,285,1009,2393,0.0223202626571652,0.42164646886753
2009,26023,159,1873,75,401,8,11,83,412,0.013200051262335,0.201456310679612
2009,26025,392,2483,292,1030,117,346,409,1376,0.0151463449536033,0.297238372093023
2009,26027,75,617,97,892,3,39,100,931,0.0267405790441176,0.107411385606874
2009,26029,149,661,36,203,8,18,44,221,0.0120890542092883,0.199095022624434
2009,26031,59,625,45,145,4,26,49,171,0.00892717306186374,0.286549707602339
2009,26033,193,1868,63,430,4,15,67,445,0.0165059347181009,0.150561797752809
2009,26035,76,943,17,120,0,13,17,133,0.00610343719884356,0.12781954887218
2009,26037,588,1461,135,269,7,75,142,344,0.00748753890690638,0.412790697674419
2009,26039,54,815,0,24,0,8,0,32,0.00305052430886559,0
2009,26041,98,420,66,340,13,46,79,386,0.0145112781954887,0.204663212435233
2009,26043,74,266,51,340,0,4,51,344,0.0181923951557459,0.148255813953488
2009,26045,753,3723,451,967,77,118,528,1085,0.0151009046624913,0.486635944700461
2009,26047,272,952,135,343,8,39,143,382,0.0165597364314201,0.37434554973822
2009,26049,1129,5885,513,2104,222,546,735,2650,0.00929133416546288,0.277358490566038
2009,26051,120,849,48,112,10,19,58,131,0.00682256132493099,0.442748091603053
2009,26053,46,335,20,196,34,34,54,230,0.0190192673447449,0.234782608695652
2009,26055,473,2803,304,855,13,23,317,878,0.01489322002273,0.361047835990888
2009,26057,133,1635,13,148,7,18,20,166,0.0059770280488244,0.120481927710843
2009,26059,124,926,77,308,19,112,96,420,0.0137066771098492,0.228571428571429
2009,26061,132,609,101,345,55,100,156,445,0.0223494550750841,0.350561797752809
2009,26063,94,563,15,45,0,18,15,63,0.00266937841616881,0.238095238095238
2009,26065,1363,4597,1232,2208,610,1166,1842,3374,0.021574131503731,0.545939537640782
2009,26067,225,2805,47,389,22,49,69,438,0.0106680955744453,0.157534246575342
2009,26069,55,766,35,234,23,23,58,257,0.0131794871794872,0.22568093385214
2009,26071,0,182,34,141,0,5,34,146,0.0166003411028994,0.232876712328767
2009,26073,303,1172,76,296,70,141,146,437,0.0136481464130672,0.334096109839817
2009,26075,601,5239,249,1154,21,77,270,1231,0.0113066480518765,0.219333874898457
2009,26077,1224,3956,742,1794,220,389,962,2183,0.015104130630319,0.440677966101695
2009,26079,22,496,4,67,0,2,4,69,0.00578276902447201,0.0579710144927536
2009,26081,2506,9226,2174,5402,442,1650,2616,7052,0.018407390102504,0.370958593306863
2009,26083,12,69,0,24,0,0,0,24,0.01468788249694,0
2009,26085,19,495,13,85,0,0,13,85,0.0104345691136754,0.152941176470588
2009,26087,665,2248,83,361,0,37,83,398,0.00650869188375934,0.208542713567839
2009,26089,247,491,62,160,5,7,67,167,0.0105562579013906,0.401197604790419
2009,26091,393,1883,399,997,33,538,432,1535,0.0228157793037843,0.2814332247557
2009,26093,1479,4395,339,1282,70,234,409,1516,0.0125176493902187,0.269788918205805
2009,26095,17,530,20,43,0,3,20,46,0.00934010152284264,0.434782608695652
2009,26097,24,233,23,94,0,0,23,94,0.0116784693750776,0.24468085106383
2009,26099,3450,16794,1009,3289,841,2308,1850,5597,0.00981879869269809,0.330534214757906
2009,26101,91,1077,34,112,14,27,48,139,0.00769486271036315,0.345323741007194
2009,26103,114,1151,215,462,28,143,243,605,0.0145948423515789,0.401652892561983
2009,26105,98,513,122,347,3,10,125,357,0.0176584062917347,0.350140056022409
2009,26107,170,1249,22,132,8,89,30,221,0.0089961735732313,0.135746606334842
2009,26109,41,222,91,297,2,19,93,316,0.0181619633312259,0.294303797468354
2009,26111,236,1285,277,943,32,132,309,1075,0.0195803431568977,0.287441860465116
2009,26113,83,422,32,144,0,3,32,147,0.0144770533779791,0.217687074829932
2009,26115,564,2294,313,1794,29,153,342,1947,0.0190108870770883,0.175654853620955
2009,26117,240,1799,39,374,40,124,79,498,0.0119227178050707,0.15863453815261
2009,26119,34,306,4,87,0,18,4,105,0.0133113590263692,0.0380952380952381
2009,26121,307,3699,421,1311,45,147,466,1458,0.0127290664478222,0.319615912208505
2009,26123,233,1722,72,277,6,27,78,304,0.00942928039702233,0.256578947368421
2009,26125,8866,24785,5512,9933,3551,6201,9063,16134,0.019664578407235,0.561732986240238
2009,26127,78,413,18,289,0,63,18,352,0.019325793345778,0.0511363636363636
2009,26129,99,711,8,120,0,2,8,122,0.00784364150700784,0.0655737704918033
2009,26131,6,36,0,20,0,0,0,20,0.00374391613627855,0
2009,26133,69,538,0,107,8,8,8,115,0.00741457124435848,0.0695652173913043
2009,26135,32,289,5,92,0,13,5,105,0.0160403299725023,0.0476190476190476
2009,26137,79,571,34,82,0,6,34,88,0.00540773059669391,0.386363636363636
2009,26139,1343,5352,559,1798,309,489,868,2287,0.0141574842144361,0.379536510712724
2009,26141,47,216,29,78,0,19,29,97,0.00935029882398303,0.298969072164948
2009,26143,133,921,0,103,31,31,31,134,0.00694300518134715,0.23134328358209
2009,26145,582,3592,408,1353,30,97,438,1450,0.0108225916001761,0.302068965517241
2009,26147,341,2721,218,711,18,133,236,844,0.00740467793160324,0.279620853080569
2009,26149,153,660,164,618,12,38,176,656,0.0162621780411017,0.268292682926829
2009,26151,76,749,42,188,6,24,48,212,0.00726500119941057,0.226415094339623
2009,26153,9,264,6,59,0,12,6,71,0.0115353371242892,0.0845070422535211
2009,26155,224,1400,93,505,73,122,166,627,0.0130527104671496,0.264752791068581
2009,26157,96,1412,70,318,9,42,79,360,0.00938306357025569,0.219444444444444
2009,26159,335,1309,197,780,29,72,226,852,0.0165839416058394,0.265258215962441
2009,26161,2533,7206,3527,5306,1245,1758,4772,7064,0.0346087893782764,0.675537938844847
2009,26163,4691,19743,3237,10574,2028,5135,5265,15709,0.012201847404282,0.335158189572856
2009,26165,97,683,68,241,11,34,79,275,0.0128456651718984,0.287272727272727
2009,27001,47,370,24,63,0,0,24,63,0.00524737631184408,0.380952380952381
2009,27003,2340,9574,856,2289,194,886,1050,3175,0.0148892567564399,0.330708661417323
2009,27005,86,633,79,311,6,54,85,365,0.0169680628515643,0.232876712328767
2009,27007,171,765,109,451,11,37,120,488,0.0182123530509423,0.245901639344262
2009,27009,448,2113,59,416,4,9,63,425,0.0166184406037382,0.148235294117647
2009,27011,11,91,10,51,4,8,14,59,0.0155304027375625,0.23728813559322
2009,27013,343,1509,238,458,70,109,308,567,0.01699334652041,0.54320987654321
2009,27015,75,234,9,158,0,13,9,171,0.00989125404905137,0.0526315789473684
2009,27017,248,1159,54,130,3,25,57,155,0.00671257199774804,0.367741935483871
2009,27019,841,2209,420,775,79,143,499,918,0.0166739319965126,0.543572984749455
2009,27021,148,722,41,124,8,11,49,135,0.00666930145242565,0.362962962962963
2009,27023,63,235,24,65,0,3,24,68,0.00796719390743995,0.352941176470588
2009,27025,198,2300,103,149,5,92,108,241,0.00748912367930392,0.448132780082988
2009,27027,102,387,439,993,48,52,487,1045,0.0334164748017396,0.466028708133971
2009,27029,26,179,10,38,0,2,10,40,0.00716589036187746,0.25
2009,27031,20,107,23,40,0,0,23,40,0.00929584011155008,0.575
2009,27033,45,196,0,57,0,44,0,101,0.0131561807997916,0
2009,27035,251,1332,150,385,9,67,159,452,0.0106805293005671,0.351769911504425
2009,27037,3122,8745,2233,4295,400,1195,2633,5490,0.0217980838332863,0.47959927140255
2009,27039,61,281,42,91,0,3,42,94,0.00756052441084211,0.446808510638298
2009,27041,314,741,0,163,0,11,0,174,0.00693309957365422,0
2009,27043,14,167,8,96,0,14,8,110,0.0106962271489693,0.0727272727272727
2009,27045,54,344,46,140,12,26,58,166,0.0117306197441877,0.349397590361446
2009,27047,58,464,59,249,57,97,116,346,0.0157265578837326,0.335260115606936
2009,27049,191,765,176,456,16,46,192,502,0.0163683198017542,0.382470119521912
2009,27051,49,141,8,40,0,11,8,51,0.0121053880845004,0.156862745098039
2009,27053,7838,18232,10063,18055,2704,5098,12767,23153,0.0301149422297258,0.55141882261478
2009,27055,8,86,121,460,58,61,179,521,0.039205357814734,0.343570057581574
2009,27057,114,545,70,272,8,19,78,291,0.0220454545454545,0.268041237113402
2009,27059,201,1765,23,192,13,56,36,248,0.00984869544497836,0.145161290322581
2009,27061,154,701,22,202,6,13,28,215,0.00687933958339999,0.130232558139535
2009,27063,12,168,0,102,4,7,4,109,0.0143364461396817,0.036697247706422
2009,27065,86,508,16,107,10,23,26,130,0.0119091242213265,0.2
2009,27067,158,873,75,166,3,12,78,178,0.00652899534167186,0.438202247191011
2009,27069,1,36,19,70,0,0,19,70,0.0217661691542289,0.271428571428571
2009,27071,37,152,10,101,0,49,10,150,0.0156071168452814,0.0666666666666667
2009,27073,33,115,20,53,0,0,20,53,0.0101766513056836,0.377358490566038
2009,27075,44,214,14,54,10,12,24,66,0.00823147917186331,0.363636363636364
2009,27077,12,73,35,69,12,12,47,81,0.0272635476270616,0.580246913580247
2009,27079,169,700,10,85,12,45,22,130,0.00705371676614216,0.169230769230769
2009,27081,18,53,22,76,0,28,22,104,0.025273390036452,0.211538461538462
2009,27083,40,291,89,348,0,7,89,355,0.0222835980164459,0.250704225352113
2009,27085,192,751,114,263,26,69,140,332,0.0137224105150037,0.421686746987952
2009,27087,11,105,5,10,0,0,5,10,0.0032071840923669,0.5
2009,27089,35,164,7,39,1,5,8,44,0.00672680018345819,0.181818181818182
2009,27091,7,119,14,148,3,20,17,168,0.0117903010737596,0.101190476190476
2009,27093,92,542,10,52,3,28,13,80,0.00518840391724496,0.1625
2009,27095,178,945,7,85,0,0,7,85,0.00488449603493851,0.0823529411764706
2009,27097,117,576,38,172,28,35,66,207,0.00955105430720251,0.318840579710145
2009,27099,102,543,70,246,3,76,73,322,0.0126671911880409,0.226708074534162
2009,27101,13,153,18,35,0,1,18,36,0.00587467362924282,0.5
2009,27103,303,959,167,247,0,6,167,253,0.0135948414830736,0.660079051383399
2009,27105,31,183,61,225,0,20,61,245,0.0187681936571166,0.248979591836735
2009,27107,1,57,14,69,0,6,14,75,0.0163648265328388,0.186666666666667
2009,27109,506,1821,1524,2391,303,469,1827,2860,0.0312036309679672,0.638811188811189
2009,27111,254,1169,122,490,0,35,122,525,0.0131787032156036,0.232380952380952
2009,27113,30,439,0,54,4,6,4,60,0.00646273158121499,0.0666666666666667
2009,27115,60,651,35,334,4,31,39,365,0.0186729421394587,0.106849315068493
2009,27117,5,97,16,76,0,5,16,81,0.0128367670364501,0.197530864197531
2009,27119,22,949,142,533,15,28,157,561,0.0275716321816484,0.279857397504456
2009,27121,37,216,27,42,0,11,27,53,0.00685551675074376,0.509433962264151
2009,27123,5442,13135,2966,5634,919,2038,3885,7672,0.0234053003609029,0.506386861313869
2009,27125,13,197,2,12,0,0,2,12,0.00419287211740042,0.166666666666667
2009,27127,30,231,12,43,12,15,24,58,0.00554917719096824,0.413793103448276
2009,27129,63,327,47,95,3,7,50,102,0.00946196660482375,0.490196078431373
2009,27131,485,2053,260,720,23,89,283,809,0.0215302727877578,0.349814585908529
2009,27133,0,76,14,24,20,33,34,57,0.00903041825095057,0.596491228070175
2009,27135,47,124,1,69,3,30,4,99,0.00953849118412179,0.0404040404040404
2009,27137,621,2363,556,1716,71,321,627,2037,0.0160146545488852,0.30780559646539
2009,27139,1636,4207,485,1016,51,181,536,1197,0.0150915326037622,0.447786131996658
2009,27141,701,2945,186,575,39,56,225,631,0.0119570984613052,0.356576862123613
2009,27143,27,274,2,22,0,13,2,35,0.00352467270896274,0.0571428571428571
2009,27145,771,3104,425,1107,62,229,487,1336,0.0156710027799608,0.364520958083832
2009,27147,210,1059,157,394,9,28,166,422,0.0180110968843363,0.393364928909953
2009,27149,36,196,62,102,15,15,77,117,0.018999675219227,0.658119658119658
2009,27151,41,570,16,60,0,8,16,68,0.00886917960088692,0.235294117647059
2009,27153,104,549,26,66,0,22,26,88,0.0055231280989142,0.295454545454545
2009,27155,9,103,1,23,2,15,3,38,0.0144103147516117,0.0789473684210526
2009,27157,84,303,48,194,0,60,48,254,0.0171101380936342,0.188976377952756
2009,27159,50,292,13,106,1,1,14,107,0.0116266434858198,0.130841121495327
2009,27161,83,311,4,379,0,2,4,381,0.0295371734242965,0.010498687664042
2009,27163,2183,6192,1035,1918,260,474,1295,2392,0.0164815478323182,0.541387959866221
2009,27165,35,234,10,30,13,20,23,50,0.00685682940208448,0.46
2009,27167,3,102,6,160,0,1,6,161,0.0363103292737934,0.0372670807453416
2009,27169,158,621,153,515,21,33,174,548,0.0193298059964727,0.317518248175182
2009,27171,957,3344,175,602,75,198,250,800,0.0109539523229225,0.3125
2009,27173,75,281,8,131,0,16,8,147,0.021301260686857,0.054421768707483
2009,28001,91,244,104,570,12,19,116,589,0.0283705023842782,0.196943972835314
2009,28003,159,612,166,572,0,48,166,620,0.0255575250422524,0.267741935483871
2009,28005,0,116,0,138,0,11,0,149,0.0167679495836147,0
2009,28007,22,299,6,135,24,88,30,223,0.0173703069013865,0.134529147982063
2009,28009,6,164,0,58,0,0,0,58,0.0110813909056171,0
2009,28011,66,580,145,415,98,98,243,513,0.0229294238591159,0.473684210526316
2009,28013,16,236,0,91,0,0,0,91,0.00931041538776345,0
2009,28015,46,225,0,29,0,0,0,29,0.00395364689843217,0
2009,28017,59,277,0,84,0,11,0,95,0.00800269564484879,0
2009,28019,15,125,25,84,0,0,25,84,0.0140491721023583,0.297619047619048
2009,28021,18,67,19,93,0,0,19,93,0.0154254436888373,0.204301075268817
2009,28023,20,332,0,30,0,0,0,30,0.00263574064312072,0
2009,28025,87,540,55,208,9,9,64,217,0.0161602621388144,0.294930875576037
2009,28027,59,258,0,170,0,44,0,214,0.013328350772297,0
2009,28029,78,243,25,165,0,0,25,165,0.00900950092825161,0.151515151515152
2009,28031,89,393,7,64,0,7,7,71,0.00549238028931693,0.0985915492957746
2009,28033,334,1475,1353,5577,163,312,1516,5889,0.0621091154539798,0.257429105111224
2009,28035,613,2114,266,974,43,102,309,1076,0.0245892273589433,0.287174721189591
2009,28037,33,61,0,73,0,0,0,73,0.0138179064925232,0
2009,28039,25,423,131,438,0,6,131,444,0.0323591574958093,0.295045045045045
2009,28041,75,1174,17,165,26,39,43,204,0.0225265017667845,0.21078431372549
2009,28043,34,449,63,341,0,10,63,351,0.0234845443596949,0.179487179487179
2009,28045,218,965,272,835,0,29,272,864,0.0305894848645778,0.314814814814815
2009,28047,729,3624,754,4583,270,911,1024,5494,0.0478038424056801,0.186385147433564
2009,28049,863,3600,814,2402,124,235,938,2637,0.0173498256464241,0.355707243079257
2009,28051,22,294,35,197,0,17,35,214,0.0182112160667177,0.163551401869159
2009,28053,23,155,16,67,0,16,16,83,0.0139919082939987,0.192771084337349
2009,28055,19,233,0,0,0,0,0,0,0,NA
2009,28057,99,407,10,376,0,16,10,392,0.0259259259259259,0.0255102040816327
2009,28059,460,2545,671,2591,23,196,694,2787,0.0325728711343821,0.249013275923933
2009,28061,0,432,0,26,0,0,0,26,0.00224311966180657,0
2009,28063,56,349,0,45,0,0,0,45,0.00756048387096774,0
2009,28065,19,251,13,120,0,0,13,120,0.0141426045963465,0.108333333333333
2009,28067,133,720,74,491,20,79,94,570,0.0132106519572624,0.164912280701754
2009,28069,13,138,0,59,0,0,0,59,0.00913595540414989,0
2009,28071,163,767,368,860,52,63,420,923,0.0407487528144453,0.455037919826652
2009,28073,427,2425,287,722,51,100,338,822,0.0290295239440599,0.411192214111922
2009,28075,140,1333,588,1765,29,124,617,1889,0.0379302036062809,0.326627845420858
2009,28077,7,231,29,85,0,0,29,85,0.00987683011852196,0.341176470588235
2009,28079,35,707,0,164,0,0,0,164,0.012196935891715,0
2009,28081,459,2239,314,883,110,139,424,1022,0.0197851127673991,0.414872798434442
2009,28083,49,425,11,282,0,11,11,293,0.0141580091809616,0.037542662116041
2009,28085,87,444,22,217,0,0,22,217,0.0096141065969607,0.101382488479263
2009,28087,124,855,414,1200,34,149,448,1349,0.0361895053117287,0.332097850259451
2009,28089,1561,3042,760,1325,8,47,768,1372,0.0243046944198406,0.559766763848397
2009,28091,58,389,81,305,10,10,91,315,0.0193619767656279,0.288888888888889
2009,28093,47,955,12,467,0,0,12,467,0.0199274589289524,0.0256959314775161
2009,28095,34,606,14,186,0,23,14,209,0.00850942551199055,0.0669856459330144
2009,28097,13,170,29,121,8,12,37,133,0.0177593804246228,0.278195488721804
2009,28099,64,632,32,235,0,8,32,243,0.0130009095286502,0.131687242798354
2009,28101,25,338,0,90,0,0,0,90,0.00637032842582106,0
2009,28103,8,136,25,69,0,0,25,69,0.00944429236244183,0.36231884057971
2009,28105,284,672,278,601,43,65,321,666,0.0323018721505481,0.481981981981982
2009,28107,71,515,68,379,42,114,110,493,0.0223016375644621,0.223123732251521
2009,28109,187,714,102,1424,0,45,102,1469,0.0396673237382875,0.0694349897889721
2009,28111,0,85,14,47,0,63,14,110,0.0139399315676087,0.127272727272727
2009,28113,50,576,31,827,0,0,31,827,0.0329587119400606,0.0374848851269649
2009,28115,6,585,35,180,18,111,53,291,0.0159338553359251,0.18213058419244
2009,28117,0,412,35,223,0,10,35,233,0.013963801989692,0.150214592274678
2009,28119,12,124,21,135,0,0,21,135,0.0248390064397424,0.155555555555556
2009,28121,1372,5069,572,2099,41,77,613,2176,0.0239226033421284,0.281709558823529
2009,28123,0,291,13,188,0,104,13,292,0.0159982467674775,0.0445205479452055
2009,28125,36,141,5,16,0,0,5,16,0.00487062404870624,0.3125
2009,28127,60,685,13,167,0,37,13,204,0.0112888052681091,0.0637254901960784
2009,28129,65,283,40,69,0,14,40,83,0.00819267594511894,0.481927710843373
2009,28131,95,626,87,326,0,0,87,326,0.0322900158478605,0.266871165644172
2009,28133,106,1697,16,214,1,67,17,281,0.0150751072961373,0.0604982206405694
2009,28135,6,81,14,384,0,0,14,384,0.0458891013384321,0.0364583333333333
2009,28137,43,403,53,165,0,12,53,177,0.010470894462849,0.299435028248588
2009,28139,8,227,0,153,0,0,0,153,0.0108649339582446,0
2009,28141,38,93,49,459,0,89,49,548,0.0411411411411411,0.0894160583941606
2009,28143,123,546,0,289,0,8,0,297,0.0466540999057493,0
2009,28145,76,556,60,301,12,61,72,362,0.0207795189713564,0.198895027624309
2009,28147,124,284,4,262,0,0,4,262,0.0271053176081109,0.0152671755725191
2009,28149,107,666,318,938,30,65,348,1003,0.0326221297079295,0.346959122632104
2009,28151,167,589,235,636,20,32,255,668,0.0196997847179215,0.381736526946108
2009,28153,5,251,5,133,0,53,5,186,0.0140102440494125,0.0268817204301075
2009,28155,71,387,7,93,12,24,19,117,0.017631103074141,0.162393162393162
2009,28157,20,461,43,165,0,0,43,165,0.0247339229500824,0.260606060606061
2009,28159,31,191,54,249,0,10,54,259,0.0202454467286797,0.208494208494208
2009,28161,73,322,8,124,0,0,8,124,0.013760958828099,0.0645161290322581
2009,28163,45,517,98,542,9,78,107,620,0.0337341531095272,0.17258064516129
2009,29001,48,487,132,411,0,12,132,423,0.033630147877246,0.312056737588652
2009,29003,77,654,10,111,23,25,33,136,0.0120353982300885,0.242647058823529
2009,29005,0,22,4,75,0,0,4,75,0.0175029171528588,0.0533333333333333
2009,29007,69,1045,84,418,13,13,97,431,0.0248329108089422,0.225058004640371
2009,29009,100,826,28,847,12,12,40,859,0.036136468806529,0.0465657741559953
2009,29011,71,232,50,143,0,5,50,148,0.0175376229411068,0.337837837837838
2009,29013,9,450,37,258,2,19,39,277,0.0245480326125487,0.140794223826715
2009,29015,9,462,37,252,0,4,37,256,0.0184931012063859,0.14453125
2009,29017,33,330,15,132,0,6,15,138,0.016928361138371,0.108695652173913
2009,29019,842,2413,977,1994,553,672,1530,2666,0.031500714851181,0.573893473368342
2009,29021,301,2462,182,1564,0,86,182,1650,0.0281157345874655,0.11030303030303
2009,29023,23,594,59,492,35,44,94,536,0.0190876393290837,0.175373134328358
2009,29025,30,172,9,66,3,3,12,69,0.0112067565372746,0.173913043478261
2009,29027,254,1922,79,512,16,40,95,552,0.0196210855578858,0.172101449275362
2009,29029,175,1367,318,931,9,87,327,1018,0.0346753866067171,0.321218074656189
2009,29031,342,1392,289,921,80,158,369,1079,0.0239815082346143,0.341983317886932
2009,29033,16,168,0,31,0,0,0,31,0.00465535365670521,0
2009,29035,0,44,0,48,0,0,0,48,0.0120967741935484,0
2009,29037,692,3129,350,1234,25,116,375,1350,0.0213665068135416,0.277777777777778
2009,29039,0,419,68,219,0,9,68,228,0.0238493723849372,0.298245614035088
2009,29041,15,170,14,30,0,1,14,31,0.00571112748710391,0.451612903225806
2009,29043,813,3076,512,1549,17,71,529,1620,0.0340858880215456,0.326543209876543
2009,29045,5,44,4,130,0,0,4,130,0.0265794316090779,0.0307692307692308
2009,29047,1829,6099,1615,3642,99,363,1714,4005,0.0277779704395231,0.427965043695381
2009,29049,27,775,31,202,0,0,31,202,0.0144049062254867,0.153465346534653
2009,29051,393,3018,187,700,72,131,259,831,0.017313942828569,0.311672683513839
2009,29053,89,1047,13,118,0,6,13,124,0.0110261426284901,0.104838709677419
2009,29055,2,609,89,232,0,0,89,232,0.0146003775959723,0.383620689655172
2009,29057,0,239,15,66,0,6,15,72,0.0135593220338983,0.208333333333333
2009,29059,94,524,37,183,0,55,37,238,0.0215794723002992,0.15546218487395
2009,29061,13,133,22,120,0,0,22,120,0.0228745711017918,0.183333333333333
2009,29063,66,1001,27,174,0,1,27,175,0.0196276357110812,0.154285714285714
2009,29065,69,371,12,194,0,8,12,202,0.0194137433925997,0.0594059405940594
2009,29067,3,94,0,91,0,0,0,91,0.010193794107763,0
2009,29069,31,928,41,638,0,36,41,674,0.0320723292886034,0.0608308605341246
2009,29071,477,2329,251,797,0,35,251,832,0.0126106462956227,0.301682692307692
2009,29073,64,496,13,51,0,0,13,51,0.00476190476190476,0.254901960784314
2009,29075,12,120,2,63,0,0,2,63,0.0147402901263453,0.0317460317460317
2009,29077,915,4976,1122,4867,200,517,1322,5384,0.0329928241832989,0.24554234769688
2009,29079,56,209,42,130,0,0,42,130,0.0188187608569774,0.323076923076923
2009,29081,6,38,10,170,0,0,10,170,0.0277732396667211,0.0588235294117647
2009,29083,60,608,21,231,0,13,21,244,0.0154950149234775,0.0860655737704918
2009,29085,0,189,0,155,0,0,0,155,0.0226013414989793,0
2009,29087,19,130,5,39,0,1,5,40,0.0113475177304965,0.125
2009,29089,23,320,4,41,0,0,4,41,0.00642633228840125,0.0975609756097561
2009,29091,38,496,100,533,8,57,108,590,0.022883295194508,0.183050847457627
2009,29093,37,457,0,134,0,4,0,138,0.0200727272727273,0
2009,29095,2018,7477,5037,13320,364,1365,5401,14685,0.0321109944896353,0.367790262172285
2009,29097,479,1810,280,2035,69,179,349,2214,0.0300627325312984,0.157633242999097
2009,29099,920,5438,342,1658,76,266,418,1924,0.0134453311716446,0.217255717255717
2009,29101,202,1134,251,961,108,259,359,1220,0.0430669302456933,0.294262295081967
2009,29103,64,142,5,107,0,21,5,128,0.0469208211143695,0.0390625
2009,29105,88,872,122,418,3,19,125,437,0.0188532723586005,0.28604118993135
2009,29107,61,789,0,169,10,26,10,195,0.00883952855847688,0.0512820512820513
2009,29109,180,1180,54,437,4,11,58,448,0.0182767624020888,0.129464285714286
2009,29111,7,159,24,139,0,0,24,139,0.021667965705378,0.172661870503597
2009,29113,83,1462,118,927,14,18,132,945,0.02919279602113,0.13968253968254
2009,29115,24,198,19,75,0,2,19,77,0.00889556377079482,0.246753246753247
2009,29117,62,442,11,171,1,1,12,172,0.0177447642628701,0.0697674418604651
2009,29119,15,326,14,886,0,122,14,1008,0.0700145863721609,0.0138888888888889
2009,29121,52,208,31,100,0,0,31,100,0.0093214019388516,0.31
2009,29123,34,258,117,384,0,0,117,384,0.0459770114942529,0.3046875
2009,29125,53,298,12,24,0,0,12,24,0.00393378134732011,0.5
2009,29127,102,686,88,275,6,40,94,315,0.017004048582996,0.298412698412698
2009,29129,3,112,0,60,0,4,0,64,0.0263808738664468,0
2009,29131,65,709,24,183,0,90,24,273,0.016548463356974,0.0879120879120879
2009,29133,0,361,10,164,0,79,10,243,0.0269341609399246,0.0411522633744856
2009,29135,113,1006,4,114,11,13,15,127,0.01278051725873,0.118110236220472
2009,29137,63,348,0,27,0,0,0,27,0.00430484693877551,0
2009,29139,48,307,30,52,7,18,37,70,0.00855536543632364,0.528571428571429
2009,29141,109,572,77,336,0,3,77,339,0.0236088864127028,0.227138643067847
2009,29143,182,583,13,231,0,16,13,247,0.0202625102543068,0.0526315789473684
2009,29145,256,1335,286,1141,9,73,295,1214,0.0332047810508465,0.242998352553542
2009,29147,73,703,85,176,7,26,92,202,0.0171841769459804,0.455445544554455
2009,29149,19,197,9,262,0,0,9,262,0.0362931153899432,0.0343511450381679
2009,29151,72,411,3,59,0,19,3,78,0.00878675228117607,0.0384615384615385
2009,29153,12,134,3,126,0,3,3,129,0.0187800262046877,0.0232558139534884
2009,29155,32,173,13,156,0,0,13,156,0.013347022587269,0.0833333333333333
2009,29157,70,258,0,129,16,23,16,152,0.0121961004573538,0.105263157894737
2009,29159,95,538,163,524,34,81,197,605,0.0228164127319354,0.325619834710744
2009,29161,152,1094,299,738,26,268,325,1006,0.0396125374074657,0.323061630218688
2009,29163,50,1140,13,238,30,50,43,288,0.0229244607179814,0.149305555555556
2009,29165,907,3159,1066,2840,96,245,1162,3085,0.0529114141154275,0.376661264181524
2009,29167,122,829,17,309,0,0,17,309,0.0161172543292301,0.0550161812297735
2009,29169,108,915,654,2673,153,455,807,3128,0.132542372881356,0.257992327365729
2009,29171,8,83,0,59,0,1,0,60,0.0176159718144451,0
2009,29173,5,100,0,67,0,6,0,73,0.0108906459794122,0
2009,29175,52,1461,25,172,0,9,25,181,0.0104806022003474,0.138121546961326
2009,29177,43,529,30,94,0,7,30,101,0.00650144834245253,0.297029702970297
2009,29179,12,148,0,31,0,0,0,31,0.00684780207643031,0
2009,29181,14,287,11,205,0,9,11,214,0.0232482346550788,0.0514018691588785
2009,29183,3224,8677,1781,4038,243,449,2024,4487,0.0200974639661026,0.451080900378872
2009,29185,22,352,30,225,0,32,30,257,0.037989652623799,0.116731517509728
2009,29186,84,413,36,81,0,19,36,100,0.00820546483958316,0.36
2009,29187,445,3513,83,462,0,14,83,476,0.0110451085947652,0.17436974789916
2009,29189,6482,21143,6715,12554,1461,2246,8176,14800,0.022189837054629,0.552432432432432
2009,29195,86,467,119,287,0,23,119,310,0.0210140997830803,0.383870967741935
2009,29197,14,78,34,86,0,0,34,86,0.0317460317460317,0.395348837209302
2009,29199,0,24,8,27,0,0,8,27,0.00823421774931381,0.296296296296296
2009,29201,42,788,59,630,7,20,66,650,0.024234741433951,0.101538461538462
2009,29203,1,123,97,199,0,14,97,213,0.0380833184337565,0.455399061032864
2009,29205,5,163,3,118,0,0,3,118,0.0270828551755795,0.0254237288135593
2009,29207,40,753,38,209,0,14,38,223,0.0110461660392312,0.170403587443946
2009,29209,190,1032,110,1128,7,64,117,1192,0.0521070117153348,0.0981543624161074
2009,29211,37,167,19,170,6,27,25,197,0.0427981751031936,0.126903553299492
2009,29213,359,1327,287,1905,3,33,290,1938,0.0625625464053976,0.149638802889577
2009,29215,32,650,76,450,0,10,76,460,0.0271819417360988,0.165217391304348
2009,29217,117,423,41,226,0,0,41,226,0.0173246454580299,0.18141592920354
2009,29219,108,1179,63,347,0,10,63,357,0.0177850844417875,0.176470588235294
2009,29221,73,868,31,129,0,7,31,136,0.00846877140544243,0.227941176470588
2009,29223,72,296,12,112,0,0,12,112,0.0125279642058166,0.107142857142857
2009,29225,89,1390,49,369,0,0,49,369,0.0162648212632785,0.132791327913279
2009,29227,8,91,0,19,0,2,0,21,0.0144927536231884,0
2009,29229,56,393,42,160,0,17,42,177,0.0147783251231527,0.23728813559322
2009,29510,3660,10954,3047,5936,531,1283,3578,7219,0.0302174113234715,0.495636514752736
2009,30001,5,64,53,104,0,0,53,104,0.0188953488372093,0.509615384615385
2009,30003,6,354,7,143,0,9,7,152,0.0207366984993179,0.0460526315789474
2009,30005,23,56,12,49,0,20,12,69,0.0176832393644285,0.173913043478261
2009,30007,5,80,0,234,0,0,0,234,0.0775091089764823,0
2009,30009,29,332,26,125,0,4,26,129,0.0180976430976431,0.201550387596899
2009,30011,16,27,4,10,0,0,4,10,0.01001001001001,0.4
2009,30013,245,1255,341,1585,50,114,391,1699,0.0315993081258021,0.230135373749264
2009,30015,19,76,6,57,22,22,28,79,0.0222974880045159,0.354430379746835
2009,30017,31,142,10,323,0,0,10,323,0.0423884514435696,0.0309597523219814
2009,30019,0,2,0,19,0,0,0,19,0.0168439716312057,0
2009,30021,16,418,13,145,0,0,13,145,0.024126455906822,0.0896551724137931
2009,30023,47,301,24,65,0,9,24,74,0.0117534942820839,0.324324324324324
2009,30025,0,31,5,85,0,3,5,88,0.0483250961010434,0.0568181818181818
2009,30027,43,136,59,404,10,21,69,425,0.0535466801058334,0.162352941176471
2009,30029,190,608,595,1570,8,47,603,1617,0.0275116971501489,0.37291280148423
2009,30031,624,1344,1416,2746,123,231,1539,2977,0.0581320419441136,0.516963385959019
2009,30033,5,7,0,3,0,0,0,3,0.00379266750948167,0
2009,30035,34,285,6,116,0,0,6,116,0.0150103519668737,0.0517241379310345
2009,30037,8,25,0,17,0,10,0,27,0.0449251247920133,0
2009,30039,14,133,4,26,0,0,4,26,0.0121099208197485,0.153846153846154
2009,30041,16,281,37,267,0,29,37,296,0.0289231971858511,0.125
2009,30043,136,367,61,221,3,11,64,232,0.0305423907319642,0.275862068965517
2009,30045,21,60,6,11,0,0,6,11,0.00652818991097923,0.545454545454545
2009,30047,84,419,134,624,0,2,134,626,0.0339903350165608,0.21405750798722
2009,30049,529,1331,450,1439,43,113,493,1552,0.0379870765615821,0.317654639175258
2009,30051,0,2,0,0,0,0,0,0,0,NA
2009,30053,25,104,47,390,20,39,67,429,0.0316231755860239,0.156177156177156
2009,30055,0,16,0,15,0,0,0,15,0.0120967741935484,0
2009,30057,32,209,61,255,0,16,61,271,0.049416484318016,0.225092250922509
2009,30059,0,27,20,36,0,0,20,36,0.03281677301732,0.555555555555556
2009,30061,15,20,5,32,0,5,5,37,0.0133525802959221,0.135135135135135
2009,30063,432,1795,1278,2681,47,230,1325,2911,0.044456322541234,0.455170044658193
2009,30065,11,70,34,85,0,9,34,94,0.029247044181705,0.361702127659574
2009,30067,69,193,149,455,52,59,201,514,0.0442759927642346,0.391050583657588
2009,30069,0,5,0,15,0,0,0,15,0.0401069518716578,0
2009,30071,16,52,21,30,0,0,21,30,0.0100704934541793,0.7
2009,30073,20,70,12,51,0,0,12,51,0.0130869899923018,0.235294117647059
2009,30075,8,31,12,44,0,0,12,44,0.0388007054673721,0.272727272727273
2009,30077,35,424,76,99,0,1,76,100,0.0192122958693564,0.76
2009,30079,1,1,15,15,0,0,15,15,0.0183374083129584,1
2009,30081,78,440,453,1200,29,68,482,1268,0.0454561749417458,0.3801261829653
2009,30083,42,189,12,82,0,0,12,82,0.0132045088566828,0.146341463414634
2009,30085,19,78,32,93,0,4,32,97,0.0170414617006325,0.329896907216495
2009,30087,40,142,11,81,0,0,11,81,0.0148215919487649,0.135802469135802
2009,30089,27,231,41,278,0,0,41,278,0.0347804328787689,0.147482014388489
2009,30091,16,68,0,70,0,4,0,74,0.0264097073518915,0
2009,30093,148,760,218,631,33,43,251,674,0.0297676883667521,0.372403560830861
2009,30095,39,117,26,112,0,21,26,133,0.022140835691693,0.195488721804511
2009,30097,5,22,11,194,0,12,11,206,0.0773563650018776,0.0533980582524272
2009,30099,13,129,9,58,10,11,19,69,0.0163662239089184,0.27536231884058
2009,30101,38,315,0,115,0,6,0,121,0.0339601459444289,0
2009,30103,0,13,11,22,0,0,11,22,0.0370994940978078,0.5
2009,30105,19,91,39,102,0,3,39,105,0.0218476903870162,0.371428571428571
2009,30107,4,7,0,0,0,9,0,9,0.00598006644518272,0
2009,30109,0,5,0,29,0,0,0,29,0.0446153846153846,0
2009,30111,686,2191,792,3156,94,247,886,3403,0.036159812984805,0.26035850719953
2009,31001,146,580,197,592,0,33,197,625,0.0292219936412942,0.3152
2009,31003,20,133,32,67,0,0,32,67,0.0146704620100723,0.477611940298507
2009,31005,3,11,0,18,0,0,0,18,0.0865384615384615,0
2009,31007,0,25,0,0,0,4,0,4,0.0071301247771836,0
2009,31009,0,4,0,7,0,0,0,7,0.0194986072423398,0
2009,31011,39,139,13,35,0,0,13,35,0.00899511693652017,0.371428571428571
2009,31013,63,146,26,213,20,20,46,233,0.0312332439678284,0.197424892703863
2009,31015,5,52,0,2,0,0,0,2,0.00130890052356021,0
2009,31017,5,52,3,78,0,4,3,82,0.0364931019136627,0.0365853658536585
2009,31019,274,674,148,428,16,71,164,499,0.0199010927654144,0.328657314629259
2009,31021,31,122,22,36,0,0,22,36,0.00710900473933649,0.611111111111111
2009,31023,38,198,4,39,0,4,4,43,0.00761871013465627,0.0930232558139535
2009,31025,162,569,53,193,0,33,53,226,0.0132582424029098,0.234513274336283
2009,31027,55,144,13,82,2,8,15,90,0.0159687721788502,0.166666666666667
2009,31029,0,27,20,72,0,1,20,73,0.0277145026575551,0.273972602739726
2009,31031,9,66,29,83,0,0,29,83,0.0214083053907661,0.349397590361446
2009,31033,115,271,10,161,0,6,10,167,0.0249775650613222,0.0598802395209581
2009,31035,38,172,12,46,4,8,16,54,0.012670107930549,0.296296296296296
2009,31037,47,133,0,8,0,78,0,86,0.0142525687769307,0
2009,31039,15,66,12,31,0,0,12,31,0.00497672178519827,0.387096774193548
2009,31041,21,136,41,79,16,16,57,95,0.012577783662121,0.6
2009,31043,11,141,79,536,16,52,95,588,0.0483512869007483,0.16156462585034
2009,31045,32,135,58,136,0,0,58,136,0.0291470210030004,0.426470588235294
2009,31047,106,283,60,402,0,158,60,560,0.0369222654447155,0.107142857142857
2009,31049,32,59,6,73,6,6,12,79,0.0556730091613813,0.151898734177215
2009,31051,5,78,4,89,0,0,4,89,0.0213788133557531,0.0449438202247191
2009,31053,161,915,103,306,0,45,103,351,0.0146292668695036,0.293447293447293
2009,31055,2140,5727,3369,8498,1137,2051,4506,10549,0.0330769496085262,0.427149492842923
2009,31057,0,29,8,38,0,0,8,38,0.0254691689008043,0.210526315789474
2009,31059,22,123,24,39,0,0,24,39,0.00942028985507246,0.615384615384615
2009,31061,19,139,6,73,0,6,6,79,0.0329853862212944,0.0759493670886076
2009,31063,23,72,3,19,0,0,3,19,0.0103204780010864,0.157894736842105
2009,31065,32,73,3,52,0,0,3,52,0.0156862745098039,0.0576923076923077
2009,31067,118,597,38,282,0,6,38,288,0.0182532640385347,0.131944444444444
2009,31069,27,32,3,54,0,6,3,60,0.0408441116405718,0.05
2009,31071,0,53,29,45,0,7,29,52,0.0374909877433309,0.557692307692308
2009,31073,21,42,0,0,0,0,0,0,0,NA
2009,31075,2,8,0,23,0,0,0,23,0.0523917995444191,0
2009,31077,6,40,0,3,0,0,0,3,0.00186799501867995,0
2009,31079,231,1241,49,896,53,175,102,1071,0.0303666109047606,0.0952380952380952
2009,31081,34,283,27,76,0,6,27,82,0.013407455853499,0.329268292682927
2009,31083,6,44,32,52,0,4,32,56,0.0233333333333333,0.571428571428571
2009,31085,4,9,0,1,0,0,0,1,0.00138312586445367,0
2009,31087,0,34,3,38,0,0,3,38,0.0184376516254246,0.0789473684210526
2009,31089,57,214,54,109,0,0,54,109,0.0155959364715982,0.495412844036697
2009,31091,2,21,0,0,0,0,0,0,0,NA
2009,31093,10,182,0,29,0,0,0,29,0.00664071444927868,0
2009,31095,18,171,19,47,0,14,19,61,0.0114747930775019,0.311475409836066
2009,31097,37,262,9,56,0,9,9,65,0.0166709412669915,0.138461538461538
2009,31099,4,145,62,81,0,0,62,81,0.0181410974244121,0.765432098765432
2009,31101,29,121,15,306,12,12,27,318,0.0555361508906741,0.0849056603773585
2009,31103,0,2,3,6,0,0,3,6,0.00983606557377049,0.5
2009,31105,44,58,24,80,0,0,24,80,0.0303720577069096,0.3
2009,31107,42,140,19,71,0,6,19,77,0.0129259694477086,0.246753246753247
2009,31109,952,4103,1564,3729,425,1057,1989,4786,0.0294700804177288,0.415587129126619
2009,31111,179,529,57,545,0,54,57,599,0.0252444369521241,0.0951585976627713
2009,31113,0,36,1,3,0,0,1,3,0.00601202404809619,0.333333333333333
2009,31115,1,2,0,1,0,0,0,1,0.00263157894736842,0
2009,31117,0,7,0,5,0,0,0,5,0.0141242937853107,0
2009,31119,140,803,184,506,30,90,214,596,0.0265703713610628,0.359060402684564
2009,31121,47,187,29,39,0,2,29,41,0.00786495300211011,0.707317073170732
2009,31123,21,43,50,121,0,0,50,121,0.0361409796893668,0.413223140495868
2009,31125,12,110,3,7,1,2,4,9,0.00368098159509202,0.444444444444444
2009,31127,31,78,62,101,0,0,62,101,0.0216505894962487,0.613861386138614
2009,31129,2,16,9,80,0,22,9,102,0.0317658050451573,0.0882352941176471
2009,31131,67,368,18,238,3,3,21,241,0.0231909160892995,0.0871369294605809
2009,31133,6,35,0,24,0,0,0,24,0.0120785103170609,0
2009,31135,0,23,4,7,0,0,4,7,0.00367068694284216,0.571428571428571
2009,31137,19,296,17,60,0,4,17,64,0.0101394169835234,0.265625
2009,31139,21,103,0,53,0,3,0,56,0.011686143572621,0
2009,31141,97,446,52,205,0,17,52,222,0.0109435078379178,0.234234234234234
2009,31143,16,100,7,37,0,0,7,37,0.0103583426651736,0.189189189189189
2009,31145,41,366,12,96,0,0,12,96,0.01309150415928,0.125
2009,31147,4,57,19,140,0,0,19,140,0.0237368599525263,0.135714285714286
2009,31149,5,16,0,6,0,0,0,6,0.00525854513584575,0
2009,31151,67,355,4,108,0,4,4,112,0.0128043900765977,0.0357142857142857
2009,31153,1354,4150,1390,3338,115,410,1505,3748,0.0415889924545051,0.401547491995731
2009,31155,179,480,22,91,1,12,23,103,0.00771304478059009,0.223300970873786
2009,31157,186,476,162,933,21,37,183,970,0.0400561612157251,0.188659793814433
2009,31159,65,312,111,246,28,47,139,293,0.0295631116940773,0.474402730375427
2009,31161,14,36,41,124,4,4,45,128,0.0339072847682119,0.3515625
2009,31163,7,43,1,14,0,0,1,14,0.00654511453950444,0.0714285714285714
2009,31165,7,51,4,8,0,0,4,8,0.00900900900900901,0.5
2009,31167,30,126,1,11,0,12,1,23,0.00568884491714074,0.0434782608695652
2009,31169,19,137,8,19,0,0,8,19,0.00506801813817018,0.421052631578947
2009,31171,9,22,3,3,0,0,3,3,0.00584795321637427,1
2009,31173,8,37,11,85,0,0,11,85,0.0222980062959077,0.129411764705882
2009,31175,10,43,0,7,0,0,0,7,0.0023592854735423,0
2009,31177,120,356,126,276,0,6,126,282,0.022084736471141,0.446808510638298
2009,31179,32,59,51,66,0,8,51,74,0.015948275862069,0.689189189189189
2009,31181,30,242,3,13,3,4,6,17,0.00645161290322581,0.352941176470588
2009,31183,0,10,2,9,0,0,2,9,0.0182186234817814,0.222222222222222
2009,31185,77,417,60,181,0,4,60,185,0.0196474086661003,0.324324324324324
2009,32001,30,315,164,621,26,127,190,748,0.0473417721518987,0.254010695187166
2009,32003,531,2727,16344,62321,2568,8840,18912,71161,0.0601475606179323,0.265763550259271
2009,32005,112,808,511,1326,40,71,551,1397,0.0420605768651773,0.394416607015032
2009,32007,81,591,183,1198,0,17,183,1215,0.0429086029100155,0.150617283950617
2009,32009,9,33,0,15,0,0,0,15,0.0214899713467049,0
2009,32011,0,16,0,0,0,8,0,8,0.00858369098712446,0
2009,32013,109,461,50,332,0,10,50,342,0.0305876039710223,0.146198830409357
2009,32015,27,127,13,161,0,0,13,161,0.0504385964912281,0.0807453416149068
2009,32017,40,329,19,128,0,0,19,128,0.0495164410058027,0.1484375
2009,32019,174,1540,70,1329,7,15,77,1344,0.0405356496561708,0.0572916666666667
2009,32021,0,42,0,22,0,0,0,22,0.00569653029518384,0
2009,32023,51,975,309,1860,0,179,309,2039,0.065411266521237,0.151544874938695
2009,32027,51,751,0,35,0,0,0,35,0.00746587030716724,0
2009,32029,0,281,0,7,0,0,0,7,0.00221029365329965,0
2009,32031,975,3981,3162,10451,708,1742,3870,12193,0.0458914833717236,0.317395226769458
2009,32033,9,176,18,110,0,1,18,111,0.0175244711083044,0.162162162162162
2009,32510,216,1527,384,1014,8,200,392,1214,0.032735607388432,0.322899505766063
2009,33001,180,910,161,613,45,70,206,683,0.0157098169104793,0.301610541727672
2009,33003,202,590,456,1033,15,26,471,1059,0.0304153024297777,0.444759206798867
2009,33005,210,571,767,1795,35,56,802,1851,0.0356002615686425,0.433279308481902
2009,33007,107,463,125,491,14,40,139,531,0.0226323416588526,0.261770244821092
2009,33009,172,856,1342,2179,358,437,1700,2616,0.0457734772794877,0.649847094801223
2009,33011,1227,4531,3349,7610,419,1225,3768,8835,0.032779039223543,0.426485568760611
2009,33013,772,3278,928,2290,269,309,1197,2599,0.0259083885759856,0.46056175452097
2009,33015,1205,3615,2505,5958,431,723,2936,6681,0.0329369657171592,0.43945517138153
2009,33017,776,2118,662,2094,95,232,757,2326,0.030745234885135,0.325451418744626
2009,33019,135,652,356,1018,19,19,375,1037,0.0343229735544302,0.361620057859209
2009,34001,1090,3662,1020,3318,231,935,1251,4253,0.0233509394182305,0.29414530919351
2009,34003,4514,9835,5548,10232,2729,4819,8277,15051,0.0242738488831546,0.549930237193542
2009,34005,2574,7857,2683,6342,586,1429,3269,7771,0.0257115253541911,0.420666580877622
2009,34007,2284,8115,2438,5975,232,1098,2670,7073,0.0206969605637018,0.377491870493426
2009,34009,558,1314,612,1797,48,184,660,1981,0.0280439983578476,0.3331650681474
2009,34011,425,4376,163,1037,58,376,221,1413,0.0138271846560329,0.156404812455768
2009,34013,3301,9419,3231,7842,1051,4405,4282,12247,0.0242379502931037,0.349636645709153
2009,34015,1277,5220,1087,2842,158,560,1245,3402,0.017929515186331,0.365961199294533
2009,34017,3765,7096,8499,12815,3003,5456,11502,18271,0.0440054046372944,0.629522193640195
2009,34019,1629,3643,847,1466,88,211,935,1677,0.0190421038288595,0.557543231961837
2009,34021,3442,6852,3239,5478,1390,2150,4629,7628,0.0318288220248105,0.606843209229156
2009,34023,5802,12450,4922,8255,3412,5668,8334,13923,0.0264481115140371,0.59857789269554
2009,34025,3930,9076,2956,6933,697,1678,3653,8611,0.0199823173547505,0.424224828707467
2009,34027,4178,8885,2980,4859,1292,2221,4272,7080,0.0214826030360865,0.603389830508475
2009,34029,3173,10770,1583,5043,318,859,1901,5902,0.014975362458578,0.322094205354117
2009,34031,2144,7463,831,2672,480,1576,1311,4248,0.0133394461994511,0.30861581920904
2009,34033,196,1108,156,763,64,112,220,875,0.0196373266304592,0.251428571428571
2009,34035,4226,7601,1875,3515,1123,1809,2998,5324,0.0245470053944396,0.563110443275733
2009,34037,1009,3249,565,1209,37,176,602,1385,0.013657968956472,0.434657039711191
2009,34039,2975,8006,1750,3810,778,2284,2528,6094,0.0174736848141808,0.414834263209714
2009,34041,947,2688,258,1190,45,107,303,1297,0.0173592986682728,0.233616037008481
2009,35001,1855,7200,5722,14324,1318,2691,7040,17015,0.0413478198532717,0.413752571260652
2009,35003,11,77,30,181,0,0,30,181,0.0609017496635262,0.165745856353591
2009,35005,146,1034,170,1259,0,64,170,1323,0.0343306432778888,0.128495842781557
2009,35006,59,1348,0,205,0,0,0,205,0.0120397016503201,0
2009,35007,38,194,46,250,22,22,68,272,0.0294659300184162,0.25
2009,35009,177,505,333,1158,62,355,395,1513,0.0572347266881029,0.261070720423001
2009,35011,0,30,0,27,0,0,0,27,0.0185950413223141,0
2009,35013,413,1990,1685,4795,285,1042,1970,5837,0.0491743892165122,0.33750214151105
2009,35015,117,501,196,957,42,58,238,1015,0.0309555033700326,0.23448275862069
2009,35017,51,211,183,1018,0,8,183,1026,0.0498300145701797,0.178362573099415
2009,35019,0,241,0,114,0,0,0,114,0.037085230969421,0
2009,35021,0,14,0,6,0,0,0,6,0.0122448979591837,0
2009,35023,4,15,18,68,6,6,24,74,0.0230027976375505,0.324324324324324
2009,35025,61,1015,199,1266,34,145,233,1411,0.040757965279182,0.165131112686038
2009,35027,197,397,138,370,0,70,138,440,0.0296675881599353,0.313636363636364
2009,35028,135,276,280,375,39,55,319,430,0.0332200247218789,0.741860465116279
2009,35029,16,211,187,863,0,32,187,895,0.0527214891611687,0.208938547486034
2009,35031,14,253,240,978,93,169,333,1147,0.0293628241558508,0.290322580645161
2009,35033,35,120,7,30,0,13,7,43,0.0117872807017544,0.162790697674419
2009,35035,63,613,412,1619,79,382,491,2001,0.0501704944338582,0.245377311344328
2009,35037,30,107,36,148,0,53,36,201,0.0316734951150331,0.17910447761194
2009,35039,74,618,138,544,7,7,145,551,0.0212323224538553,0.263157894736842
2009,35041,13,224,97,393,34,104,131,497,0.051068639539663,0.263581488933602
2009,35043,1102,3276,1227,3282,179,356,1406,3638,0.047889215053905,0.386476085761407
2009,35045,206,932,348,2162,46,154,394,2316,0.0312070498827714,0.170120898100173
2009,35047,74,450,109,365,0,0,109,365,0.0198164938378848,0.298630136986301
2009,35049,776,3123,2391,4705,150,347,2541,5052,0.0504892015870319,0.502969121140142
2009,35051,14,160,49,133,0,9,49,142,0.014852002928564,0.345070422535211
2009,35053,57,299,66,148,39,51,105,199,0.0182184381580152,0.527638190954774
2009,35055,118,432,278,748,10,72,288,820,0.0371696659262953,0.351219512195122
2009,35057,85,790,8,278,0,310,8,588,0.0549738219895288,0.0136054421768707
2009,35059,4,22,5,119,0,0,5,119,0.051897078063672,0.0420168067226891
2009,35061,179,2175,221,1053,40,84,261,1137,0.0253150465333749,0.229551451187335
2009,36001,2065,6118,1643,2905,542,1057,2185,3962,0.0208485715939528,0.551489146895507
2009,36003,135,725,176,330,23,43,199,373,0.0122499917895497,0.533512064343164
2009,36005,3852,24225,1985,7330,1580,6896,3565,14226,0.0168175708504896,0.250597497539716
2009,36007,679,2343,738,1812,283,374,1021,2186,0.0165623626748291,0.467063129002745
2009,36009,219,1261,193,599,28,52,221,651,0.0122559632509366,0.339477726574501
2009,36011,121,2307,133,581,17,46,150,627,0.0114503816793893,0.239234449760766
2009,36013,258,1464,316,1085,19,150,335,1235,0.0136813302462639,0.271255060728745
2009,36015,322,2146,352,1048,35,107,387,1155,0.0193941632803842,0.335064935064935
2009,36017,110,809,89,432,10,14,99,446,0.0128308400460299,0.221973094170404
2009,36019,145,2206,170,522,68,121,238,643,0.0115268092429593,0.370139968895801
2009,36021,387,1417,190,585,3,20,193,605,0.013748125255647,0.31900826446281
2009,36023,112,668,149,238,44,75,193,313,0.0108349487676544,0.616613418530351
2009,36025,171,1059,109,455,0,6,109,461,0.0143354686236706,0.23644251626898
2009,36027,1500,6413,1068,2673,146,592,1214,3265,0.0168821969089809,0.371822358346095
2009,36029,1957,7052,3024,6562,907,1985,3931,8547,0.0137043628842176,0.45992745992746
2009,36031,244,1095,238,728,16,29,254,757,0.027746215592127,0.33553500660502
2009,36033,263,2704,61,299,15,42,76,341,0.00978872430818693,0.222873900293255
2009,36035,160,1476,76,347,27,167,103,514,0.0134196647694637,0.200389105058366
2009,36037,201,1217,86,509,0,8,86,517,0.0130243103665449,0.166344294003868
2009,36039,176,1837,53,207,4,21,57,228,0.00676136532131313,0.25
2009,36041,6,86,15,71,0,0,15,71,0.0180157320477036,0.211267605633803
2009,36043,328,1072,83,319,5,56,88,375,0.00870190745811482,0.234666666666667
2009,36045,384,1645,687,2603,294,1137,981,3740,0.052617510094402,0.262299465240642
2009,36047,12574,24408,8916,15246,4598,14017,13514,29263,0.0176153140002107,0.461811844308512
2009,36049,81,296,26,98,10,42,36,140,0.00801740923147406,0.257142857142857
2009,36051,216,1844,102,318,8,42,110,360,0.00918953414167198,0.305555555555556
2009,36053,310,1233,275,668,19,83,294,751,0.0168900683699172,0.391478029294274
2009,36055,2171,6450,2739,5150,1182,2080,3921,7230,0.015053750007808,0.542323651452282
2009,36057,156,1339,46,185,14,129,60,314,0.009444177093359,0.191082802547771
2009,36059,7358,16269,2531,5156,1444,3699,3975,8855,0.00967739467705042,0.448898927159797
2009,36061,15650,30118,28231,34620,13855,19110,42086,53730,0.0442311776705407,0.783286804392332
2009,36063,643,2981,360,1267,38,366,398,1633,0.0110923935931747,0.243723208818126
2009,36065,717,5620,426,1766,198,445,624,2211,0.0141096738374356,0.282225237449118
2009,36067,1812,5390,1647,3715,887,1595,2534,5310,0.0176240403859366,0.477212806026365
2009,36069,692,2239,447,921,55,160,502,1081,0.015360568383659,0.464384828862165
2009,36071,1829,6265,1678,4016,336,1414,2014,5430,0.023383200268713,0.370902394106814
2009,36073,121,1637,35,289,0,10,35,299,0.0105664911474715,0.117056856187291
2009,36075,399,1757,173,672,28,135,201,807,0.0102572576135035,0.24907063197026
2009,36077,188,737,281,692,30,41,311,733,0.0190766187799292,0.424283765347885
2009,36079,913,2896,316,720,52,161,368,881,0.0132085938319915,0.417707150964813
2009,36081,12622,31849,5943,12692,6025,15698,11968,28390,0.0177944976830799,0.421556886227545
2009,36083,1259,4246,527,1134,338,445,865,1579,0.0150355177207717,0.547815072830906
2009,36085,2024,6385,732,2078,325,954,1057,3032,0.00928369780216416,0.348614775725594
2009,36087,1261,2828,884,1481,329,931,1213,2412,0.0129388729447738,0.502902155887231
2009,36089,340,2033,194,837,32,156,226,993,0.0143575952112432,0.227593152064451
2009,36091,1234,4420,1217,2198,245,631,1462,2829,0.0190783839010541,0.516790385295157
2009,36093,1283,3997,792,1496,115,328,907,1824,0.0179619490290306,0.497258771929825
2009,36095,38,733,27,192,0,0,27,192,0.00900056253515845,0.140625
2009,36097,65,594,28,242,0,14,28,256,0.0195270785659802,0.109375
2009,36099,166,1365,46,316,11,35,57,351,0.0148558852160664,0.162393162393162
2009,36101,329,1557,327,910,121,183,448,1093,0.0166056425760775,0.409881061299177
2009,36103,6211,15904,2781,6265,1695,3963,4476,10228,0.010168221028573,0.437622213531482
2009,36105,401,2310,221,682,112,258,333,940,0.0180765754504721,0.354255319148936
2009,36107,116,503,99,402,23,23,122,425,0.0124611505306984,0.287058823529412
2009,36109,649,1336,829,1342,682,900,1511,2242,0.0418049599104979,0.673951828724353
2009,36111,1406,5487,687,1382,106,329,793,1711,0.0136162153128705,0.463471654003507
2009,36113,196,1469,201,583,52,125,253,708,0.0153034757046516,0.357344632768362
2009,36115,258,2421,155,594,18,53,173,647,0.0149692286335662,0.267387944358578
2009,36117,504,1884,250,923,0,128,250,1051,0.0170122533546998,0.237868696479543
2009,36119,6262,12764,3922,5748,1917,4292,5839,10040,0.0157528002799103,0.581573705179283
2009,36121,146,2412,8,163,16,53,24,216,0.00732551041172082,0.111111111111111
2009,36123,102,400,141,194,13,29,154,223,0.0141578312488096,0.690582959641256
2009,37001,808,3277,647,1971,52,310,699,2281,0.0237075685451182,0.306444541867602
2009,37003,180,899,50,269,14,27,64,296,0.0117904799840669,0.216216216216216
2009,37005,22,64,19,154,0,111,19,265,0.033459595959596,0.0716981132075472
2009,37007,0,967,11,216,0,0,11,216,0.0123393316195373,0.0509259259259259
2009,37009,87,247,79,324,0,29,79,353,0.0188036009162094,0.223796033994334
2009,37011,285,876,105,331,0,7,105,338,0.0263856362217018,0.310650887573964
2009,37013,130,854,153,672,0,24,153,696,0.0216599757258893,0.219827586206897
2009,37015,64,542,22,262,0,0,22,262,0.0201228878648233,0.083969465648855
2009,37017,72,742,17,619,0,67,17,686,0.0317225433526012,0.0247813411078717
2009,37019,577,2537,580,2314,8,212,588,2526,0.0344771108017361,0.232779097387173
2009,37021,1073,3637,2704,5970,162,612,2866,6582,0.0412605078891445,0.435429960498329
2009,37023,160,1703,95,851,10,117,105,968,0.0158936047943519,0.108471074380165
2009,37025,991,3624,770,2821,45,379,815,3200,0.0305492176536292,0.2546875
2009,37027,207,1171,211,894,43,62,254,956,0.017290962035848,0.265690376569038
2009,37029,27,161,76,140,23,23,99,163,0.027344405301124,0.607361963190184
2009,37031,391,1731,419,1115,82,187,501,1302,0.0281027412044032,0.384792626728111
2009,37033,35,1087,18,120,0,17,18,137,0.00836079580129379,0.131386861313869
2009,37035,577,3194,666,2051,64,358,730,2409,0.0229605695822492,0.303030303030303
2009,37037,728,1614,512,1170,0,55,512,1225,0.0279776179056755,0.417959183673469
2009,37039,115,350,83,529,0,18,83,547,0.0283038393873538,0.151736745886654
2009,37041,0,323,49,213,13,31,62,244,0.0248954188348128,0.254098360655738
2009,37043,0,136,43,202,0,0,43,202,0.0265231092436975,0.212871287128713
2009,37045,353,2247,249,1125,12,36,261,1161,0.017673922971533,0.224806201550388
2009,37047,27,798,53,518,0,29,53,547,0.0151746331178739,0.0968921389396709
2009,37049,479,2189,648,2743,145,529,793,3272,0.0538025158266875,0.242359413202934
2009,37051,801,3495,3091,9965,763,3363,3854,13328,0.0746139979622227,0.289165666266507
2009,37053,14,232,83,512,0,0,83,512,0.0319241800723282,0.162109375
2009,37055,202,563,302,907,41,104,343,1011,0.0412350110123175,0.339268051434224
2009,37057,638,3561,318,1507,31,228,349,1735,0.0162727443256425,0.201152737752161
2009,37059,175,669,238,674,7,7,245,681,0.0245821752156806,0.359765051395007
2009,37061,90,1280,154,487,2,232,156,719,0.0210943230159894,0.216968011126565
2009,37063,3683,7280,3851,7520,1127,1596,4978,9116,0.0541568147523258,0.546072838964458
2009,37065,146,2057,33,373,44,97,77,470,0.0138422571714673,0.163829787234043
2009,37067,1595,5287,2208,5442,258,657,2466,6099,0.0266850429874647,0.404328578455485
2009,37069,213,1466,76,613,19,64,95,677,0.0176412341046487,0.140324963072378
2009,37071,638,3957,812,2970,66,308,878,3278,0.0240502428502252,0.26784624771202
2009,37073,0,255,100,299,0,0,100,299,0.0388311688311688,0.334448160535117
2009,37075,0,74,27,229,0,0,27,229,0.0409660107334526,0.117903930131004
2009,37077,226,1724,150,841,9,28,159,869,0.023341391351061,0.182968929804373
2009,37079,81,1289,14,169,0,76,14,245,0.0178078209042012,0.0571428571428571
2009,37081,2129,6926,3197,8227,394,1091,3591,9318,0.0306307609367398,0.385383129426916
2009,37083,152,1185,51,424,0,50,51,474,0.0128832354859752,0.107594936708861
2009,37085,308,3359,571,1945,92,550,663,2495,0.0362545227335474,0.265731462925852
2009,37087,239,906,399,1108,0,20,399,1128,0.0273474434504328,0.353723404255319
2009,37089,648,1977,850,2643,20,262,870,2905,0.0399906390242559,0.299483648881239
2009,37091,88,450,88,1041,0,91,88,1132,0.0733826008038377,0.0777385159010601
2009,37093,219,2171,84,612,106,307,190,919,0.0356865486175831,0.206746463547334
2009,37095,2,700,0,107,0,0,0,107,0.0263546798029557,0
2009,37097,635,2561,983,2819,39,147,1022,2966,0.0297507397562566,0.344571813890762
2009,37099,99,761,242,521,29,77,271,598,0.0261180992313068,0.453177257525084
2009,37101,654,3877,429,1945,123,394,552,2339,0.0228979236213766,0.235998289867465
2009,37103,45,279,3,97,0,5,3,102,0.0145776761469201,0.0294117647058824
2009,37105,126,967,182,953,42,245,224,1198,0.0312769234785787,0.186978297161937
2009,37107,80,788,68,667,0,33,68,700,0.0183035247359063,0.0971428571428571
2009,37109,255,1303,320,1147,0,27,320,1174,0.023720526135009,0.272572402044293
2009,37111,129,876,19,303,0,4,19,307,0.0100854139290407,0.0618892508143322
2009,37113,80,222,241,746,22,66,263,812,0.034130553570678,0.323891625615764
2009,37115,86,386,57,365,0,9,57,374,0.0266419717908534,0.152406417112299
2009,37117,155,551,41,188,0,9,41,197,0.0120275963123512,0.208121827411168
2009,37119,4927,12460,12082,28576,1912,3865,13994,32441,0.0581253885806124,0.431367713695632
2009,37121,10,149,10,99,0,0,10,99,0.00874095002648773,0.101010101010101
2009,37123,45,528,47,266,6,38,53,304,0.0167714884696017,0.174342105263158
2009,37125,451,1299,774,1567,43,83,817,1650,0.0276446737928492,0.495151515151515
2009,37127,398,2311,163,744,91,391,254,1135,0.0183227056259585,0.223788546255507
2009,37129,1560,4611,2364,5177,104,221,2468,5398,0.0437308100488508,0.457206372730641
2009,37131,24,428,0,178,0,27,0,205,0.0141506177952647,0
2009,37133,220,1562,1025,5424,277,1275,1302,6699,0.0875880914713073,0.19435736677116
2009,37135,1319,3307,1667,2193,627,885,2294,3078,0.0429474389205933,0.745289148797921
2009,37137,13,423,47,149,0,9,47,158,0.0168138767691817,0.29746835443038
2009,37139,71,964,118,1005,12,23,130,1028,0.0401782224654108,0.126459143968872
2009,37141,336,2059,191,508,21,127,212,635,0.0184496484397699,0.333858267716535
2009,37143,0,375,47,151,0,0,47,151,0.0171182405622945,0.311258278145695
2009,37145,166,749,94,325,0,48,94,373,0.0146022549326652,0.25201072386059
2009,37147,643,2945,670,1899,153,297,823,2196,0.0254363916462998,0.374772313296903
2009,37149,117,277,205,613,38,41,243,654,0.0453316697858183,0.371559633027523
2009,37151,465,3099,296,1191,40,278,336,1469,0.0156484687083888,0.228727025187202
2009,37153,83,685,19,220,0,105,19,325,0.0108127890341684,0.0584615384615385
2009,37155,191,1641,278,1220,45,146,323,1366,0.0172817327277558,0.236456808199122
2009,37157,317,1217,133,636,0,238,133,874,0.0136528367908023,0.152173913043478
2009,37159,226,2504,277,1547,27,125,304,1672,0.0181011150806539,0.181818181818182
2009,37161,81,738,88,864,0,10,88,874,0.0198392881463658,0.100686498855835
2009,37163,125,1465,122,603,40,131,162,734,0.0178345806200797,0.220708446866485
2009,37165,171,975,76,433,0,22,76,455,0.0195682091863066,0.167032967032967
2009,37167,352,1102,125,391,20,244,145,635,0.0159060167326286,0.228346456692913
2009,37169,132,1086,22,172,6,6,28,178,0.00552057810997736,0.157303370786517
2009,37171,134,915,94,540,49,135,143,675,0.0135389922978177,0.211851851851852
2009,37173,39,128,207,363,0,2,207,365,0.0392388733605676,0.567123287671233
2009,37175,252,617,412,664,0,0,412,664,0.0306428538465088,0.620481927710843
2009,37177,24,714,0,25,0,0,0,25,0.00768521364893944,0
2009,37179,1085,3456,1144,3254,64,501,1208,3755,0.033071171274319,0.321704394141145
2009,37181,97,838,78,260,0,57,78,317,0.011392632524708,0.246056782334385
2009,37183,5431,14142,12490,23870,2335,4055,14825,27925,0.0521336039115605,0.53088630259624
2009,37185,53,272,0,199,9,166,9,365,0.0269850657992015,0.0246575342465753
2009,37187,34,214,25,158,0,17,25,175,0.020327564177024,0.142857142857143
2009,37189,266,617,272,567,16,39,288,606,0.0255039771053407,0.475247524752475
2009,37191,152,2228,379,1576,161,565,540,2141,0.0294299578001072,0.252218589444185
2009,37193,106,655,123,444,122,155,245,599,0.0128419518051625,0.409015025041736
2009,37195,237,1224,237,1071,0,60,237,1131,0.0222580835612934,0.209549071618037
2009,37197,151,1066,26,99,0,5,26,104,0.00402866550455162,0.25
2009,37199,0,245,65,188,0,9,65,197,0.0149366896656304,0.32994923857868
2009,38001,2,18,7,79,0,0,7,79,0.0457971014492754,0.0886075949367089
2009,38003,25,133,59,93,0,2,59,95,0.0126162018592297,0.621052631578947
2009,38005,10,54,0,23,0,8,0,31,0.00809822361546499,0
2009,38007,3,3,14,25,0,0,14,25,0.0386398763523957,0.56
2009,38009,12,68,0,67,9,16,9,83,0.0179110919292188,0.108433734939759
2009,38011,16,39,2,8,0,8,2,16,0.00767018216682646,0.125
2009,38013,11,28,2,29,0,2,2,31,0.0196700507614213,0.0645161290322581
2009,38015,659,1845,202,1217,36,62,238,1279,0.024841222056053,0.18608287724785
2009,38017,318,1263,1269,2782,120,331,1389,3113,0.0378890227723616,0.446193382589142
2009,38019,1,45,0,12,0,2,0,14,0.00469011725293132,0
2009,38021,4,69,17,108,0,14,17,122,0.0350272753373529,0.139344262295082
2009,38023,0,11,9,32,6,11,15,43,0.0288590604026846,0.348837209302326
2009,38025,19,52,3,17,0,6,3,23,0.0103697024346258,0.130434782608696
2009,38027,7,21,4,14,0,20,4,34,0.020310633213859,0.117647058823529
2009,38029,17,40,18,64,0,1,18,65,0.0242899850523169,0.276923076923077
2009,38031,24,85,8,23,0,28,8,51,0.0208248264597795,0.156862745098039
2009,38033,0,11,0,13,0,0,0,13,0.012241054613936,0
2009,38035,173,443,573,1490,97,302,670,1792,0.0511400930338746,0.373883928571429
2009,38037,10,20,6,25,0,2,6,27,0.0153409090909091,0.222222222222222
2009,38039,5,35,8,25,0,0,8,25,0.0145011600928074,0.32
2009,38041,12,34,0,15,0,1,0,16,0.00855614973262032,0
2009,38043,5,21,1,71,0,0,1,71,0.0403180011357183,0.0140845070422535
2009,38045,29,37,5,53,0,0,5,53,0.0180949129395698,0.0943396226415094
2009,38047,5,65,11,38,0,0,11,38,0.0254180602006689,0.289473684210526
2009,38049,25,132,7,47,0,0,7,47,0.0126514131897712,0.148936170212766
2009,38051,3,43,2,2,7,13,9,15,0.00696378830083565,0.6
2009,38053,63,101,18,55,0,0,18,55,0.0147849462365591,0.327272727272727
2009,38055,31,115,12,56,0,0,12,56,0.0091758151728658,0.214285714285714
2009,38057,124,178,0,35,0,0,0,35,0.00616197183098592,0
2009,38059,231,799,71,322,0,40,71,362,0.0209091434182406,0.196132596685083
2009,38061,20,76,18,133,0,0,18,133,0.0315914489311164,0.135338345864662
2009,38063,0,36,11,46,0,0,11,46,0.0192468619246862,0.239130434782609
2009,38065,1,1,0,0,0,0,0,0,0,NA
2009,38067,0,60,5,62,0,27,5,89,0.0166199813258637,0.0561797752808989
2009,38069,0,186,0,34,0,35,0,69,0.0226899046366327,0
2009,38071,21,104,0,13,0,14,0,27,0.00358090185676393,0
2009,38073,32,155,5,39,14,15,19,54,0.0136467020470053,0.351851851851852
2009,38075,8,34,14,23,0,2,14,25,0.0161394448030988,0.56
2009,38077,56,187,4,201,13,52,17,253,0.0254527162977867,0.0671936758893281
2009,38079,4,30,0,13,0,63,0,76,0.0101171458998935,0
2009,38081,11,34,0,15,0,0,0,15,0.00532292405961675,0
2009,38083,0,13,0,16,0,0,0,16,0.0143240823634736,0
2009,38085,20,63,11,25,0,10,11,35,0.0167144221585482,0.314285714285714
2009,38087,5,5,7,7,0,0,7,7,0.0144628099173554,1
2009,38089,53,490,162,413,4,4,166,417,0.0284098651042376,0.398081534772182
2009,38091,0,24,0,16,0,2,0,18,0.0134428678117999,0
2009,38093,38,311,47,335,0,65,47,400,0.0286717798007311,0.1175
2009,38095,9,30,7,23,0,3,7,26,0.0146809712027103,0.269230769230769
2009,38097,65,127,15,91,10,10,25,101,0.0187558031569174,0.247524752475248
2009,38099,19,179,15,71,0,0,15,71,0.00933841904511377,0.211267605633803
2009,38101,128,548,385,1378,525,977,910,2355,0.0672396071265418,0.386411889596603
2009,38103,4,54,52,67,0,5,52,72,0.0221948212083847,0.722222222222222
2009,38105,36,266,43,182,20,49,63,231,0.017394578313253,0.272727272727273
2009,39001,26,457,134,275,0,38,134,313,0.0165669824802837,0.428115015974441
2009,39003,261,1856,161,849,0,121,161,970,0.0142012180838604,0.165979381443299
2009,39005,150,1270,96,388,104,160,200,548,0.0154501113648538,0.364963503649635
2009,39007,310,1762,156,1356,34,120,190,1476,0.0213671501780596,0.128726287262873
2009,39009,114,793,413,705,154,164,567,869,0.028426561988878,0.652474108170311
2009,39011,166,1056,40,228,0,8,40,236,0.00765239948119326,0.169491525423729
2009,39013,54,1200,82,714,5,111,87,825,0.0169157901211786,0.105454545454545
2009,39015,24,841,19,205,9,35,28,240,0.00816743236345074,0.116666666666667
2009,39017,1636,7232,1187,3459,267,859,1454,4318,0.0186223433618548,0.336729967577582
2009,39019,84,665,70,207,13,13,83,220,0.0109753055624844,0.377272727272727
2009,39021,97,841,51,237,0,17,51,254,0.00969169719169719,0.200787401574803
2009,39023,486,2040,128,793,12,174,140,967,0.0102121637748044,0.144777662874871
2009,39025,1030,4690,854,2473,96,317,950,2790,0.0219038272816487,0.340501792114695
2009,39027,215,1258,9,201,0,156,9,357,0.0127865329512894,0.0252100840336134
2009,39029,79,1197,114,1535,10,54,124,1589,0.0210068480473811,0.0780365009439899
2009,39031,80,562,53,204,8,8,61,212,0.00876757650951199,0.287735849056604
2009,39033,109,1105,0,202,14,38,14,240,0.00788125574674898,0.0583333333333333
2009,39035,3756,12458,5226,10758,1440,3232,6666,13990,0.0159207037429017,0.476483202287348
2009,39037,104,595,26,432,0,34,26,466,0.0132589768394696,0.055793991416309
2009,39039,70,454,73,383,0,2,73,385,0.0150543520763275,0.18961038961039
2009,39041,2820,5542,1173,1953,271,395,1444,2348,0.0226640926640927,0.614991482112436
2009,39043,288,1665,145,546,0,135,145,681,0.0126537589654019,0.212922173274596
2009,39045,858,4139,431,1151,85,194,516,1345,0.0144869778763921,0.38364312267658
2009,39047,112,677,3,99,0,3,3,102,0.00538713425583606,0.0294117647058824
2009,39049,5272,16236,7384,15736,2640,4361,10024,20097,0.0271836386876864,0.498780912574016
2009,39051,159,886,16,371,0,8,16,379,0.013528466892736,0.0422163588390501
2009,39053,43,292,40,349,0,0,40,349,0.0168909108508373,0.114613180515759
2009,39055,602,1936,197,419,27,59,224,478,0.00740625968391695,0.468619246861925
2009,39057,1098,3248,961,1946,314,470,1275,2416,0.0251342016561941,0.52773178807947
2009,39059,96,421,8,190,0,21,8,211,0.00775250762391153,0.037914691943128
2009,39061,2840,9098,4938,11152,1234,2314,6172,13466,0.0238634893574792,0.458339521758503
2009,39063,425,1920,249,645,26,149,275,794,0.0161687743091616,0.346347607052897
2009,39065,136,470,6,233,0,0,6,233,0.0116821258460767,0.0257510729613734
2009,39067,43,404,12,67,5,5,17,72,0.00655677989254166,0.236111111111111
2009,39069,60,519,12,63,0,8,12,71,0.00370718462823726,0.169014084507042
2009,39071,100,1287,23,353,23,81,46,434,0.0155371782479505,0.105990783410138
2009,39073,93,803,35,128,0,11,35,139,0.00705977957235004,0.251798561151079
2009,39075,100,514,5,98,0,9,5,107,0.00457989128108548,0.0467289719626168
2009,39077,131,1204,52,549,13,27,65,576,0.0148056755089451,0.112847222222222
2009,39079,13,541,87,278,0,38,87,316,0.0140394526390617,0.275316455696203
2009,39081,112,726,127,690,63,153,190,843,0.0173703406070347,0.225385527876631
2009,39083,201,1453,180,442,0,0,180,442,0.011733163441374,0.407239819004525
2009,39085,776,4350,410,1179,152,369,562,1548,0.00950188748734002,0.363049095607235
2009,39087,22,525,194,937,0,34,194,971,0.0225159420289855,0.199794026776519
2009,39089,699,3840,315,1191,12,96,327,1287,0.0124304589707928,0.254079254079254
2009,39091,130,780,21,460,0,11,21,471,0.0151700592630765,0.0445859872611465
2009,39093,1503,6783,565,2028,119,432,684,2460,0.0121277256570417,0.278048780487805
2009,39095,937,4903,1599,5132,143,485,1742,5617,0.01834895351838,0.310129962613495
2009,39097,353,2922,12,352,0,12,12,364,0.0128236744759556,0.032967032967033
2009,39099,613,3597,544,1716,127,294,671,2010,0.0120201651726179,0.333830845771144
2009,39101,175,2494,131,448,0,40,131,488,0.0108994259933442,0.26844262295082
2009,39103,1054,3780,356,996,0,68,356,1064,0.00937767162284838,0.334586466165414
2009,39105,54,490,31,133,0,0,31,133,0.00833124530192934,0.233082706766917
2009,39107,121,615,52,222,4,30,56,252,0.00963155480813331,0.222222222222222
2009,39109,564,2058,298,841,44,112,342,953,0.0138652466791789,0.358866736621196
2009,39111,3,74,49,124,0,0,49,124,0.0121342597123006,0.395161290322581
2009,39113,1957,7886,1705,5358,771,1197,2476,6555,0.018096786750557,0.377726926010679
2009,39115,35,217,18,65,10,18,28,83,0.0082718756228822,0.337349397590361
2009,39117,142,791,38,204,0,9,38,213,0.00926771961884871,0.178403755868545
2009,39119,181,1462,46,501,31,98,77,599,0.0105224326318378,0.128547579298831
2009,39121,34,1063,0,43,0,5,0,48,0.00500834724540901,0
2009,39123,214,847,94,223,8,51,102,274,0.00934197067848619,0.372262773722628
2009,39125,39,235,16,109,0,27,16,136,0.0104954468282142,0.117647058823529
2009,39127,57,704,32,213,0,12,32,225,0.00975588605125092,0.142222222222222
2009,39129,247,3447,42,512,18,41,60,553,0.0151706353560847,0.108499095840868
2009,39131,221,784,14,150,0,11,14,161,0.00869001997085335,0.0869565217391304
2009,39133,777,2670,459,958,246,357,705,1315,0.0136437679625652,0.536121673003802
2009,39135,70,913,94,548,30,87,124,635,0.0223190749007065,0.195275590551181
2009,39137,101,320,57,178,25,29,82,207,0.00946805104514476,0.396135265700483
2009,39139,403,3390,98,747,0,64,98,811,0.00942979396307148,0.120838471023428
2009,39141,86,2729,215,697,0,17,215,714,0.0136420956093087,0.301120448179272
2009,39143,99,810,40,307,27,119,67,426,0.0104604051565378,0.157276995305164
2009,39145,64,905,74,753,0,45,74,798,0.0154639175257732,0.0927318295739348
2009,39147,209,1001,42,300,0,24,42,324,0.00869145340415258,0.12962962962963
2009,39149,113,679,82,368,18,62,100,430,0.0137130465286858,0.232558139534884
2009,39151,1100,5115,722,2928,161,293,883,3221,0.0124896275213848,0.274138466314809
2009,39153,2629,7576,1472,3090,285,763,1757,3853,0.0103869845934033,0.456008305216714
2009,39155,410,2219,220,1325,25,60,245,1385,0.0093402480392223,0.176895306859206
2009,39157,87,1049,82,426,15,105,97,531,0.00853162807885731,0.182674199623352
2009,39159,404,2086,146,512,118,142,264,654,0.021024882659294,0.403669724770642
2009,39161,20,314,50,303,0,9,50,312,0.0160799876307787,0.16025641025641
2009,39163,0,441,0,0,0,0,0,0,0,NA
2009,39165,1940,6905,1348,3071,192,566,1540,3637,0.0272204052000928,0.423425900467418
2009,39167,26,432,159,1135,40,67,199,1202,0.0282870119784435,0.165557404326123
2009,39169,271,1538,188,537,22,32,210,569,0.00774233930223698,0.369068541300527
2009,39171,38,643,88,560,0,59,88,619,0.0238159362856373,0.1421647819063
2009,39173,893,2762,337,862,96,150,433,1012,0.0138605453823292,0.427865612648221
2009,39175,42,577,25,77,12,24,37,101,0.00658667014477631,0.366336633663366
2009,40001,16,106,38,156,0,0,38,156,0.0116600642798415,0.243589743589744
2009,40003,14,427,0,33,0,0,0,33,0.00775193798449612,0
2009,40005,73,957,15,180,0,7,15,187,0.0189347914135277,0.0802139037433155
2009,40007,28,105,11,204,0,2,11,206,0.0569375345494748,0.0533980582524272
2009,40009,72,604,117,481,0,22,117,503,0.0389017788089714,0.232604373757455
2009,40011,60,252,26,605,0,34,26,639,0.0764811490125673,0.0406885758998435
2009,40013,162,723,107,1161,0,38,107,1199,0.046332792333256,0.0892410341951626
2009,40015,53,606,67,725,0,23,67,748,0.0396312387411254,0.089572192513369
2009,40017,868,3805,451,2193,60,174,511,2367,0.0348200888522757,0.21588508660752
2009,40019,83,551,156,513,0,40,156,553,0.0176615247037782,0.282097649186257
2009,40021,85,645,242,682,17,49,259,731,0.0281760715386987,0.354309165526676
2009,40023,48,278,43,329,0,29,43,358,0.036008851337759,0.120111731843575
2009,40025,0,23,0,71,0,0,0,71,0.0386079390973355,0
2009,40027,1733,7409,1291,3658,373,613,1664,4271,0.0303637824272542,0.389604308124561
2009,40029,14,106,5,87,0,0,5,87,0.0231814548361311,0.0574712643678161
2009,40031,117,2112,730,3777,207,1240,937,5017,0.0758634246658199,0.186764999003388
2009,40033,28,192,32,111,9,32,41,143,0.0330101569713758,0.286713286713287
2009,40035,32,700,0,418,0,12,0,430,0.0411247130833971,0
2009,40037,290,1734,258,1014,14,72,272,1086,0.0236261584649524,0.250460405156538
2009,40039,142,578,68,312,0,34,68,346,0.0239612188365651,0.196531791907514
2009,40041,95,669,91,855,0,4,91,859,0.0309048389998201,0.105937136204889
2009,40043,38,237,0,16,0,0,0,16,0.00492307692307692,0
2009,40045,15,64,18,43,2,10,20,53,0.0195788695973402,0.377358490566038
2009,40047,204,756,448,1310,33,185,481,1495,0.0394427881698019,0.321739130434783
2009,40049,93,621,19,279,0,8,19,287,0.0155935886987232,0.0662020905923345
2009,40051,294,1761,91,792,5,96,96,888,0.027004835325244,0.108108108108108
2009,40053,21,107,15,90,0,0,15,90,0.0285623611551888,0.166666666666667
2009,40055,23,750,0,144,0,0,0,144,0.033317908375752,0
2009,40057,0,156,0,40,0,69,0,109,0.0547738693467337,0
2009,40059,36,58,7,71,0,4,7,75,0.0307755437012721,0.0933333333333333
2009,40061,58,266,31,210,0,0,31,210,0.0262368815592204,0.147619047619048
2009,40063,6,737,47,195,0,0,47,195,0.0205371248025276,0.241025641025641
2009,40065,38,558,339,819,0,88,339,907,0.0575361583354479,0.373759647188534
2009,40067,17,269,0,118,0,2,0,120,0.0281557954012201,0
2009,40069,30,325,6,168,0,5,6,173,0.0261566374357424,0.0346820809248555
2009,40071,78,502,158,643,15,89,173,732,0.0243878060969515,0.236338797814208
2009,40073,57,285,10,89,5,17,15,106,0.0115142298500978,0.141509433962264
2009,40075,32,277,19,111,0,17,19,128,0.0199439077594266,0.1484375
2009,40077,3,190,29,60,0,0,29,60,0.00885478158205431,0.483333333333333
2009,40079,49,952,75,815,5,176,80,991,0.0305186006405519,0.0807265388496468
2009,40081,123,784,22,210,0,1,22,211,0.0099721158844936,0.104265402843602
2009,40083,319,1132,143,442,55,73,198,515,0.0215688738116179,0.384466019417476
2009,40085,20,197,49,179,39,60,88,239,0.0385483870967742,0.368200836820084
2009,40087,293,1542,27,267,0,0,27,267,0.0126510305614783,0.101123595505618
2009,40089,62,271,52,376,0,3,52,379,0.0173257142857143,0.137203166226913
2009,40091,78,682,6,442,0,9,6,451,0.0324904545782004,0.0133037694013304
2009,40093,32,173,0,46,0,0,0,46,0.00919448331001399,0
2009,40095,26,312,54,211,0,0,54,211,0.0212060301507538,0.255924170616114
2009,40097,49,741,86,494,0,25,86,519,0.0195575988242831,0.165703275529865
2009,40099,22,401,8,314,0,0,8,314,0.0356494096276113,0.0254777070063694
2009,40101,225,2384,67,760,6,6,73,766,0.0165200138026225,0.0953002610966057
2009,40103,24,377,22,149,0,0,22,149,0.0200161203653949,0.147651006711409
2009,40105,58,158,11,104,0,56,11,160,0.022766078542971,0.06875
2009,40107,25,602,17,51,0,7,17,58,0.00751003496050758,0.293103448275862
2009,40109,2806,12045,4290,13177,749,2384,5039,15561,0.0344607657505033,0.323822376453955
2009,40111,133,1156,31,314,0,10,31,324,0.0126869762706555,0.095679012345679
2009,40113,190,1759,96,525,13,34,109,559,0.0183790892651652,0.194991055456172
2009,40115,53,631,64,668,0,29,64,697,0.0332776318930532,0.0918220946915352
2009,40117,94,589,27,95,0,4,27,99,0.00883849656280689,0.272727272727273
2009,40119,405,1770,466,1002,235,310,701,1312,0.0324294930419952,0.534298780487805
2009,40121,55,1453,187,758,0,17,187,775,0.0250509099136956,0.241290322580645
2009,40123,122,737,71,288,15,28,86,316,0.0135256602319908,0.272151898734177
2009,40125,213,1871,75,715,57,104,132,819,0.018244191486044,0.161172161172161
2009,40127,6,391,54,286,5,13,59,299,0.0376432078559738,0.197324414715719
2009,40129,25,66,0,27,0,0,0,27,0.0118473014480035,0
2009,40131,568,2955,282,1419,28,69,310,1488,0.0276621058893516,0.208333333333333
2009,40133,49,569,34,151,0,14,34,165,0.0105633802816901,0.206060606060606
2009,40135,72,581,98,937,0,38,98,975,0.0363941769316909,0.100512820512821
2009,40137,190,1177,164,679,0,41,164,720,0.0246761258482418,0.227777777777778
2009,40139,29,107,48,726,52,267,100,993,0.08201189296333,0.100704934541793
2009,40141,14,150,28,202,0,0,28,202,0.0378915775651848,0.138613861386139
2009,40143,2111,9778,3355,10525,474,1701,3829,12226,0.0323287772656719,0.313185015540651
2009,40145,410,2185,258,1182,11,107,269,1289,0.0292814792939733,0.208688906128782
2009,40147,196,844,283,873,67,93,350,966,0.0288720186502481,0.36231884057971
2009,40149,13,271,31,121,0,37,31,158,0.0206562949405151,0.19620253164557
2009,40151,28,245,82,226,0,0,82,226,0.0431297709923664,0.36283185840708
2009,40153,107,676,52,440,0,19,52,459,0.0363621959914442,0.113289760348584
2009,41001,26,281,46,271,0,10,46,281,0.0245994922524731,0.163701067615658
2009,41003,509,1601,945,1694,275,323,1220,2017,0.0450857232268592,0.60485870104115
2009,41005,3217,10765,2477,6048,295,708,2772,6756,0.0265432486799095,0.410301953818828
2009,41007,329,962,323,1017,10,26,333,1043,0.0407788247253392,0.319271332694151
2009,41009,178,1172,118,821,5,46,123,867,0.0263453766446869,0.141868512110727
2009,41011,195,1238,352,1670,32,75,384,1745,0.0377910124526259,0.220057306590258
2009,41013,165,755,17,435,0,10,17,445,0.0284109046798187,0.0382022471910112
2009,41015,0,114,137,853,53,53,190,906,0.0539414146225292,0.209713024282561
2009,41017,891,2996,1146,3408,106,289,1252,3697,0.0351787005671221,0.338652961860968
2009,41019,300,1629,614,2300,33,88,647,2388,0.0324663847837614,0.270938023450586
2009,41021,0,32,3,15,0,0,3,15,0.0124069478908189,0.2
2009,41023,7,136,16,44,0,13,16,57,0.0112248916896416,0.280701754385965
2009,41025,32,237,19,147,0,1,19,148,0.0303465245027681,0.128378378378378
2009,41027,110,398,205,341,0,90,205,431,0.0308827744339352,0.475638051044084
2009,41029,474,2461,1799,6006,35,251,1834,6257,0.0456745333635056,0.293111714879335
2009,41031,147,891,23,240,0,50,23,290,0.0227272727272727,0.0793103448275862
2009,41033,158,865,406,1837,46,154,452,1991,0.0340988884892702,0.227021597187343
2009,41035,69,568,357,1910,74,87,431,1997,0.0449157688760937,0.215823735603405
2009,41037,22,446,40,182,0,37,40,219,0.0413285525570862,0.182648401826484
2009,41039,1113,3882,2295,6912,626,1143,2921,8055,0.0362208052665186,0.362631905648665
2009,41041,306,1157,383,1003,33,128,416,1131,0.0333166406457124,0.367816091954023
2009,41043,601,3122,176,1637,27,151,203,1788,0.0234682627185384,0.113534675615213
2009,41045,71,929,115,807,0,30,115,837,0.0420391762933199,0.137395459976105
2009,41047,1496,7042,915,4225,186,931,1101,5156,0.0261009106970199,0.213537626066718
2009,41049,81,369,0,290,1,13,1,303,0.041978387364921,0.0033003300330033
2009,41051,5325,13979,9259,17795,1885,4031,11144,21826,0.0447593462256219,0.510583707504811
2009,41053,398,2045,366,1251,25,60,391,1311,0.0281941547130046,0.298245614035088
2009,41055,7,28,0,34,0,0,0,34,0.0277551020408163,0
2009,41057,105,722,77,292,0,30,77,322,0.0178958483854832,0.239130434782609
2009,41059,180,1424,303,1407,0,128,303,1535,0.0327522563850897,0.197394136807818
2009,41061,85,346,54,350,14,14,68,364,0.0234884171129896,0.186813186813187
2009,41063,48,140,36,72,0,15,36,87,0.0171293561724749,0.413793103448276
2009,41065,94,400,123,499,7,58,130,557,0.0341508277130595,0.233393177737882
2009,41067,4405,11827,6192,13876,1400,2536,7592,16412,0.0482555438598555,0.462588349987814
2009,41069,7,50,0,5,0,0,0,5,0.00455373406193078,0
2009,41071,539,2541,546,2106,39,234,585,2340,0.037977765154589,0.25
2009,42001,325,1752,515,1667,0,62,515,1729,0.0255583970199116,0.29786003470214
2009,42003,3714,9128,7425,12284,3020,4270,10445,16554,0.0192321320899172,0.630965325601063
2009,42005,135,920,12,259,68,138,80,397,0.00806271451491704,0.201511335012594
2009,42007,593,1968,268,1323,22,120,290,1443,0.0117149444697019,0.200970200970201
2009,42009,161,525,130,513,0,13,130,526,0.0149287619912584,0.247148288973384
2009,42011,1292,5386,728,3021,230,877,958,3898,0.0146232944804379,0.245767060030785
2009,42013,345,1731,290,1164,2,86,292,1250,0.0141234958476922,0.2336
2009,42015,44,525,76,644,0,56,76,700,0.01661799966764,0.108571428571429
2009,42017,2793,7246,3383,6731,357,998,3740,7729,0.0182098336400112,0.483891835942554
2009,42019,1135,3064,851,2051,130,246,981,2297,0.0184005831791273,0.427078798432738
2009,42021,422,1839,366,1352,30,94,396,1446,0.0141064913273369,0.273858921161826
2009,42023,5,13,0,17,0,0,0,17,0.00448785638859556,0
2009,42025,152,1147,88,392,0,35,88,427,0.00947919904098033,0.206088992974239
2009,42027,863,2954,1277,1969,383,570,1660,2539,0.0334880898994962,0.653800708940528
2009,42029,4004,7918,4440,7413,816,1463,5256,8876,0.0277167124656508,0.59215863001352
2009,42031,77,998,87,269,3,8,90,277,0.0108845141262918,0.324909747292419
2009,42033,215,2678,155,599,0,34,155,633,0.0107579877634262,0.244865718799368
2009,42035,272,833,33,206,33,75,66,281,0.0111366518706405,0.234875444839858
2009,42037,305,815,70,318,48,103,118,421,0.0101124135280553,0.280285035629454
2009,42039,301,1509,285,923,32,129,317,1052,0.0175027036020298,0.301330798479087
2009,42041,1599,6518,984,2559,396,708,1380,3267,0.0209491564549949,0.422405876951331
2009,42043,1317,5159,1101,2673,236,616,1337,3289,0.0187486461527938,0.40650653694132
2009,42045,3621,10449,2497,4423,771,1606,3268,6029,0.0164819543240184,0.542046773926024
2009,42047,15,153,18,164,0,0,18,164,0.00712114633087277,0.109756097560976
2009,42049,476,2301,1047,2896,83,639,1130,3535,0.0190355671629735,0.31966053748232
2009,42051,384,3082,165,1038,106,349,271,1387,0.0134562211981567,0.195385724585436
2009,42053,110,1117,3,98,22,33,25,131,0.0254270186335404,0.190839694656489
2009,42055,207,1304,690,2500,64,261,754,2761,0.0283860752986655,0.273089460340456
2009,42057,25,155,19,150,0,4,19,154,0.015040531301885,0.123376623376623
2009,42059,199,1620,33,428,18,18,51,446,0.0160871447121627,0.114349775784753
2009,42061,187,2534,73,491,40,141,113,632,0.0196946089124338,0.17879746835443
2009,42063,192,1080,177,523,35,52,212,575,0.0107006606494836,0.368695652173913
2009,42065,121,558,33,216,0,9,33,225,0.0071362872276317,0.146666666666667
2009,42067,34,329,0,73,25,41,25,114,0.00717793728749528,0.219298245614035
2009,42069,821,2847,570,1738,197,427,767,2165,0.0148644009612084,0.354272517321016
2009,42071,1605,5351,1963,4252,306,1145,2269,5397,0.0165433400565238,0.420418751158051
2009,42073,350,983,59,421,18,49,77,470,0.00744365784514024,0.163829787234043
2009,42075,514,2045,307,1025,68,347,375,1372,0.0156241103253505,0.27332361516035
2009,42077,1739,5889,1603,4769,382,1399,1985,6168,0.0271535044661528,0.321822308690013
2009,42079,564,2956,617,3124,212,466,829,3590,0.0162355282199711,0.23091922005571
2009,42081,436,1941,286,674,72,195,358,869,0.0108126267590738,0.411967779056387
2009,42083,46,496,90,549,5,19,95,568,0.0189883996924414,0.167253521126761
2009,42085,239,1372,316,1487,17,143,333,1630,0.0204599086207762,0.204294478527607
2009,42087,65,572,24,283,0,88,24,371,0.0117019934393137,0.0646900269541779
2009,42089,378,1629,898,3361,70,285,968,3646,0.0338413558818616,0.265496434448711
2009,42091,6798,17043,5080,8200,1328,2237,6408,10437,0.0196079168114826,0.613969531474562
2009,42093,85,483,100,278,26,45,126,323,0.0259834285254605,0.390092879256966
2009,42095,1414,5232,1629,4563,331,634,1960,5197,0.0260413795868054,0.377140658071965
2009,42097,449,2830,58,452,9,83,67,535,0.00819308105790288,0.125233644859813
2009,42099,136,882,46,277,5,20,51,297,0.00962254981370484,0.171717171717172
2009,42101,5144,11753,9107,17228,2308,6669,11415,23897,0.0238691447081256,0.477675021969285
2009,42103,41,506,283,1666,28,41,311,1707,0.0422524752475248,0.182190978324546
2009,42105,62,164,55,233,2,2,57,235,0.0198815566835871,0.242553191489362
2009,42107,441,3434,200,1827,51,443,251,2270,0.0213438140549486,0.11057268722467
2009,42109,193,765,47,318,13,43,60,361,0.0144637205016227,0.166204986149584
2009,42111,197,1327,122,445,3,171,125,616,0.0109404138176006,0.202922077922078
2009,42113,24,171,0,11,0,3,0,14,0.00314394790029194,0
2009,42115,64,512,86,379,12,25,98,404,0.0141451629844893,0.242574257425743
2009,42117,66,442,223,607,12,21,235,628,0.0224815636858309,0.374203821656051
2009,42119,244,1230,249,971,12,102,261,1073,0.0381782600960683,0.243243243243243
2009,42121,217,1039,106,351,6,15,112,366,0.00952628839146278,0.306010928961749
2009,42123,14,679,60,363,0,19,60,382,0.0131280500378033,0.157068062827225
2009,42125,800,2670,577,1607,54,179,631,1786,0.0123018004986844,0.353303471444569
2009,42127,198,1396,219,1243,70,86,289,1329,0.0361740929257737,0.217456734386757
2009,42129,1219,5255,680,2033,117,312,797,2345,0.00899991556582412,0.339872068230277
2009,42131,76,398,33,125,3,3,36,128,0.00677499603027576,0.28125
2009,42133,1086,4282,1671,6640,186,903,1857,7543,0.0262794829808731,0.246188519156834
2009,44001,349,839,525,821,112,188,637,1009,0.0293860671015843,0.631318136769078
2009,44003,985,3544,734,1691,19,261,753,1952,0.0162058945620589,0.385758196721311
2009,44005,172,549,1791,2628,419,536,2210,3164,0.0542998850160463,0.698482932996207
2009,44007,956,3584,3691,7643,751,2030,4442,9673,0.0231142186017726,0.459216375478135
2009,44009,662,1470,710,1592,113,239,823,1831,0.0222803601849598,0.449481157837247
2009,45001,198,638,19,117,18,38,37,155,0.00910425844346549,0.238709677419355
2009,45003,309,1489,841,2749,73,276,914,3025,0.0293304891646871,0.302148760330579
2009,45005,9,398,0,85,0,15,0,100,0.0143472022955524,0
2009,45007,550,2992,854,2168,45,266,899,2434,0.0200078913622464,0.369350862777321
2009,45009,16,265,51,260,0,0,51,260,0.0271966527196653,0.196153846153846
2009,45011,18,283,0,162,0,6,0,168,0.0113467513170336,0
2009,45013,365,946,2707,6407,117,801,2824,7208,0.0734064546352591,0.391786903440622
2009,45015,664,4098,1007,3844,258,767,1265,4611,0.0448292289294846,0.274343960095424
2009,45017,81,257,19,201,0,11,19,212,0.0206809091795922,0.089622641509434
2009,45019,1909,5580,5177,10222,597,1409,5774,11631,0.0502150036265672,0.496431949101539
2009,45021,56,492,120,452,0,26,120,478,0.0131383651256116,0.251046025104602
2009,45023,21,439,28,316,2,7,30,323,0.0147799029925872,0.0928792569659443
2009,45025,61,399,51,500,24,149,75,649,0.0227527695975319,0.115562403697997
2009,45027,68,518,86,453,0,10,86,463,0.0212981277887667,0.185745140388769
2009,45029,48,649,39,248,3,3,42,251,0.00971888794238364,0.167330677290837
2009,45031,343,1200,85,380,49,83,134,463,0.010394216954023,0.289416846652268
2009,45033,0,385,30,476,0,139,30,615,0.0319082702085711,0.0487804878048781
2009,45035,632,3659,889,3023,202,310,1091,3333,0.0425165512226857,0.327332733273327
2009,45037,35,775,67,444,35,99,102,543,0.0311263972484953,0.187845303867403
2009,45039,112,226,28,94,0,11,28,105,0.00663549039433772,0.266666666666667
2009,45041,437,2122,450,1517,43,106,493,1623,0.0187790711128596,0.303758471965496
2009,45043,191,1044,295,828,19,62,314,890,0.0212527162881773,0.352808988764045
2009,45045,1540,6976,3828,9819,719,1736,4547,11555,0.0406056942853328,0.393509303331891
2009,45047,180,1127,233,1074,15,222,248,1296,0.0286465816405473,0.191358024691358
2009,45049,45,180,21,423,0,14,21,437,0.0327684463107379,0.0480549199084668
2009,45051,475,2337,2158,9030,210,903,2368,9933,0.0562887824781118,0.238397261653076
2009,45053,46,714,33,319,11,179,44,498,0.0352891156462585,0.0883534136546185
2009,45055,169,831,104,663,80,213,184,876,0.0225523260304302,0.210045662100457
2009,45057,157,1004,363,1313,0,85,363,1398,0.0284916542686531,0.259656652360515
2009,45059,182,1802,228,751,12,62,240,813,0.0172890438924804,0.29520295202952
2009,45061,52,402,0,112,9,22,9,134,0.0101361573373676,0.0671641791044776
2009,45063,1756,5754,929,3244,132,316,1061,3560,0.0218655758446807,0.298033707865169
2009,45065,12,414,105,172,0,0,105,172,0.0222164815293206,0.61046511627907
2009,45067,29,579,23,286,0,45,23,331,0.0149807648789319,0.0694864048338369
2009,45069,9,563,96,703,0,65,96,768,0.0402052141137054,0.125
2009,45071,84,681,155,339,14,101,169,440,0.017344002522764,0.384090909090909
2009,45073,233,941,521,1340,49,136,570,1476,0.0295554665598718,0.386178861788618
2009,45075,153,1106,142,706,81,155,223,861,0.0149202003223179,0.259001161440186
2009,45077,346,1811,749,1711,26,117,775,1828,0.0261426691836851,0.423960612691466
2009,45079,2307,8802,3935,10171,736,1776,4671,11947,0.0533636473273509,0.390976814262995
2009,45081,63,195,90,182,0,18,90,200,0.0157170923379175,0.45
2009,45083,973,3910,1199,4027,134,567,1333,4594,0.0249915679298452,0.290161079669134
2009,45085,84,732,271,1170,103,213,374,1383,0.0212608956325232,0.270426608821403
2009,45087,11,246,61,338,0,13,61,351,0.0182517809786283,0.173789173789174
2009,45089,65,489,0,267,0,33,0,300,0.0130429111777749,0
2009,45091,292,1465,1976,6426,103,272,2079,6698,0.048708830566282,0.310391161540758
2009,46003,11,74,7,18,0,14,7,32,0.0163182049974503,0.21875
2009,46005,48,177,61,395,0,7,61,402,0.0364923747276688,0.151741293532338
2009,46007,14,63,20,101,0,0,20,101,0.049196298100341,0.198019801980198
2009,46009,39,370,5,85,4,4,9,89,0.0176587301587302,0.101123595505618
2009,46011,239,443,129,272,8,13,137,285,0.0193482688391039,0.480701754385965
2009,46013,121,336,245,528,8,50,253,578,0.0244987920145806,0.437716262975779
2009,46015,0,31,18,67,0,9,18,76,0.0241116751269036,0.236842105263158
2009,46017,0,48,0,8,0,0,0,8,0.00795228628230616,0
2009,46019,104,231,32,165,0,0,32,165,0.0258864135550675,0.193939393939394
2009,46021,0,20,5,20,0,0,5,20,0.0186046511627907,0.25
2009,46023,32,154,25,99,2,9,27,108,0.0196757150664966,0.25
2009,46025,3,62,2,19,0,0,2,19,0.00756369426751592,0.105263157894737
2009,46027,27,256,95,211,15,21,110,232,0.0370666240613517,0.474137931034483
2009,46029,69,475,64,201,0,0,64,201,0.0115563732536078,0.318407960199005
2009,46031,3,24,4,154,0,0,4,154,0.0670439703961689,0.025974025974026
2009,46033,6,209,54,233,0,0,54,233,0.03929173693086,0.231759656652361
2009,46035,163,763,96,191,13,13,109,204,0.0163461538461538,0.534313725490196
2009,46037,5,63,4,182,0,5,4,187,0.047558494404883,0.0213903743315508
2009,46039,4,39,22,81,0,23,22,104,0.0355434039644566,0.211538461538462
2009,46041,3,64,10,22,0,0,10,22,0.00683654443753884,0.454545454545455
2009,46043,1,83,0,9,0,1,0,10,0.00468164794007491,0
2009,46045,20,56,0,21,0,4,0,25,0.00901875901875902,0
2009,46047,9,143,131,560,0,9,131,569,0.104865462587541,0.230228471001757
2009,46049,15,35,0,0,0,0,0,0,0,NA
2009,46051,0,42,6,76,0,0,6,76,0.0151273885350318,0.0789473684210526
2009,46053,25,64,18,62,0,0,18,62,0.0210812648758926,0.290322580645161
2009,46055,0,47,0,0,8,15,8,15,0.0106913756236636,0.533333333333333
2009,46057,11,102,11,46,8,15,19,61,0.0175136376686764,0.311475409836066
2009,46059,9,69,13,26,0,3,13,29,0.0120282040647034,0.448275862068966
2009,46061,3,58,0,29,0,18,0,47,0.0204882301656495,0
2009,46063,3,19,0,0,0,0,0,0,0,NA
2009,46065,129,323,77,234,48,57,125,291,0.0260986547085202,0.429553264604811
2009,46067,62,223,15,60,0,4,15,64,0.0124732021048529,0.234375
2009,46069,0,23,0,0,0,0,0,0,0,NA
2009,46071,23,52,19,20,0,0,19,20,0.0137835975189524,0.95
2009,46073,3,31,0,5,0,0,0,5,0.00343642611683849,0
2009,46075,13,24,0,9,0,0,0,9,0.014218009478673,0
2009,46077,15,70,4,44,0,3,4,47,0.0119017472777918,0.0851063829787234
2009,46079,122,143,33,254,0,0,33,254,0.0330084470435348,0.12992125984252
2009,46081,89,275,204,486,0,0,204,486,0.0337664142291392,0.419753086419753
2009,46083,413,1355,364,616,11,79,375,695,0.0294778809857064,0.539568345323741
2009,46085,25,57,25,72,0,0,25,72,0.0309810671256454,0.347222222222222
2009,46087,24,158,17,49,0,9,17,58,0.01533985718064,0.293103448275862
2009,46089,0,6,3,32,2,2,5,34,0.0193732193732194,0.147058823529412
2009,46091,23,62,0,35,0,3,0,38,0.0130360205831904,0
2009,46093,212,637,79,529,31,96,110,625,0.0408363279973865,0.176
2009,46095,0,25,0,12,0,0,0,12,0.00996677740863787,0
2009,46097,15,37,2,13,0,2,2,15,0.00852757248436612,0.133333333333333
2009,46099,717,2527,1115,3625,39,208,1154,3833,0.0334316017164986,0.301069658231151
2009,46101,15,93,58,92,0,9,58,101,0.0238601464682258,0.574257425742574
2009,46103,394,1883,1182,2544,115,461,1297,3005,0.0476115028123267,0.431613976705491
2009,46105,12,50,3,21,0,0,3,21,0.00995732574679943,0.142857142857143
2009,46107,1,13,0,18,5,10,5,28,0.0174890693316677,0.178571428571429
2009,46109,0,68,13,99,0,0,13,99,0.015607756582059,0.131313131313131
2009,46111,13,50,11,55,0,0,11,55,0.0328947368421053,0.2
2009,46113,12,106,13,85,0,0,13,85,0.0139940730984524,0.152941176470588
2009,46115,21,120,18,67,0,2,18,69,0.0148355192431735,0.260869565217391
2009,46117,38,123,22,22,0,0,22,22,0.0114583333333333,1
2009,46119,4,27,3,3,0,0,3,3,0.00319488817891374,1
2009,46121,0,73,25,85,0,0,25,85,0.0180122907395635,0.294117647058824
2009,46123,10,45,98,98,0,0,98,98,0.0238384821211384,1
2009,46125,37,157,24,81,1,6,25,87,0.015015533310321,0.28735632183908
2009,46127,34,158,185,550,10,10,195,560,0.0598674363908488,0.348214285714286
2009,46129,36,250,35,139,0,1,35,140,0.033167495854063,0.25
2009,46135,73,399,66,524,14,17,80,541,0.0367977145966535,0.147874306839187
2009,46137,3,35,3,41,0,0,3,41,0.0307346326836582,0.0731707317073171
2009,47001,310,2097,173,933,44,117,217,1050,0.0204982039668905,0.206666666666667
2009,47003,127,810,63,467,11,27,74,494,0.0171778287780791,0.149797570850202
2009,47005,83,343,245,462,0,46,245,508,0.0433891356337547,0.482283464566929
2009,47007,13,516,0,66,0,0,0,66,0.00696790540540541,0
2009,47009,788,2330,420,2106,65,293,485,2399,0.0288324018989243,0.202167569820759
2009,47011,210,1401,465,1557,53,195,518,1752,0.027169951770234,0.295662100456621
2009,47013,24,324,45,624,0,20,45,644,0.0224813237450255,0.0698757763975155
2009,47015,38,438,32,102,9,9,41,111,0.0118741976893453,0.369369369369369
2009,47017,76,609,48,481,0,6,48,487,0.024730855169612,0.0985626283367557
2009,47019,188,1343,164,902,0,24,164,926,0.0221812345797303,0.177105831533477
2009,47021,179,1327,159,431,0,32,159,463,0.0177639656230816,0.34341252699784
2009,47023,17,312,6,151,0,27,6,178,0.0174390124424415,0.0337078651685393
2009,47025,35,290,105,586,0,0,105,586,0.0271359110905302,0.179180887372014
2009,47027,19,128,0,45,0,0,0,45,0.00762195121951219,0
2009,47029,30,372,85,593,19,19,104,612,0.024447728997723,0.169934640522876
2009,47031,198,936,125,826,124,124,249,950,0.0270964061608671,0.262105263157895
2009,47033,52,291,22,131,2,17,24,148,0.0152687506447952,0.162162162162162
2009,47035,131,644,329,1368,0,29,329,1397,0.035772815732869,0.235504652827487
2009,47037,3588,11587,6402,12966,1132,2436,7534,15402,0.0369024201489802,0.489157252304895
2009,47039,0,144,5,136,0,0,5,136,0.0166218528477145,0.0367647058823529
2009,47041,185,653,33,167,0,35,33,202,0.015645573541941,0.163366336633663
2009,47043,229,1201,203,917,14,71,217,988,0.0316829143150334,0.219635627530364
2009,47045,165,722,25,305,0,0,25,305,0.0121118259073942,0.0819672131147541
2009,47047,194,1528,69,268,10,17,79,285,0.0112532575219142,0.27719298245614
2009,47049,64,152,0,88,11,11,11,99,0.00810478919361441,0.111111111111111
2009,47051,193,767,271,619,8,37,279,656,0.0236874413230303,0.42530487804878
2009,47053,281,1024,73,582,4,46,77,628,0.0189636429520473,0.122611464968153
2009,47055,21,268,87,603,0,5,87,608,0.0303802528356568,0.143092105263158
2009,47057,0,788,41,285,0,33,41,318,0.0199398043641836,0.128930817610063
2009,47059,97,757,109,933,10,45,119,978,0.021157382368848,0.121676891615542
2009,47061,10,192,13,50,0,0,13,50,0.0051562338867691,0.26
2009,47063,83,980,125,990,0,208,125,1198,0.0285925678417146,0.104340567612688
2009,47065,635,3172,2589,7382,284,598,2873,7980,0.0351332907742092,0.360025062656642
2009,47067,7,107,3,41,0,0,3,41,0.00896959089914679,0.0731707317073171
2009,47069,121,1211,47,155,0,19,47,174,0.0091391354587951,0.270114942528736
2009,47071,4,420,0,441,12,23,12,464,0.0251327050157079,0.0258620689655172
2009,47073,226,1774,278,1020,0,25,278,1045,0.0259704756697649,0.266028708133971
2009,47075,83,253,0,99,0,8,0,107,0.00860959124557451,0
2009,47077,51,486,41,367,0,0,41,367,0.0200678040244969,0.111716621253406
2009,47079,36,419,121,416,58,64,179,480,0.0212436379730029,0.372916666666667
2009,47081,138,1222,83,144,0,0,83,144,0.00892138033579084,0.576388888888889
2009,47083,31,65,17,54,0,0,17,54,0.00987925356750823,0.314814814814815
2009,47085,92,264,14,291,0,7,14,298,0.0234738085860575,0.0469798657718121
2009,47087,0,297,0,120,0,5,0,125,0.0158167784385676,0
2009,47089,149,1405,300,999,3,17,303,1016,0.029605454863337,0.298228346456693
2009,47091,58,299,64,269,0,0,64,269,0.019730086548335,0.237918215613383
2009,47093,1535,4954,3064,7158,261,687,3325,7845,0.0286768092526118,0.423836838750797
2009,47095,10,512,2,81,5,12,7,93,0.0171239182471,0.0752688172043011
2009,47097,37,901,55,258,15,33,70,291,0.0165915958720566,0.240549828178694
2009,47099,89,432,55,414,2,2,57,416,0.0153579207738029,0.137019230769231
2009,47101,0,404,0,144,0,70,0,214,0.0280031405391259,0
2009,47103,30,244,80,498,0,41,80,539,0.0240346026933024,0.148423005565863
2009,47105,194,1173,177,952,5,33,182,985,0.030189720170411,0.184771573604061
2009,47107,225,1407,70,396,0,113,70,509,0.014225426902546,0.137524557956778
2009,47109,39,274,57,431,0,37,57,468,0.0266393442622951,0.121794871794872
2009,47111,0,219,0,242,0,74,0,316,0.0222081664206901,0
2009,47113,214,1150,493,1339,54,160,547,1499,0.0242004488141942,0.364909939959973
2009,47115,86,295,83,512,0,14,83,526,0.0270590050928546,0.157794676806084
2009,47117,93,721,9,260,0,24,9,284,0.0143325763310623,0.0316901408450704
2009,47119,339,1708,309,1487,46,127,355,1614,0.0298557158712542,0.219950433705081
2009,47121,0,616,50,231,0,0,50,231,0.0283227072094164,0.216450216450216
2009,47123,75,1012,103,610,9,55,112,665,0.0219653179190751,0.168421052631579
2009,47125,423,1441,1539,6540,545,1987,2084,8527,0.0918442084401456,0.244400140729448
2009,47127,10,152,0,177,0,0,0,177,0.0414325842696629,0
2009,47129,20,858,0,60,0,0,0,60,0.00448564593301435,0
2009,47131,43,479,23,347,0,93,23,440,0.0199718578366847,0.0522727272727273
2009,47133,0,418,48,181,0,11,48,192,0.0131678211370962,0.25
2009,47135,14,126,0,76,0,0,0,76,0.0142082632267714,0
2009,47137,0,85,0,18,0,28,0,46,0.0141017780502759,0
2009,47139,0,498,111,238,0,40,111,278,0.024761735102877,0.399280575539568
2009,47141,219,1158,208,1022,114,128,322,1150,0.0268559818780505,0.28
2009,47143,23,494,69,444,0,48,69,492,0.0240881272949816,0.140243902439024
2009,47145,178,1012,91,796,17,17,108,813,0.0212983338572776,0.132841328413284
2009,47147,75,1139,116,725,14,91,130,816,0.0196484469058512,0.159313725490196
2009,47149,1130,5495,1353,4802,122,306,1475,5108,0.0335175002296618,0.28876272513704
2009,47151,57,231,15,240,0,0,15,240,0.0164024056861673,0.0625
2009,47153,11,166,115,223,0,64,115,287,0.0314865606143719,0.400696864111498
2009,47155,340,1552,428,2787,101,194,529,2981,0.0510716304887869,0.177457229117746
2009,47157,1427,4120,5830,16432,953,2200,6783,18632,0.0322279898500513,0.364051094890511
2009,47159,40,311,67,151,0,12,67,163,0.0127702914446882,0.411042944785276
2009,47161,13,227,55,223,0,20,55,243,0.0272207908591912,0.226337448559671
2009,47163,321,2402,676,3165,24,126,700,3291,0.0301075859040509,0.212701306593741
2009,47165,635,3941,1046,3648,49,282,1095,3930,0.0389293921863856,0.278625954198473
2009,47167,160,1507,89,766,0,34,89,800,0.0216555681879703,0.11125
2009,47169,5,245,12,12,0,9,12,21,0.00401760091830878,0.571428571428571
2009,47171,75,258,23,255,0,0,23,255,0.0197797083462612,0.0901960784313725
2009,47173,67,568,0,106,0,0,0,106,0.00817081631079935,0
2009,47175,0,77,0,87,0,11,0,98,0.0267686424474187,0
2009,47177,112,408,37,342,0,76,37,418,0.0155425001859151,0.0885167464114833
2009,47179,773,3484,794,2415,149,438,943,2853,0.0350508624502433,0.330529267437785
2009,47181,33,745,5,232,0,17,5,249,0.0212620613098796,0.0200803212851406
2009,47183,37,379,122,585,27,71,149,656,0.0310988906798142,0.227134146341463
2009,47185,15,355,25,283,16,16,41,299,0.0174211967604731,0.137123745819398
2009,47187,1533,3494,2121,3563,140,342,2261,3905,0.0367657443062525,0.579001280409731
2009,47189,703,2662,301,1484,36,95,337,1579,0.0221782122591157,0.213426219126029
2009,48001,265,4445,81,515,6,159,87,674,0.016956828016504,0.129080118694362
2009,48003,20,257,12,85,14,35,26,120,0.0147148988350705,0.216666666666667
2009,48005,454,2565,189,985,0,151,189,1136,0.0215314632297195,0.16637323943662
2009,48007,215,975,76,161,18,47,94,208,0.0121197995571612,0.451923076923077
2009,48009,21,150,0,39,0,31,0,70,0.0117805452709525,0
2009,48011,56,185,0,13,0,0,0,13,0.00898410504492052,0
2009,48013,68,797,108,425,0,0,108,425,0.0158363453441145,0.254117647058824
2009,48015,195,863,62,294,6,7,68,301,0.0172502722219038,0.225913621262458
2009,48017,45,159,42,72,0,0,42,72,0.0198565912851627,0.583333333333333
2009,48019,215,394,203,314,0,29,203,343,0.0235044199273624,0.591836734693878
2009,48021,361,1871,142,1041,66,164,208,1205,0.0256415712644167,0.172614107883817
2009,48023,24,174,0,0,0,0,0,0,0,NA
2009,48025,195,3272,47,199,0,49,47,248,0.0115268417383221,0.189516129032258
2009,48027,1468,5144,1616,6481,993,5079,2609,11560,0.0749850808230196,0.225692041522491
2009,48029,6720,21767,8469,23391,2565,7070,11034,30461,0.0313587702330006,0.362233675847805
2009,48031,122,269,16,93,0,0,16,93,0.0149662053427744,0.172043010752688
2009,48033,0,13,0,0,0,4,0,4,0.00985221674876847,0
2009,48035,35,688,9,196,0,19,9,215,0.0174428038293039,0.0418604651162791
2009,48037,221,1725,336,2741,23,198,359,2939,0.0485167637882365,0.122150391289554
2009,48039,3300,11674,998,3144,324,911,1322,4055,0.021794630619978,0.326017262638718
2009,48041,1210,4358,708,1526,614,930,1322,2456,0.0332683138274816,0.538273615635179
2009,48043,60,272,90,228,0,0,90,228,0.041036717062635,0.394736842105263
2009,48045,0,13,0,12,0,0,0,12,0.0107334525939177,0
2009,48047,0,232,0,121,0,0,0,121,0.0254897830208553,0
2009,48049,89,1324,5,131,0,80,5,211,0.00836538080323514,0.023696682464455
2009,48051,24,387,0,73,0,0,0,73,0.00640575640575641,0
2009,48053,306,1748,79,429,0,29,79,458,0.0150232893787312,0.172489082969432
2009,48055,160,2414,48,305,17,38,65,343,0.0145653743258737,0.189504373177843
2009,48057,124,541,0,224,92,102,92,326,0.0248267458685553,0.282208588957055
2009,48059,149,544,0,69,0,0,0,69,0.00768887898373078,0
2009,48061,491,2418,632,3008,321,1623,953,4631,0.0218600128393943,0.205787087022241
2009,48063,24,299,37,105,0,36,37,141,0.0179434970730466,0.26241134751773
2009,48065,38,191,25,53,0,0,25,53,0.0126976521322472,0.471698113207547
2009,48067,63,456,49,226,9,23,58,249,0.0121540489090643,0.232931726907631
2009,48069,33,101,21,46,0,0,21,46,0.0104426787741203,0.456521739130435
2009,48071,69,918,17,162,0,0,17,162,0.00856734888148501,0.104938271604938
2009,48073,112,1246,34,173,0,56,34,229,0.00733222336065574,0.148471615720524
2009,48075,35,460,0,156,0,0,0,156,0.0311439409063685,0
2009,48077,60,257,28,113,0,10,28,123,0.0157793457344452,0.227642276422764
2009,48079,6,75,0,32,0,29,0,61,0.0314432989690722,0
2009,48081,0,202,3,32,0,0,3,32,0.0131578947368421,0.09375
2009,48083,24,128,15,54,0,0,15,54,0.0093603744149766,0.277777777777778
2009,48085,11583,26176,6245,14359,2492,4853,8737,19212,0.0409441972277633,0.454767853424943
2009,48087,14,55,0,31,0,0,0,31,0.0169956140350877,0
2009,48089,83,717,32,78,0,19,32,97,0.00711247983575304,0.329896907216495
2009,48091,1216,4638,434,1424,92,462,526,1886,0.0265701163675298,0.278897136797455
2009,48093,47,341,31,71,16,25,47,96,0.0103896103896104,0.489583333333333
2009,48095,48,371,11,182,0,126,11,308,0.107391910739191,0.0357142857142857
2009,48097,329,1088,46,748,3,65,49,813,0.0328020980431713,0.0602706027060271
2009,48099,294,2887,404,2220,172,1286,576,3506,0.0843883887738892,0.164289788933257
2009,48101,5,32,36,36,0,0,36,36,0.031858407079646,1
2009,48103,0,20,0,8,0,0,0,8,0.00332778702163062,0
2009,48105,0,63,0,0,0,0,0,0,0,NA
2009,48107,8,148,38,70,0,10,38,80,0.0201765447667087,0.475
2009,48109,0,35,30,30,0,31,30,61,0.040748162992652,0.491803278688525
2009,48111,24,265,0,91,6,6,6,97,0.0261737722611981,0.0618556701030928
2009,48113,13660,43473,11789,27750,4425,13345,16214,41095,0.0278781407427206,0.394549215232997
2009,48115,117,717,0,31,0,0,0,31,0.00334881711137518,0
2009,48117,43,324,9,117,0,46,9,163,0.0154399924220896,0.0552147239263804
2009,48119,8,77,0,19,0,0,0,19,0.00506937033084312,0
2009,48121,9240,25397,5571,12943,977,2176,6548,15119,0.0391909336457755,0.433097427078511
2009,48123,86,930,21,53,5,16,26,69,0.00500725689404935,0.376811594202899
2009,48125,16,241,0,62,0,10,0,72,0.0406549971767363,0
2009,48127,5,156,0,27,0,0,0,27,0.00459574468085106,0
2009,48129,18,109,0,10,0,0,0,10,0.0043956043956044,0
2009,48131,56,590,0,41,0,15,0,56,0.00744779890942945,0
2009,48133,22,595,23,163,0,44,23,207,0.0171727227476356,0.111111111111111
2009,48135,412,2971,58,924,29,313,87,1237,0.0163035598961422,0.0703314470493129
2009,48137,30,78,0,0,0,0,0,0,0,NA
2009,48139,633,4711,321,1345,22,242,343,1587,0.0181674565560821,0.216131064902331
2009,48141,726,3308,2495,9466,1473,4927,3968,14393,0.0342426318744588,0.275689571319391
2009,48143,52,852,11,124,9,27,20,151,0.00784293356879447,0.132450331125828
2009,48145,150,995,0,25,0,0,0,25,0.00223353881890467,0
2009,48147,249,1883,10,238,0,134,10,372,0.0164427157001414,0.0268817204301075
2009,48149,129,679,56,85,4,56,60,141,0.00881580592722271,0.425531914893617
2009,48151,20,148,2,40,0,0,2,40,0.0137127185464518,0.05
2009,48153,23,144,0,20,0,0,0,20,0.00455477112275108,0
2009,48155,0,26,5,14,0,0,5,14,0.015712682379349,0.357142857142857
2009,48157,5420,16365,3105,6427,1482,2825,4587,9252,0.0296709640177025,0.495784695201038
2009,48159,50,513,25,109,0,0,25,109,0.0154478458049887,0.229357798165138
2009,48161,146,831,0,130,0,52,0,182,0.0141271442986882,0
2009,48163,36,705,0,126,0,177,0,303,0.0310673638880345,0
2009,48165,13,250,0,141,0,124,0,265,0.0319008065486939,0
2009,48167,2319,8924,1331,3970,354,712,1685,4682,0.0253596498830055,0.359888936351986
2009,48169,0,174,0,285,0,72,0,357,0.110663360198388,0
2009,48171,144,943,14,109,0,64,14,173,0.0101181424728038,0.0809248554913295
2009,48173,0,28,0,0,0,0,0,0,0,NA
2009,48175,4,202,0,0,0,0,0,0,0,NA
2009,48177,213,467,0,25,0,13,0,38,0.00311782080735149,0
2009,48179,78,1144,14,234,0,22,14,256,0.0176417889876645,0.0546875
2009,48181,463,2499,441,1263,7,140,448,1403,0.0178712455098973,0.319315751960086
2009,48183,577,3589,281,1397,155,331,436,1728,0.0234773039142426,0.252314814814815
2009,48185,312,1940,0,102,0,121,0,223,0.0126367087890293,0
2009,48187,1386,4588,630,1930,126,247,756,2177,0.0302201615813876,0.347266881028939
2009,48189,77,2083,64,343,0,54,64,397,0.018910164808993,0.161209068010076
2009,48191,15,109,0,0,0,0,0,0,0,NA
2009,48193,0,248,4,13,0,0,4,13,0.00230292294065545,0.307692307692308
2009,48195,3,42,24,83,0,0,24,83,0.0260596546310832,0.289156626506024
2009,48197,32,170,0,14,0,0,0,14,0.00495926319518243,0
2009,48199,279,2075,11,461,0,60,11,521,0.0154215013023917,0.0211132437619962
2009,48201,13933,47425,17974,53686,8762,21920,26736,75606,0.0315209923154918,0.353622728354892
2009,48203,292,1492,176,695,89,143,265,838,0.0207477098291656,0.316229116945107
2009,48205,27,552,33,70,0,30,33,100,0.0265533722782793,0.33
2009,48207,9,52,0,15,0,0,0,15,0.00395673964653126,0
2009,48209,1860,6592,675,1880,100,188,775,2068,0.0269921033740129,0.374758220502901
2009,48211,0,65,8,57,0,0,8,57,0.0248366013071895,0.140350877192982
2009,48213,392,2943,29,523,3,44,32,567,0.0105099260412612,0.0564373897707231
2009,48215,995,6090,1204,5771,801,3914,2005,9685,0.025805815567688,0.20702116675271
2009,48217,185,1243,63,266,9,50,72,316,0.0135221875133724,0.227848101265823
2009,48219,153,757,0,58,12,21,12,79,0.00593761743705374,0.151898734177215
2009,48221,349,1605,208,765,70,78,278,843,0.0243987149431276,0.329774614472123
2009,48223,111,1070,45,285,0,24,45,309,0.0138820252482142,0.145631067961165
2009,48225,115,566,0,215,7,42,7,257,0.0166731542753341,0.0272373540856031
2009,48227,90,1693,93,1009,10,216,103,1225,0.0567471163200074,0.0840816326530612
2009,48229,20,89,4,28,0,4,4,32,0.016268429079817,0.125
2009,48231,340,2760,70,647,86,216,156,863,0.0162511298583911,0.180764774044032
2009,48233,17,431,27,321,2,46,29,367,0.0264333045231922,0.0790190735694823
2009,48235,0,32,0,25,0,0,0,25,0.0207125103562552,0
2009,48237,61,694,0,137,10,10,10,147,0.0248815165876777,0.0680272108843537
2009,48239,81,318,0,88,0,4,0,92,0.00982905982905983,0
2009,48241,117,1161,51,203,11,38,62,241,0.0104401316929475,0.257261410788382
2009,48243,17,104,4,30,0,0,4,30,0.0194426441996111,0.133333333333333
2009,48245,926,6000,935,2798,59,612,994,3410,0.0217223740452666,0.291495601173021
2009,48247,19,76,0,91,0,24,0,115,0.0406791651927839,0
2009,48249,62,903,30,311,0,115,30,426,0.0174819435325016,0.0704225352112676
2009,48251,681,5359,252,1173,11,422,263,1595,0.0166718929654019,0.164890282131661
2009,48253,172,2193,42,126,0,11,42,137,0.0102284605047036,0.306569343065693
2009,48255,49,2244,0,168,0,220,0,388,0.0322178859088267,0
2009,48257,541,4664,141,928,91,272,232,1200,0.0200176822860193,0.193333333333333
2009,48259,625,1375,136,495,8,136,144,631,0.0300418967815654,0.228209191759113
2009,48261,0,0,0,0,0,0,0,0,0,NA
2009,48263,2,65,0,14,0,0,0,14,0.0252252252252252,0
2009,48265,471,1786,108,529,27,76,135,605,0.018260843318946,0.223140495867769
2009,48267,124,484,0,8,0,0,0,8,0.00244947948560931,0
2009,48269,0,20,0,7,0,0,0,7,0.0402298850574713,0
2009,48271,43,156,8,27,0,39,8,66,0.0285467128027682,0.121212121212121
2009,48273,175,661,76,505,78,103,154,608,0.0375470882480084,0.253289473684211
2009,48275,0,118,0,8,0,0,0,8,0.00305810397553517,0
2009,48277,175,710,140,679,9,94,149,773,0.0238543434655146,0.192755498059508
2009,48279,53,297,25,86,0,5,25,91,0.0106370543541788,0.274725274725275
2009,48281,74,696,84,358,0,47,84,405,0.0301406563965171,0.207407407407407
2009,48283,29,540,0,37,0,0,0,37,0.0101788170563961,0
2009,48285,83,513,0,15,0,0,0,15,0.00117490404950262,0
2009,48287,69,636,12,199,0,0,12,199,0.0191640986132512,0.0603015075376884
2009,48289,61,550,27,84,0,0,27,84,0.00729673384294649,0.321428571428571
2009,48291,362,4861,48,1039,16,197,64,1236,0.0257355237678806,0.0517799352750809
2009,48293,68,1407,11,230,0,232,11,462,0.0307323887447615,0.0238095238095238
2009,48295,8,93,18,96,0,0,18,96,0.0493573264781491,0.1875
2009,48297,32,656,0,126,0,30,0,156,0.0196448809973555,0
2009,48299,123,545,0,165,0,0,0,165,0.0116238112011272,0
2009,48301,0,4,0,0,0,0,0,0,0,NA
2009,48303,1210,5151,761,2071,216,466,977,2537,0.0173228453985552,0.38510051241624
2009,48305,20,134,0,19,0,4,0,23,0.00628587045640885,0
2009,48307,102,233,0,63,0,0,0,63,0.0117427772600186,0
2009,48309,1169,4311,351,1788,135,638,486,2426,0.0186499181279357,0.200329760923331
2009,48311,30,68,0,17,0,0,0,17,0.0246734397677794,0
2009,48313,73,625,14,34,0,28,14,62,0.00704225352112676,0.225806451612903
2009,48315,37,305,17,78,0,0,17,78,0.00995405819295559,0.217948717948718
2009,48317,17,100,0,12,0,25,0,37,0.0121351262709085,0
2009,48319,22,79,0,0,0,0,0,0,0,NA
2009,48321,72,1025,37,272,0,50,37,322,0.0138114437676932,0.114906832298137
2009,48323,114,518,14,299,24,219,38,518,0.0186324232941261,0.0733590733590734
2009,48325,143,1072,6,164,11,11,17,175,0.00629972281219626,0.0971428571428571
2009,48327,0,88,0,5,0,9,0,14,0.00916230366492147,0
2009,48329,663,2999,484,1352,72,312,556,1664,0.0215393377689181,0.334134615384615
2009,48331,96,558,0,61,0,52,0,113,0.00701906950742282,0
2009,48333,23,139,5,6,0,0,5,6,0.00165608611647806,0.833333333333333
2009,48335,47,1219,9,55,0,0,9,55,0.00846284043699031,0.163636363636364
2009,48337,153,586,0,86,0,37,0,123,0.00906210859795182,0
2009,48339,3778,14823,3153,8186,1098,2268,4251,10454,0.0400050513361167,0.406638607231682
2009,48341,40,417,123,520,0,59,123,579,0.0502255378209577,0.212435233160622
2009,48343,102,466,23,90,0,0,23,90,0.0103021978021978,0.255555555555556
2009,48345,0,43,0,0,0,0,0,0,0,NA
2009,48347,268,1280,237,542,47,123,284,665,0.0202047823048643,0.427067669172932
2009,48349,315,1633,60,406,25,131,85,537,0.0175881042840299,0.15828677839851
2009,48351,33,497,0,138,0,4,0,142,0.0145402416547205,0
2009,48353,141,322,10,109,8,73,18,182,0.0191841467271002,0.0989010989010989
2009,48355,1201,6559,1651,3880,206,864,1857,4744,0.0237307975128684,0.391441821247892
2009,48357,56,230,9,168,10,195,19,363,0.0656538252848616,0.0523415977961433
2009,48359,6,13,0,4,3,3,3,7,0.00532319391634981,0.428571428571429
2009,48361,230,1679,87,774,30,116,117,890,0.0164434180138568,0.131460674157303
2009,48363,150,976,12,98,0,6,12,104,0.00574363505826476,0.115384615384615
2009,48365,65,456,32,188,0,6,32,194,0.0126211697352157,0.164948453608247
2009,48367,560,5418,465,1695,54,293,519,1988,0.028171808352346,0.261066398390342
2009,48369,85,208,24,100,0,49,24,149,0.0259717622450758,0.161073825503356
2009,48371,84,953,0,83,0,28,0,111,0.0108919634972034,0
2009,48373,108,1829,35,307,13,41,48,348,0.0105540897097625,0.137931034482759
2009,48375,738,4980,449,2153,74,432,523,2585,0.0345662173727,0.202321083172147
2009,48377,12,95,8,8,5,29,13,37,0.0080417300586829,0.351351351351351
2009,48379,19,672,0,66,0,0,0,66,0.00850186783460003,0
2009,48381,778,3686,276,762,126,132,402,894,0.0131741821396994,0.449664429530201
2009,48383,27,77,0,11,0,0,0,11,0.00626423690205011,0
2009,48385,0,88,0,22,0,0,0,22,0.0101242521859181,0
2009,48387,59,377,37,96,0,27,37,123,0.0132714717306862,0.300813008130081
2009,48389,121,434,0,186,0,32,0,218,0.029838488913222,0
2009,48391,66,433,0,1,0,0,0,1,0.000198412698412698,0
2009,48393,12,12,24,24,0,0,24,24,0.0386473429951691,1
2009,48395,91,510,7,53,0,0,7,53,0.00507468402910762,0.132075471698113
2009,48397,1105,4261,291,893,83,410,374,1303,0.0285151548309443,0.287029930928626
2009,48399,47,166,4,16,3,39,7,55,0.00796524257784214,0.127272727272727
2009,48401,374,3307,88,352,6,61,94,413,0.0126624969340201,0.227602905569007
2009,48403,80,392,0,36,0,0,0,36,0.00472999605833662,0
2009,48405,8,134,0,29,0,0,0,29,0.00481088254810883,0
2009,48407,51,997,3,194,47,52,50,246,0.0145218417945691,0.203252032520325
2009,48409,330,2103,197,1011,12,85,209,1096,0.0264478764478764,0.190693430656934
2009,48411,28,123,0,11,0,0,0,11,0.00295778435063189,0
2009,48413,19,154,13,14,0,0,13,14,0.00728029121164847,0.928571428571429
2009,48415,80,503,47,222,0,0,47,222,0.0219021310181531,0.211711711711712
2009,48417,9,41,0,0,0,0,0,0,0,NA
2009,48419,117,639,0,156,0,0,0,156,0.00907662768371444,0
2009,48421,20,98,27,52,0,18,27,70,0.0407450523864959,0.385714285714286
2009,48423,1554,5772,527,2096,129,526,656,2622,0.0208100192861735,0.250190694126621
2009,48425,9,325,0,42,0,0,0,42,0.00864197530864197,0
2009,48427,114,724,5,177,16,97,21,274,0.00872250342215006,0.0766423357664234
2009,48429,102,654,0,41,0,25,0,66,0.0106623586429725,0
2009,48431,11,44,0,0,0,0,0,0,0,NA
2009,48433,13,48,0,0,0,0,0,0,0,NA
2009,48435,12,102,0,54,0,0,0,54,0.020501138952164,0
2009,48437,51,511,0,36,0,9,0,45,0.00962155227710071,0
2009,48439,9616,34189,7751,24743,2256,7137,10007,31880,0.0300341322651181,0.313895859473024
2009,48441,780,3195,624,1905,93,452,717,2357,0.0304569183852794,0.304200254560882
2009,48443,13,39,0,0,0,14,0,14,0.0232558139534884,0
2009,48445,44,810,0,20,8,19,8,39,0.0050695437410633,0.205128205128205
2009,48447,0,12,0,0,0,7,0,7,0.00568643379366369,0
2009,48449,172,631,20,448,2,61,22,509,0.0293456327471894,0.0432220039292731
2009,48451,753,2361,594,1903,35,382,629,2285,0.0342995241597742,0.27527352297593
2009,48453,11606,26454,12420,21411,3334,7435,15754,28846,0.0455911150588499,0.546141579421757
2009,48455,95,562,0,59,0,37,0,96,0.00980592441266599,0
2009,48457,221,887,20,184,0,0,20,184,0.012884251803095,0.108695652173913
2009,48459,134,1389,0,203,0,38,0,241,0.0095889865913341,0
2009,48461,27,316,0,124,0,0,0,124,0.0610536681437715,0
2009,48463,83,604,8,94,0,0,8,94,0.00588529927372903,0.0851063829787234
2009,48465,57,566,222,836,13,110,235,946,0.0336810624132161,0.248414376321353
2009,48467,209,1992,18,190,4,23,22,213,0.00602887064817436,0.103286384976526
2009,48469,353,2675,82,528,55,95,137,623,0.0115069910049685,0.219903691813804
2009,48471,529,6146,70,354,28,69,98,423,0.0104338817493402,0.231678486997636
2009,48473,111,973,58,435,0,53,58,488,0.0237169517884914,0.118852459016393
2009,48475,28,268,2,90,0,0,2,90,0.0142993326978074,0.0222222222222222
2009,48477,144,833,73,93,0,92,73,185,0.00891008043153687,0.394594594594595
2009,48479,325,1791,556,1329,375,1305,931,2634,0.021868539689656,0.353454821564161
2009,48481,202,871,0,81,24,85,24,166,0.00645336858064767,0.144578313253012
2009,48483,15,117,5,41,0,0,5,41,0.0128930817610063,0.121951219512195
2009,48485,331,3027,526,2194,127,550,653,2744,0.034867911102075,0.237973760932945
2009,48487,77,392,0,154,0,0,0,154,0.0184276654301783,0
2009,48489,6,742,30,125,0,14,30,139,0.0116561844863732,0.215827338129496
2009,48491,5819,16983,3237,8090,594,1304,3831,9394,0.0396578800722741,0.407813497977432
2009,48493,217,1697,53,310,0,24,53,334,0.0132104576197445,0.158682634730539
2009,48495,2,194,9,81,0,20,9,101,0.0247913598429062,0.0891089108910891
2009,48497,529,2539,61,580,9,135,70,715,0.0191560616208975,0.0979020979020979
2009,48499,302,2193,18,372,0,137,18,509,0.0175893289100836,0.0353634577603143
2009,48501,0,67,0,66,0,2,0,68,0.0151853506029477,0
2009,48503,114,580,10,312,0,32,10,344,0.0283992404854289,0.0290697674418605
2009,48505,0,1,20,163,0,31,20,194,0.02578073089701,0.103092783505155
2009,48507,0,192,11,208,0,104,11,312,0.0472297910990009,0.0352564102564103
2009,49001,5,172,0,146,0,18,0,164,0.0456951797157983,0
2009,49003,214,837,59,335,29,95,88,430,0.0157584197603254,0.204651162790698
2009,49005,394,1214,683,1882,368,523,1051,2405,0.0483991064780342,0.437006237006237
2009,49007,65,462,73,448,0,5,73,453,0.0368532378782948,0.161147902869757
2009,49009,11,69,23,29,0,0,23,29,0.0533088235294118,0.793103448275862
2009,49011,2142,6332,1798,4785,170,623,1968,5408,0.0336911355183563,0.363905325443787
2009,49013,49,360,27,124,9,16,36,140,0.0154491282277643,0.257142857142857
2009,49015,19,129,28,77,0,2,28,79,0.0130298532079828,0.354430379746835
2009,49017,7,101,17,82,0,1,17,83,0.0270976167156383,0.204819277108434
2009,49019,0,109,46,188,0,0,46,188,0.0298744636898141,0.24468085106383
2009,49021,280,717,241,942,24,42,265,984,0.0481220657276995,0.269308943089431
2009,49023,60,198,0,79,0,0,0,79,0.014824544942766,0
2009,49025,1,140,87,306,0,0,87,306,0.0713952403173122,0.284313725490196
2009,49027,56,161,34,67,0,8,34,75,0.0108885017421603,0.453333333333333
2009,49029,10,74,3,108,0,0,3,108,0.0226843100189036,0.0277777777777778
2009,49031,0,17,1,4,0,0,1,4,0.00427807486631016,0.25
2009,49033,13,43,0,3,0,0,0,3,0.00231124807395994,0
2009,49035,3506,10365,7302,18895,1282,4304,8584,23199,0.0381501008061201,0.370015948963317
2009,49037,39,310,74,212,32,32,106,244,0.0309487569761542,0.434426229508197
2009,49039,124,959,37,266,15,37,52,303,0.0234683603129115,0.171617161716172
2009,49041,15,331,67,245,16,30,83,275,0.0242312097982201,0.301818181818182
2009,49043,273,504,461,743,87,126,548,869,0.0379194484443863,0.630609896432681
2009,49045,104,1441,379,1369,18,27,397,1396,0.0451619164698651,0.284383954154728
2009,49047,51,719,74,446,0,0,74,446,0.0268739455290431,0.165919282511211
2009,49049,1477,4946,2585,6603,962,1719,3547,8322,0.0369600554267594,0.426219658735881
2009,49051,113,480,76,383,0,14,76,397,0.0333809804086437,0.191435768261965
2009,49053,746,2781,841,3677,123,460,964,4137,0.0520331543134567,0.233019095963258
2009,49055,20,37,0,11,8,50,8,61,0.0379825653798257,0.131147540983607
2009,49057,825,4358,1042,3461,44,302,1086,3763,0.0280475533857563,0.288599521658251
2009,50001,160,444,263,465,12,36,275,501,0.0211249789171867,0.548902195608782
2009,50003,45,234,345,898,0,0,345,898,0.0351660401002506,0.384187082405345
2009,50005,162,551,250,448,17,33,267,481,0.0231930179854381,0.555093555093555
2009,50007,392,1351,1857,3119,177,446,2034,3565,0.0375480541366054,0.57054698457223
2009,50009,47,101,43,125,7,7,50,132,0.0282352941176471,0.378787878787879
2009,50011,111,717,122,502,71,124,193,626,0.0195612774201612,0.308306709265176
2009,50013,56,169,70,176,5,7,75,183,0.0335472043996334,0.409836065573771
2009,50015,37,438,230,517,29,54,259,571,0.0325226405422339,0.453590192644483
2009,50017,95,343,190,447,52,52,242,499,0.0249662280482313,0.48496993987976
2009,50019,48,364,117,317,16,74,133,391,0.020353982300885,0.340153452685422
2009,50021,164,634,366,1015,19,37,385,1052,0.023670236702367,0.365969581749049
2009,50023,271,800,630,1033,38,93,668,1126,0.0275399892383701,0.593250444049734
2009,50025,115,358,721,1302,28,80,749,1382,0.0448832451040889,0.541968162083936
2009,50027,282,882,963,1701,36,99,999,1800,0.0437392170680145,0.555
2009,51001,21,211,157,727,0,83,157,810,0.0302871672150763,0.193827160493827
2009,51003,1713,3078,1535,2217,243,502,1778,2719,0.0452608449578853,0.653916881206326
2009,51005,91,460,0,126,0,23,0,149,0.0128138974888201,0
2009,51007,33,225,0,96,0,43,0,139,0.0158494868871152,0
2009,51009,145,819,84,330,0,45,84,375,0.0172819023918153,0.224
2009,51011,53,433,9,137,0,0,9,137,0.0139142799106236,0.0656934306569343
2009,51013,4426,6183,8839,11292,2447,3324,11286,14616,0.095823772372648,0.772167487684729
2009,51015,143,1501,77,348,25,37,102,385,0.00771852445870088,0.264935064935065
2009,51017,13,54,0,27,0,0,0,27,0.00787631271878646,0
2009,51019,262,1864,218,738,36,70,254,808,0.0175100227543613,0.314356435643564
2009,51021,21,151,23,153,0,0,23,153,0.0304114490161002,0.150326797385621
2009,51023,224,677,19,89,0,18,19,107,0.00467126517069763,0.177570093457944
2009,51025,28,412,13,90,0,0,13,90,0.00730460189919649,0.144444444444444
2009,51027,59,140,39,295,0,0,39,295,0.0172041756575494,0.132203389830508
2009,51029,335,998,45,313,15,25,60,338,0.024501631025734,0.177514792899408
2009,51031,190,1419,188,555,0,23,188,578,0.015966409767686,0.325259515570934
2009,51033,179,1019,42,205,0,7,42,212,0.0115179832663262,0.19811320754717
2009,51035,30,256,47,381,0,0,47,381,0.0177374301675978,0.123359580052493
2009,51036,2,125,11,38,0,0,11,38,0.00726160901968278,0.289473684210526
2009,51037,12,138,4,18,0,4,4,22,0.00261998332737883,0.181818181818182
2009,51041,2173,6970,2002,4281,287,812,2289,5093,0.0267980699917391,0.449440408403691
2009,51043,99,561,123,171,0,0,123,171,0.0169072572671544,0.719298245614035
2009,51045,42,79,13,67,0,0,13,67,0.0179817498658078,0.194029850746269
2009,51047,301,1482,176,461,14,128,190,589,0.0198872269304791,0.32258064516129
2009,51049,14,413,0,91,6,13,6,104,0.0155945419103314,0.0576923076923077
2009,51051,16,169,23,297,0,35,23,332,0.0293831312505531,0.0692771084337349
2009,51053,56,760,44,123,0,26,44,149,0.00847120359315481,0.295302013422819
2009,51057,68,394,21,93,0,0,21,93,0.0120716510903427,0.225806451612903
2009,51059,11218,21004,14986,22750,5497,9413,20483,32163,0.0479130851897425,0.636849796349843
2009,51061,285,1726,280,740,34,104,314,844,0.0192945156939396,0.372037914691943
2009,51063,32,141,116,157,0,0,116,157,0.0149666348903718,0.738853503184713
2009,51065,297,760,60,227,0,61,60,288,0.0163654960790999,0.208333333333333
2009,51067,219,1052,126,560,0,37,126,597,0.016679238957338,0.21105527638191
2009,51069,504,2157,335,1240,25,52,360,1292,0.0270899293397354,0.278637770897833
2009,51071,41,361,17,278,0,31,17,309,0.025317492830807,0.0550161812297735
2009,51073,191,1384,79,371,18,126,97,497,0.0188586172876983,0.195171026156942
2009,51075,142,548,120,170,11,12,131,182,0.0119532378825693,0.71978021978022
2009,51077,46,354,25,202,0,5,25,207,0.0172313327228835,0.120772946859903
2009,51079,88,386,124,181,16,48,140,229,0.0192809632061968,0.611353711790393
2009,51081,18,290,0,97,0,0,0,97,0.0112698965957941,0
2009,51083,143,679,97,487,0,14,97,501,0.0201075614063253,0.193612774451098
2009,51085,769,2568,343,1004,11,92,354,1096,0.0169021035099624,0.322992700729927
2009,51087,3315,9394,2722,4798,615,1170,3337,5968,0.0305277911342548,0.559148793565684
2009,51089,88,1326,28,469,0,145,28,614,0.0155584836813298,0.0456026058631922
2009,51091,18,59,10,22,0,0,10,22,0.011144883485309,0.454545454545455
2009,51093,290,1024,220,463,43,89,263,552,0.0229350174505568,0.476449275362319
2009,51095,798,2096,919,1862,159,353,1078,2215,0.0511582788645865,0.486681715575621
2009,51097,39,77,15,50,0,0,15,50,0.0102375102375102,0.3
2009,51099,77,616,274,849,16,97,290,946,0.0670208997520368,0.306553911205074
2009,51101,62,556,0,34,0,0,0,34,0.00332096112521977,0
2009,51103,56,135,23,52,0,3,23,55,0.00616799371986094,0.418181818181818
2009,51105,0,225,44,384,0,41,44,425,0.023876404494382,0.103529411764706
2009,51107,4462,7879,4085,6800,911,2305,4996,9105,0.0515744218056995,0.548709500274574
2009,51109,123,706,45,238,8,21,53,259,0.0116713983146321,0.204633204633205
2009,51111,34,451,15,98,0,6,15,104,0.0113947627917169,0.144230769230769
2009,51113,13,61,40,106,0,0,40,106,0.0112098138747885,0.377358490566038
2009,51115,0,215,0,36,0,0,0,36,0.00550711335474988,0
2009,51117,67,964,19,200,67,135,86,335,0.0144415226106824,0.256716417910448
2009,51119,34,191,25,112,36,36,61,148,0.0181728880157171,0.412162162162162
2009,51121,562,1538,817,1385,121,169,938,1554,0.0359580720549784,0.603603603603604
2009,51125,150,447,0,209,0,0,0,209,0.0186540521242413,0
2009,51127,253,875,72,177,0,0,72,177,0.0146196415296936,0.406779661016949
2009,51131,41,203,11,137,0,20,11,157,0.0166950233943003,0.0700636942675159
2009,51133,80,255,34,130,32,32,66,162,0.0162340915923439,0.407407407407407
2009,51135,28,349,29,49,0,166,29,215,0.0195650195650196,0.134883720930233
2009,51137,288,1289,40,337,13,13,53,350,0.0155176235867879,0.151428571428571
2009,51139,24,506,30,131,8,91,38,222,0.0130549838282858,0.171171171171171
2009,51141,37,243,0,108,0,0,0,108,0.00793301013662406,0
2009,51143,270,1154,205,750,0,69,205,819,0.01906602104479,0.25030525030525
2009,51145,117,2838,80,443,0,11,80,454,0.0227170377783338,0.176211453744493
2009,51147,118,465,141,196,50,50,191,246,0.0203339394941313,0.776422764227642
2009,51149,208,1415,280,965,25,162,305,1127,0.049922480620155,0.270629991126886
2009,51153,3471,9924,3858,8073,684,1536,4542,9609,0.0434191262855387,0.472681860755542
2009,51155,157,1170,96,561,0,41,96,602,0.0235422940049275,0.159468438538206
2009,51157,0,95,20,28,35,53,55,81,0.0157710280373832,0.679012345679012
2009,51159,26,319,0,127,0,0,0,127,0.0196169292554835,0
2009,51161,934,3531,477,1146,48,184,525,1330,0.0215290480275831,0.394736842105263
2009,51163,196,431,14,127,0,0,14,127,0.00831097441266933,0.110236220472441
2009,51165,375,1568,310,885,82,147,392,1032,0.0209377345858102,0.37984496124031
2009,51167,60,531,27,244,0,0,27,244,0.0116936643343238,0.110655737704918
2009,51169,66,441,17,335,0,14,17,349,0.0209358128374325,0.0487106017191977
2009,51171,360,1189,54,367,27,132,81,499,0.0176014109347443,0.162324649298597
2009,51173,113,773,188,357,12,12,200,369,0.0162162162162162,0.5420054200542
2009,51175,65,504,35,85,0,2,35,87,0.00690202300674336,0.402298850574713
2009,51177,1018,3662,599,1939,68,232,667,2171,0.0292540289980057,0.307231690465223
2009,51179,1156,3632,2089,3629,324,608,2413,4237,0.0585366527589732,0.569506726457399
2009,51181,2,183,2,28,0,0,2,28,0.00571895424836601,0.0714285714285714
2009,51183,17,430,52,105,0,8,52,113,0.0136555891238671,0.460176991150442
2009,51185,18,448,169,804,0,47,169,851,0.0268496608297839,0.198589894242068
2009,51187,181,1067,165,401,12,88,177,489,0.020193260654113,0.361963190184049
2009,51191,56,750,314,896,7,17,321,913,0.024089709762533,0.351588170865279
2009,51193,46,314,89,322,0,0,89,322,0.0261597205296937,0.27639751552795
2009,51195,11,650,38,497,0,21,38,518,0.0182651622002821,0.0733590733590734
2009,51197,9,364,79,328,0,0,79,328,0.0161592275100995,0.240853658536585
2009,51199,480,1230,826,1701,274,512,1100,2213,0.0561475617800781,0.497062810664257
2009,51510,3989,6744,5805,8070,818,1804,6623,9874,0.092867958955259,0.67075146850314
2009,51515,42,274,0,33,0,0,0,33,0.00809815950920245,0
2009,51520,156,851,114,988,0,0,114,988,0.0781151170145477,0.115384615384615
2009,51530,38,499,17,73,8,8,25,81,0.0188987400839944,0.308641975308642
2009,51540,830,2140,560,731,227,320,787,1051,0.0462242160355368,0.748810656517602
2009,51550,1635,6635,1336,3567,236,609,1572,4176,0.0298509596483077,0.376436781609195
2009,51570,147,604,43,205,15,60,58,265,0.0220300939396459,0.218867924528302
2009,51580,100,562,8,42,0,0,8,42,0.00951086956521739,0.19047619047619
2009,51590,314,1600,199,726,55,119,254,845,0.0269632087813906,0.300591715976331
2009,51595,8,207,13,71,0,0,13,71,0.0177633224918689,0.183098591549296
2009,51600,536,987,277,389,138,240,415,629,0.0392071308358786,0.659777424483307
2009,51610,328,510,203,254,90,136,293,390,0.0534979423868313,0.751282051282051
2009,51620,54,314,55,98,0,0,55,98,0.0172931004058585,0.561224489795918
2009,51630,273,1187,246,427,15,73,261,500,0.0376307669150297,0.522
2009,51640,24,518,48,111,0,15,48,126,0.0243008678881389,0.380952380952381
2009,51650,668,4717,929,2939,148,657,1077,3596,0.0385547335692077,0.299499443826474
2009,51660,400,2396,376,874,163,449,539,1323,0.0711787808683488,0.407407407407407
2009,51670,92,667,99,261,10,31,109,292,0.0197484106587312,0.373287671232877
2009,51678,166,212,51,94,34,34,85,128,0.0474601408972933,0.6640625
2009,51680,600,2405,528,1253,200,276,728,1529,0.0356377027782957,0.476128188358404
2009,51683,601,2815,97,442,20,107,117,549,0.0249409413047429,0.213114754098361
2009,51685,224,736,150,208,21,29,171,237,0.0331144334218248,0.721518987341772
2009,51690,100,1174,50,275,0,11,50,286,0.0278399688503845,0.174825174825175
2009,51700,1455,6445,1223,5126,440,1251,1663,6377,0.0537196000303263,0.260780931472479
2009,51710,1505,5888,2028,6120,309,744,2337,6864,0.0501732380158765,0.340472027972028
2009,51720,8,230,0,17,0,0,0,17,0.00681089743589744,0
2009,51730,79,581,55,316,9,32,64,348,0.0160464794577397,0.183908045977011
2009,51735,84,240,63,88,0,0,63,88,0.0111477071193311,0.715909090909091
2009,51740,739,4076,468,1901,97,182,565,2083,0.0328098665868603,0.271243398943831
2009,51750,73,463,134,276,0,125,134,401,0.06470873003066,0.334164588528678
2009,51760,2603,7612,2081,3569,159,781,2240,4350,0.0327409849391469,0.514942528735632
2009,51770,836,3370,551,1456,13,97,564,1553,0.0236694507102359,0.36316806181584
2009,51775,380,1427,87,385,30,48,117,433,0.0255774115423238,0.270207852193995
2009,51790,625,2128,57,273,9,22,66,295,0.0176161471396154,0.223728813559322
2009,51800,588,2276,445,1432,68,144,513,1576,0.0298281474752063,0.325507614213198
2009,51810,2339,9098,3902,10919,1136,2622,5038,13541,0.048808884435297,0.372055239642567
2009,51820,95,1039,70,248,0,103,70,351,0.0236141011840689,0.199430199430199
2009,51830,167,348,93,158,28,64,121,222,0.0437524635396137,0.545045045045045
2009,51840,323,1621,225,544,8,1352,233,1896,0.107788516202388,0.12289029535865
2009,53001,25,179,14,104,14,50,28,154,0.0164970540974826,0.181818181818182
2009,53003,121,260,82,608,56,70,138,678,0.045991045991046,0.20353982300885
2009,53005,683,3919,1071,3503,159,405,1230,3908,0.0382275261664873,0.314738996929376
2009,53007,449,1683,401,1017,0,195,401,1212,0.0262093722293104,0.330858085808581
2009,53009,354,1680,738,1661,21,63,759,1724,0.0334503967868992,0.440255220417633
2009,53011,976,3630,4032,12639,315,1272,4347,13911,0.0513654624405518,0.312486521457839
2009,53013,36,176,20,46,0,18,20,64,0.021599730003375,0.3125
2009,53015,358,2361,261,1907,70,284,331,2191,0.032890983877263,0.151072569602921
2009,53017,157,1185,38,223,19,83,57,306,0.013400481716663,0.186274509803922
2009,53019,19,156,9,42,2,6,11,48,0.00963468486551586,0.229166666666667
2009,53021,364,2332,216,1123,17,252,233,1375,0.0358960971152591,0.169454545454545
2009,53023,18,78,10,47,0,0,10,47,0.0311671087533156,0.212765957446809
2009,53025,158,1317,135,807,16,268,151,1075,0.0218691512734966,0.14046511627907
2009,53027,209,2178,197,735,32,103,229,838,0.0171812851109198,0.27326968973747
2009,53029,411,1719,572,2267,127,411,699,2678,0.0485461532883765,0.26101568334578
2009,53031,294,870,232,727,62,62,294,789,0.0347485246190434,0.372623574144487
2009,53033,7018,21681,24715,41715,9055,14479,33770,56194,0.0433533793401405,0.600953838488095
2009,53035,1005,4526,1645,4986,319,1000,1964,5986,0.0378542113284387,0.32809889742733
2009,53037,226,797,122,284,29,35,151,319,0.0151731354642314,0.473354231974922
2009,53039,129,372,93,524,5,18,98,542,0.0384451695275926,0.180811808118081
2009,53041,210,1703,169,873,16,48,185,921,0.0186068123964605,0.200868621064061
2009,53043,36,426,40,114,14,14,54,128,0.0177334441673594,0.421875
2009,53045,483,2727,357,761,36,58,393,819,0.0206588638886086,0.47985347985348
2009,53047,49,564,135,329,0,53,135,382,0.0143398776230339,0.353403141361257
2009,53049,19,602,124,482,6,61,130,543,0.0342846318979669,0.239410681399632
2009,53051,27,260,5,248,0,21,5,269,0.030231512699483,0.0185873605947955
2009,53053,3503,15515,4523,14061,1358,4861,5881,18922,0.038058191501772,0.31080224077793
2009,53055,147,306,70,242,44,100,114,342,0.0287057243578983,0.333333333333333
2009,53057,802,2952,325,1485,163,622,488,2107,0.0271692176761099,0.231608922638823
2009,53059,14,257,11,159,0,19,11,178,0.0237967914438503,0.0617977528089888
2009,53061,5747,18398,3207,9341,1018,2622,4225,11963,0.0268846564413731,0.353172281200368
2009,53063,1323,6494,3012,8749,361,1277,3373,10026,0.0334850726578651,0.336425294234989
2009,53065,191,833,116,567,3,48,119,615,0.0218783351120598,0.19349593495935
2009,53067,1423,5612,1873,4478,352,1456,2225,5934,0.0364756214501733,0.374957869902258
2009,53069,71,137,0,59,0,0,0,59,0.0200339558573854,0
2009,53071,295,2022,270,1342,90,178,360,1520,0.0406123921233334,0.236842105263158
2009,53073,749,2261,1077,2749,322,648,1399,3397,0.0286918476975573,0.411833971151016
2009,53075,351,764,248,644,283,335,531,979,0.0517907210495689,0.542390194075587
2009,53077,336,2516,675,2730,59,727,734,3457,0.0251683593607805,0.212322823257159
2009,54001,22,188,37,161,0,33,37,194,0.0179214780600462,0.190721649484536
2009,54003,118,977,645,2803,29,207,674,3010,0.0453524989076225,0.223920265780731
2009,54005,30,356,0,127,0,0,0,127,0.00725921691911975,0
2009,54007,25,377,6,190,0,27,6,217,0.0209864603481625,0.0276497695852535
2009,54009,38,205,36,184,0,31,36,215,0.0126292293233083,0.167441860465116
2009,54011,203,961,386,1766,62,90,448,1856,0.0304841994612706,0.241379310344828
2009,54013,0,126,24,125,0,0,24,125,0.024187306501548,0.192
2009,54015,0,243,19,75,0,0,19,75,0.0108727167294868,0.253333333333333
2009,54017,0,123,0,96,5,5,5,101,0.0203752269517854,0.0495049504950495
2009,54019,97,752,96,539,0,10,96,549,0.016927203773934,0.174863387978142
2009,54021,11,147,77,413,0,14,77,427,0.0922047074066076,0.180327868852459
2009,54023,4,244,25,104,0,0,25,104,0.0121197995571612,0.240384615384615
2009,54025,88,385,361,791,6,6,367,797,0.032056954388223,0.460476787954831
2009,54027,39,101,52,381,0,0,52,381,0.0243263950964117,0.136482939632546
2009,54029,19,367,215,776,0,32,215,808,0.0366041496783546,0.266089108910891
2009,54031,0,113,25,163,0,8,25,171,0.0185748424940256,0.146198830409357
2009,54033,206,852,221,871,0,40,221,911,0.0192096828609986,0.242590559824369
2009,54035,77,386,19,207,0,0,19,207,0.0105081476217067,0.0917874396135266
2009,54037,93,419,362,1261,64,157,426,1418,0.0413966252116541,0.300423131170663
2009,54039,735,2590,763,2405,42,224,805,2629,0.0192722154617561,0.306200076074553
2009,54041,13,339,24,211,0,0,24,211,0.0172583019793882,0.113744075829384
2009,54043,39,280,0,209,0,21,0,230,0.014865563598759,0
2009,54045,51,510,51,392,0,8,51,400,0.0158434665504812,0.1275
2009,54047,11,183,0,127,0,0,0,127,0.0078735275883447,0
2009,54049,174,461,83,531,16,92,99,623,0.016420231411929,0.158908507223114
2009,54051,28,588,55,358,0,9,55,367,0.0154610944938282,0.149863760217984
2009,54053,23,290,34,394,0,0,34,394,0.0217008151575237,0.0862944162436548
2009,54055,62,826,189,919,0,75,189,994,0.0227590154550658,0.190140845070423
2009,54057,0,200,103,594,0,0,103,594,0.0317749010377661,0.173400673400673
2009,54059,17,177,41,348,0,0,41,348,0.0190549197831682,0.117816091954023
2009,54061,282,641,720,1434,148,240,868,1674,0.0342962507682852,0.518518518518518
2009,54063,56,276,55,272,0,0,55,272,0.0275192229866451,0.202205882352941
2009,54065,18,131,40,239,0,5,40,244,0.0207500637809338,0.163934426229508
2009,54067,31,246,16,160,0,26,16,186,0.0100269541778976,0.0860215053763441
2009,54069,78,341,283,799,3,20,286,819,0.0265598650927487,0.349206349206349
2009,54071,1,23,74,140,1,70,75,210,0.0373266974760043,0.357142857142857
2009,54073,26,223,3,81,0,0,3,81,0.0157373227122596,0.037037037037037
2009,54075,32,145,0,140,69,80,69,220,0.0344611528822055,0.313636363636364
2009,54077,30,440,68,486,0,9,68,495,0.0231373282228662,0.137373737373737
2009,54079,253,1380,132,368,31,119,163,487,0.0127446875327122,0.334702258726899
2009,54081,199,1414,205,1801,12,55,217,1856,0.0331487765672442,0.116918103448276
2009,54083,57,737,7,254,0,0,7,254,0.0127273638322393,0.0275590551181102
2009,54085,3,112,24,114,0,0,24,114,0.0154744129224922,0.210526315789474
2009,54087,0,216,0,387,0,0,0,387,0.0360536612632756,0
2009,54089,28,168,34,458,0,0,34,458,0.0455087440381558,0.074235807860262
2009,54091,80,344,13,89,0,17,13,106,0.0091308467568266,0.122641509433962
2009,54093,19,58,29,78,0,0,29,78,0.0154455445544554,0.371794871794872
2009,54095,3,85,6,133,0,3,6,136,0.0212267832058686,0.0441176470588235
2009,54097,56,191,60,258,0,6,60,264,0.0167141500474834,0.227272727272727
2009,54099,123,503,33,561,0,0,33,561,0.0191552565984908,0.0588235294117647
2009,54101,20,80,19,21,0,0,19,21,0.00306882946076282,0.904761904761905
2009,54103,35,150,13,84,0,8,13,92,0.00797296126180778,0.141304347826087
2009,54105,8,154,0,51,0,0,0,51,0.0129179331306991,0
2009,54107,250,953,366,1883,26,47,392,1930,0.0316512783508536,0.203108808290155
2009,54109,6,140,0,188,0,0,0,188,0.0112071535022355,0
2009,55001,55,596,40,409,5,55,45,464,0.0295692072393576,0.0969827586206897
2009,55003,38,152,77,168,0,5,77,173,0.0160037002775208,0.445086705202312
2009,55005,157,746,86,516,9,13,95,529,0.0166887500788693,0.179584120982987
2009,55007,145,410,84,151,0,2,84,153,0.0141222078641314,0.549019607843137
2009,55009,1318,3594,1133,2361,148,461,1281,2822,0.0179035921381533,0.453933380581148
2009,55011,24,166,14,90,3,16,17,106,0.0111932418162619,0.160377358490566
2009,55013,46,156,84,252,3,15,87,267,0.0222834251377066,0.325842696629214
2009,55015,354,1286,62,105,18,42,80,147,0.00505310920903372,0.54421768707483
2009,55017,262,1759,112,428,36,62,148,490,0.0121299138528567,0.302040816326531
2009,55019,61,578,13,114,3,14,16,128,0.00607643009731783,0.125
2009,55021,434,1820,158,470,2,37,160,507,0.0133098813399139,0.315581854043393
2009,55023,40,426,33,166,0,2,33,168,0.0148043708142404,0.196428571428571
2009,55025,2330,5814,4290,6693,1006,1600,5296,8293,0.0279523936322607,0.638610876642952
2009,55027,433,4494,121,703,3,66,124,769,0.0126914444151043,0.161248374512354
2009,55029,139,408,116,260,0,3,116,263,0.0126692037188689,0.44106463878327
2009,55031,60,605,298,1067,13,35,311,1102,0.0361264096511933,0.282214156079855
2009,55033,191,926,79,343,13,35,92,378,0.0156288762093773,0.243386243386243
2009,55035,177,1350,423,983,6,104,429,1087,0.0190621492704826,0.394664213431463
2009,55037,9,48,44,105,0,0,44,105,0.0298889837745517,0.419047619047619
2009,55039,426,2075,160,576,59,144,219,720,0.0107868400551327,0.304166666666667
2009,55041,18,234,5,36,0,24,5,60,0.00888757221152422,0.0833333333333333
2009,55043,62,616,268,511,10,21,278,532,0.0179257362355954,0.522556390977444
2009,55045,74,542,80,255,0,15,80,270,0.0111418313869517,0.296296296296296
2009,55047,77,427,27,121,0,6,27,127,0.00969021822066229,0.21259842519685
2009,55049,140,484,55,194,0,7,55,201,0.0125947741086534,0.27363184079602
2009,55051,24,104,17,133,12,12,29,145,0.0299092409240924,0.2
2009,55053,31,874,45,185,6,11,51,196,0.0143737166324435,0.260204081632653
2009,55055,347,1548,183,566,14,105,197,671,0.0126838304789989,0.293591654247392
2009,55057,102,707,29,246,2,5,31,251,0.0135653677781981,0.123505976095618
2009,55059,334,1791,1020,3320,220,426,1240,3746,0.035723481561305,0.331019754404698
2009,55061,22,287,46,129,9,39,55,168,0.0120568393856753,0.327380952380952
2009,55063,303,1146,465,1147,32,71,497,1218,0.0180254843053973,0.408045977011494
2009,55065,35,246,17,117,0,20,17,137,0.0128965452320437,0.124087591240876
2009,55067,51,504,19,80,3,3,22,83,0.0057859881491809,0.265060240963855
2009,55069,73,568,38,143,0,62,38,205,0.00984535587359524,0.185365853658537
2009,55071,230,986,291,660,18,146,309,806,0.0144927536231884,0.383374689826303
2009,55073,718,1947,380,1034,15,94,395,1128,0.0130073800738007,0.350177304964539
2009,55075,112,847,128,503,40,67,168,570,0.0190501654356472,0.294736842105263
2009,55077,75,477,47,168,0,22,47,190,0.0174873446847676,0.247368421052632
2009,55078,15,97,0,22,0,0,0,22,0.00852052672347018,0
2009,55079,3469,9676,4392,9124,780,2752,5172,11876,0.0192489411947764,0.435500168406871
2009,55081,160,759,63,268,8,19,71,287,0.0102628285356696,0.247386759581882
2009,55083,48,697,17,99,6,40,23,139,0.00529685237405686,0.165467625899281
2009,55085,174,1183,142,464,1,26,143,490,0.0182938211685645,0.291836734693878
2009,55087,1035,3717,582,1317,172,252,754,1569,0.0138292715173417,0.480560866794136
2009,55089,761,1772,488,1067,40,93,528,1160,0.0202340874600987,0.455172413793103
2009,55091,21,145,3,18,0,4,3,22,0.0043956043956044,0.136363636363636
2009,55093,156,438,189,689,4,23,193,712,0.0305369703208097,0.271067415730337
2009,55095,63,459,134,561,0,23,134,584,0.0193108921367634,0.229452054794521
2009,55097,330,840,173,299,21,62,194,361,0.00881304623797666,0.537396121883656
2009,55099,48,224,13,120,3,15,16,135,0.0126239012530391,0.118518518518519
2009,55101,776,3870,373,1604,39,226,412,1830,0.0139050354464428,0.225136612021858
2009,55103,119,566,19,95,4,29,23,124,0.01,0.185483870967742
2009,55105,363,1712,339,1780,47,193,386,1973,0.0188381996295377,0.195641155600608
2009,55107,21,415,116,233,0,2,116,235,0.0232144621159735,0.493617021276596
2009,55109,405,1097,818,2214,0,39,818,2253,0.0424405681347248,0.363071460275189
2009,55111,236,994,108,570,14,42,122,612,0.0154319431136215,0.199346405228758
2009,55113,46,294,22,226,3,17,25,243,0.0200826446280992,0.102880658436214
2009,55115,109,1020,40,188,3,12,43,200,0.00707013574660633,0.215
2009,55117,407,1654,191,699,16,127,207,826,0.01076614269701,0.250605326876513
2009,55119,23,203,10,99,0,10,10,109,0.00833588253288467,0.0917431192660551
2009,55121,81,348,53,197,3,27,56,224,0.0118118540392322,0.25
2009,55123,137,472,114,267,5,12,119,279,0.0145722344092761,0.426523297491039
2009,55125,171,474,95,279,0,16,95,295,0.0178549812371384,0.322033898305085
2009,55127,540,1475,440,1443,43,189,483,1632,0.0260220677339116,0.295955882352941
2009,55129,23,242,39,146,5,5,44,151,0.0125749500333111,0.291390728476821
2009,55131,1166,3220,401,757,0,87,401,844,0.00968489661028619,0.475118483412322
2009,55133,3184,8727,2245,3534,326,521,2571,4055,0.0158083505516354,0.63403205918619
2009,55135,201,1107,32,263,0,86,32,349,0.00970037244983045,0.0916905444126074
2009,55137,111,847,11,151,0,16,11,167,0.00956471935853379,0.0658682634730539
2009,55139,1102,5453,378,1197,86,210,464,1407,0.012855185015989,0.329779673063255
2009,55141,269,1225,269,523,18,61,287,584,0.0114361806289899,0.491438356164384
2009,56001,109,206,278,726,30,86,308,812,0.0514216959027294,0.379310344827586
2009,56003,18,86,18,221,0,4,18,225,0.0298289805117327,0.08
2009,56005,13,249,233,1350,22,22,255,1372,0.0552891396332863,0.185860058309038
2009,56007,41,484,123,508,16,16,139,524,0.0489490892106492,0.265267175572519
2009,56009,72,487,89,344,0,0,89,344,0.0400745573159366,0.258720930232558
2009,56011,4,31,30,175,2,5,32,180,0.0424528301886792,0.177777777777778
2009,56013,106,343,308,938,0,32,308,970,0.0396436161517084,0.317525773195876
2009,56015,0,91,107,316,0,8,107,324,0.0392489400363416,0.330246913580247
2009,56017,31,155,30,103,0,6,30,109,0.0328115593016255,0.275229357798165
2009,56019,35,152,83,317,9,9,92,326,0.0583288602612274,0.282208588957055
2009,56021,142,717,515,2278,72,341,587,2619,0.0465657948544708,0.224131347842688
2009,56023,8,106,125,365,0,0,125,365,0.0352657004830918,0.342465753424658
2009,56025,144,863,470,1750,31,93,501,1843,0.0391153935946686,0.271839392295171
2009,56027,2,139,13,70,0,0,13,70,0.0417412045319022,0.185714285714286
2009,56029,104,367,256,805,0,66,256,871,0.0459194432728806,0.293915040183697
2009,56031,17,154,26,92,0,1,26,93,0.0154459392127554,0.279569892473118
2009,56033,96,552,234,569,18,51,252,620,0.0316100744366269,0.406451612903226
2009,56035,55,103,46,280,0,25,46,305,0.0581284543548694,0.150819672131148
2009,56037,71,355,289,1188,11,60,300,1248,0.0510847318870241,0.240384615384615
2009,56039,112,145,714,884,71,113,785,997,0.0691065363554447,0.787362086258776
2009,56041,7,79,85,582,0,30,85,612,0.0500163452108532,0.138888888888889
2009,56043,72,174,0,55,0,0,0,55,0.0106754658385093,0
2009,56045,16,134,69,191,0,7,69,198,0.0422986541337321,0.348484848484849
2009,72001,NA,NA,NA,NA,NA,NA,NA,NA,NA,NA
2009,72003,NA,NA,NA,NA,NA,NA,NA,NA,NA,NA
2009,72005,NA,NA,NA,NA,NA,NA,NA,NA,NA,NA
2009,72007,NA,NA,NA,NA,NA,NA,NA,NA,NA,NA
2009,72009,NA,NA,NA,NA,NA,NA,NA,NA,NA,NA
2009,72011,NA,NA,NA,NA,NA,NA,NA,NA,NA,NA
2009,72013,NA,NA,NA,NA,NA,NA,NA,NA,NA,NA
2009,72015,NA,NA,NA,NA,NA,NA,NA,NA,NA,NA
2009,72017,NA,NA,NA,NA,NA,NA,NA,NA,NA,NA
2009,72019,NA,NA,NA,NA,NA,NA,NA,NA,NA,NA
2009,72021,NA,NA,NA,NA,NA,NA,NA,NA,NA,NA
2009,72023,NA,NA,NA,NA,NA,NA,NA,NA,NA,NA
2009,72025,NA,NA,NA,NA,NA,NA,NA,NA,NA,NA
2009,72027,NA,NA,NA,NA,NA,NA,NA,NA,NA,NA
2009,72029,NA,NA,NA,NA,NA,NA,NA,NA,NA,NA
2009,72031,NA,NA,NA,NA,NA,NA,NA,NA,NA,NA
2009,72033,NA,NA,NA,NA,NA,NA,NA,NA,NA,NA
2009,72035,NA,NA,NA,NA,NA,NA,NA,NA,NA,NA
2009,72037,NA,NA,NA,NA,NA,NA,NA,NA,NA,NA
2009,72039,NA,NA,NA,NA,NA,NA,NA,NA,NA,NA
2009,72041,NA,NA,NA,NA,NA,NA,NA,NA,NA,NA
2009,72043,NA,NA,NA,NA,NA,NA,NA,NA,NA,NA
2009,72045,NA,NA,NA,NA,NA,NA,NA,NA,NA,NA
2009,72047,NA,NA,NA,NA,NA,NA,NA,NA,NA,NA
2009,72049,NA,NA,NA,NA,NA,NA,NA,NA,NA,NA
2009,72051,NA,NA,NA,NA,NA,NA,NA,NA,NA,NA
2009,72053,NA,NA,NA,NA,NA,NA,NA,NA,NA,NA
2009,72054,NA,NA,NA,NA,NA,NA,NA,NA,NA,NA
2009,72055,NA,NA,NA,NA,NA,NA,NA,NA,NA,NA
2009,72057,NA,NA,NA,NA,NA,NA,NA,NA,NA,NA
2009,72059,NA,NA,NA,NA,NA,NA,NA,NA,NA,NA
2009,72061,NA,NA,NA,NA,NA,NA,NA,NA,NA,NA
2009,72063,NA,NA,NA,NA,NA,NA,NA,NA,NA,NA
2009,72065,NA,NA,NA,NA,NA,NA,NA,NA,NA,NA
2009,72067,NA,NA,NA,NA,NA,NA,NA,NA,NA,NA
2009,72069,NA,NA,NA,NA,NA,NA,NA,NA,NA,NA
2009,72071,NA,NA,NA,NA,NA,NA,NA,NA,NA,NA
2009,72073,NA,NA,NA,NA,NA,NA,NA,NA,NA,NA
2009,72075,NA,NA,NA,NA,NA,NA,NA,NA,NA,NA
2009,72077,NA,NA,NA,NA,NA,NA,NA,NA,NA,NA
2009,72079,NA,NA,NA,NA,NA,NA,NA,NA,NA,NA
2009,72081,NA,NA,NA,NA,NA,NA,NA,NA,NA,NA
2009,72083,NA,NA,NA,NA,NA,NA,NA,NA,NA,NA
2009,72085,NA,NA,NA,NA,NA,NA,NA,NA,NA,NA
2009,72087,NA,NA,NA,NA,NA,NA,NA,NA,NA,NA
2009,72089,NA,NA,NA,NA,NA,NA,NA,NA,NA,NA
2009,72091,NA,NA,NA,NA,NA,NA,NA,NA,NA,NA
2009,72093,NA,NA,NA,NA,NA,NA,NA,NA,NA,NA
2009,72095,NA,NA,NA,NA,NA,NA,NA,NA,NA,NA
2009,72097,NA,NA,NA,NA,NA,NA,NA,NA,NA,NA
2009,72099,NA,NA,NA,NA,NA,NA,NA,NA,NA,NA
2009,72101,NA,NA,NA,NA,NA,NA,NA,NA,NA,NA
2009,72103,NA,NA,NA,NA,NA,NA,NA,NA,NA,NA
2009,72105,NA,NA,NA,NA,NA,NA,NA,NA,NA,NA
2009,72107,NA,NA,NA,NA,NA,NA,NA,NA,NA,NA
2009,72109,NA,NA,NA,NA,NA,NA,NA,NA,NA,NA
2009,72111,NA,NA,NA,NA,NA,NA,NA,NA,NA,NA
2009,72113,NA,NA,NA,NA,NA,NA,NA,NA,NA,NA
2009,72115,NA,NA,NA,NA,NA,NA,NA,NA,NA,NA
2009,72117,NA,NA,NA,NA,NA,NA,NA,NA,NA,NA
2009,72119,NA,NA,NA,NA,NA,NA,NA,NA,NA,NA
2009,72121,NA,NA,NA,NA,NA,NA,NA,NA,NA,NA
2009,72123,NA,NA,NA,NA,NA,NA,NA,NA,NA,NA
2009,72125,NA,NA,NA,NA,NA,NA,NA,NA,NA,NA
2009,72127,NA,NA,NA,NA,NA,NA,NA,NA,NA,NA
2009,72129,NA,NA,NA,NA,NA,NA,NA,NA,NA,NA
2009,72131,NA,NA,NA,NA,NA,NA,NA,NA,NA,NA
2009,72133,NA,NA,NA,NA,NA,NA,NA,NA,NA,NA
2009,72135,NA,NA,NA,NA,NA,NA,NA,NA,NA,NA
2009,72137,NA,NA,NA,NA,NA,NA,NA,NA,NA,NA
2009,72139,NA,NA,NA,NA,NA,NA,NA,NA,NA,NA
2009,72141,NA,NA,NA,NA,NA,NA,NA,NA,NA,NA
2009,72143,NA,NA,NA,NA,NA,NA,NA,NA,NA,NA
2009,72145,NA,NA,NA,NA,NA,NA,NA,NA,NA,NA
2009,72147,NA,NA,NA,NA,NA,NA,NA,NA,NA,NA
2009,72149,NA,NA,NA,NA,NA,NA,NA,NA,NA,NA
2009,72151,NA,NA,NA,NA,NA,NA,NA,NA,NA,NA
2009,72153,NA,NA,NA,NA,NA,NA,NA,NA,NA,NA
2010,01001,150,1122,464,909,36,53,500,962,0.0283909809939795,0.51975051975052
2010,01003,704,2826,1541,5586,164,267,1705,5853,0.0481490621915104,0.291303604988895
2010,01005,35,1390,25,365,0,5,25,370,0.0195984956830341,0.0675675675675676
2010,01007,8,486,0,73,0,6,0,79,0.00523803209123458,0
2010,01009,111,1352,95,352,0,190,95,542,0.0142313246685047,0.175276752767528
2010,01011,0,116,0,73,0,0,0,73,0.00999863032461307,0
2010,01013,8,75,57,165,0,34,57,199,0.0141747987748415,0.28643216080402
2010,01015,125,1757,293,1629,51,166,344,1795,0.0230951339389105,0.191643454038997
2010,01017,58,369,80,675,16,21,96,696,0.0293213127185407,0.137931034482759
2010,01019,202,641,60,482,0,18,60,500,0.0269483669289641,0.12
2010,01021,47,714,61,302,0,30,61,332,0.0116270925264411,0.183734939759036
2010,01023,9,98,37,128,0,0,37,128,0.0130705606045134,0.2890625
2010,01025,31,365,131,244,36,62,167,306,0.0181721004810262,0.545751633986928
2010,01027,42,265,0,142,0,0,0,142,0.0144485144485144,0
2010,01029,16,298,46,359,0,0,46,359,0.0354392892398815,0.128133704735376
2010,01031,238,1226,470,1296,123,349,593,1645,0.0507308949608339,0.36048632218845
2010,01033,142,1001,127,818,13,46,140,864,0.0227452219238667,0.162037037037037
2010,01035,0,71,0,0,0,0,0,0,0,NA
2010,01037,0,509,0,48,0,0,0,48,0.00587587219977965,0
2010,01039,46,355,125,635,0,6,125,641,0.0246311097448509,0.195007800312012
2010,01041,6,307,2,118,0,0,2,118,0.0123586091328027,0.0169491525423729
2010,01043,144,1334,77,929,0,92,77,1021,0.0188237463126844,0.0754162585700294
2010,01045,209,1628,547,1846,81,343,628,2189,0.067268983743585,0.286888990406578
2010,01047,157,537,60,443,0,11,60,454,0.0161882688536281,0.13215859030837
2010,01049,102,620,135,849,0,243,135,1092,0.0235781837025521,0.123626373626374
2010,01051,543,4253,188,1027,0,97,188,1124,0.0217164496309749,0.167259786476868
2010,01053,53,799,85,536,52,313,137,849,0.0327710657351295,0.161366313309776
2010,01055,386,2136,362,1382,9,50,371,1432,0.0201644699785964,0.259078212290503
2010,01057,23,407,45,275,0,4,45,279,0.023092203277603,0.161290322580645
2010,01059,21,547,23,186,0,40,23,226,0.0108258287028166,0.101769911504425
2010,01061,85,554,25,457,3,12,28,469,0.0256648790631498,0.0597014925373134
2010,01063,26,205,0,40,0,9,0,49,0.00804862023653088,0
2010,01065,23,403,23,220,0,1,23,221,0.0209438968915845,0.104072398190045
2010,01067,41,231,39,128,0,29,39,157,0.0131172194836661,0.248407643312102
2010,01069,266,1279,388,1877,69,165,457,2042,0.030864104230589,0.223800195886386
2010,01071,83,483,78,541,0,14,78,555,0.0150012163148363,0.140540540540541
2010,01073,2764,8662,3706,8360,256,894,3962,9254,0.0211961364120489,0.428139183055976
2010,01075,17,181,42,229,0,17,42,246,0.0239229796751921,0.170731707317073
2010,01077,291,2103,340,1485,11,54,351,1539,0.0248321931070092,0.228070175438596
2010,01079,83,306,45,174,0,36,45,210,0.00906383529716431,0.214285714285714
2010,01081,615,2588,1267,3123,363,596,1630,3719,0.0492139529959771,0.438289862866362
2010,01083,515,2735,180,996,38,175,218,1171,0.0219210393305753,0.186165670367208
2010,01085,62,261,38,48,0,0,38,48,0.00629425649095201,0.791666666666667
2010,01087,69,376,168,454,11,34,179,488,0.0370117557830868,0.366803278688525
2010,01089,1148,3567,2714,7093,702,1315,3416,8408,0.0396284129310792,0.40627973358706
2010,01091,103,515,37,132,0,0,37,132,0.00943868430461208,0.28030303030303
2010,01093,63,661,11,239,0,0,11,239,0.0109417204596438,0.0460251046025105
2010,01095,130,1549,238,1114,0,467,238,1581,0.0262310857446244,0.150537634408602
2010,01097,552,2344,1483,5146,203,975,1686,6121,0.0232035360657478,0.275445188694658
2010,01099,34,229,74,134,6,15,80,149,0.0096816114359974,0.536912751677852
2010,01101,859,3732,1810,4170,450,771,2260,4941,0.0339917033001053,0.457397287998381
2010,01103,294,2386,343,994,11,73,354,1067,0.0134557423357756,0.331771321462043
2010,01105,35,260,26,74,0,7,26,81,0.0122116689280868,0.320987654320988
2010,01107,10,168,101,182,0,9,101,191,0.0143060444910494,0.528795811518325
2010,01109,25,475,198,445,77,84,275,529,0.0283706961278558,0.519848771266541
2010,01111,14,279,89,636,12,26,101,662,0.0432143090280044,0.152567975830816
2010,01113,29,416,177,1936,51,159,228,2095,0.062645774774236,0.108830548926014
2010,01115,367,2668,97,803,0,85,97,888,0.0162153278673557,0.109234234234234
2010,01117,2303,5957,1236,2903,186,396,1422,3299,0.0264023497210907,0.431039709002728
2010,01119,0,26,0,38,0,28,0,66,0.00764419735927728,0
2010,01121,179,2185,99,1312,51,141,150,1453,0.026123696512046,0.103234686854783
2010,01123,152,1062,7,472,14,28,21,500,0.0174009883761398,0.042
2010,01125,781,3111,937,2353,260,372,1197,2725,0.0246118552371318,0.439266055045872
2010,01127,87,1129,67,508,22,37,89,545,0.0116090827759554,0.163302752293578
2010,01129,0,255,36,184,0,0,36,184,0.0159445407279029,0.195652173913043
2010,01131,19,534,0,48,0,11,0,59,0.007686294945284,0
2010,01133,79,667,53,254,0,0,53,254,0.0146372385178355,0.208661417322835
2010,02013,0,29,36,733,13,67,49,800,0.265164070268479,0.06125
2010,02016,8,103,134,1091,15,25,149,1116,0.220640569395018,0.133512544802867
2010,02020,860,3239,3009,8265,777,1935,3786,10200,0.0575747483927049,0.371176470588235
2010,02050,45,246,123,194,0,17,123,211,0.0244864802135314,0.582938388625592
2010,02060,12,30,5,19,0,0,5,19,0.029874213836478,0.263157894736842
2010,02068,2,11,33,76,0,7,33,83,0.0984578884934757,0.397590361445783
2010,02070,47,99,30,57,9,9,39,66,0.0249244712990937,0.590909090909091
2010,02090,266,1324,584,2637,232,562,816,3199,0.0564755313890262,0.255079712410128
2010,02100,28,57,10,13,0,5,10,18,0.015025041736227,0.555555555555556
2010,02105,0,82,1,21,9,9,10,30,0.0187149095446039,0.333333333333333
2010,02110,180,487,366,851,62,176,428,1027,0.0498277618747271,0.416747809152872
2010,02122,188,970,271,1193,14,83,285,1276,0.03516604657572,0.223354231974922
2010,02130,0,246,68,334,0,7,68,341,0.0383059986519883,0.19941348973607
2010,02150,40,447,73,630,0,5,73,635,0.0793155133649763,0.11496062992126
2010,02164,6,22,15,29,0,3,15,32,0.0428954423592493,0.46875
2010,02170,437,1938,405,1621,28,89,433,1710,0.0327849994248246,0.253216374269006
2010,02180,2,156,27,208,0,18,27,226,0.0450648055832502,0.119469026548673
2010,02185,42,237,86,123,21,21,107,144,0.0311284046692607,0.743055555555556
2010,02188,39,180,30,84,6,6,36,90,0.0235171152338646,0.4
2010,02195,18,109,22,74,21,21,43,95,0.0350942002216476,0.452631578947368
2010,02198,34,144,20,76,0,4,20,80,0.02173322466721,0.25
2010,02220,11,136,125,249,31,53,156,302,0.0509189006912831,0.516556291390728
2010,02230,0,9,51,62,0,24,51,86,0.119113573407202,0.593023255813954
2010,02240,36,166,130,349,0,0,130,349,0.0809932699002089,0.372492836676218
2010,02261,51,291,96,297,12,74,108,371,0.0583425066834408,0.291105121293801
2010,02270,12,82,69,87,4,4,73,91,0.0279484029484029,0.802197802197802
2010,02275,12,21,8,14,0,0,8,14,0.0091324200913242,0.571428571428571
2010,02282,4,4,0,0,0,0,0,0,0,NA
2010,02290,15,182,42,76,0,0,42,76,0.0217765042979943,0.552631578947368
2010,04001,111,926,138,805,77,154,215,959,0.0238622508646645,0.224191866527633
2010,04003,515,2576,1616,5166,245,716,1861,5882,0.0675114202419484,0.316388983339
2010,04005,628,2340,1133,2823,96,366,1229,3189,0.0416084965358872,0.385387268736281
2010,04007,416,1614,167,708,0,52,167,760,0.0201292509799767,0.219736842105263
2010,04009,89,1294,52,501,10,118,62,619,0.0287799888413614,0.10016155088853
2010,04011,36,344,72,225,16,16,88,241,0.04603629417383,0.365145228215768
2010,04012,1,419,48,655,3,94,51,749,0.0472614840989399,0.0680907877169559
2010,04013,5218,19757,31646,87139,6121,17456,37767,104595,0.0440207420837789,0.361078445432382
2010,04015,215,2271,1256,8845,33,402,1289,9247,0.0646101173840134,0.139396561046826
2010,04017,260,2653,258,1305,42,110,300,1415,0.0221460544026043,0.212014134275618
2010,04019,1866,7872,8862,22323,1708,4684,10570,27007,0.0425022622654129,0.391380012589329
2010,04021,2914,17834,2141,11765,187,1916,2328,13681,0.0628482701910576,0.170162999780718
2010,04023,83,566,48,249,78,261,126,510,0.0182762945708654,0.247058823529412
2010,04025,898,4703,1996,6556,148,390,2144,6946,0.0453604477270798,0.308666858623668
2010,04027,190,1910,838,4767,199,1270,1037,6037,0.0519812636690833,0.171774059963558
2010,05001,53,263,58,222,10,130,68,352,0.026662626874716,0.193181818181818
2010,05003,22,262,11,65,0,7,11,72,0.00484228932678728,0.152777777777778
2010,05005,105,568,214,1616,50,78,264,1694,0.0539989161964872,0.155844155844156
2010,05007,1075,3274,2357,6488,300,586,2657,7074,0.0529391955098223,0.375600791631326
2010,05009,84,513,134,962,8,16,142,978,0.0389858885434107,0.14519427402863
2010,05011,95,182,10,87,0,24,10,111,0.0135151588944357,0.0900900900900901
2010,05013,11,143,0,13,0,0,0,13,0.00341655716162943,0
2010,05015,64,505,141,647,18,25,159,672,0.0354243542435424,0.236607142857143
2010,05017,8,281,0,71,0,8,0,79,0.00967307456838496,0
2010,05019,49,322,62,585,21,21,83,606,0.0451295799821269,0.136963696369637
2010,05021,1,220,11,236,0,0,11,236,0.0206836108676599,0.0466101694915254
2010,05023,111,873,85,592,11,22,96,614,0.0327135169694709,0.156351791530945
2010,05025,18,138,0,43,0,2,0,45,0.00767132628707808,0
2010,05027,115,267,25,237,0,15,25,252,0.0161352285824049,0.0992063492063492
2010,05029,135,569,36,261,0,6,36,267,0.0189281156954487,0.134831460674157
2010,05031,195,1852,509,1149,51,148,560,1297,0.0221747307232005,0.431765612952968
2010,05033,64,1398,98,1361,0,4,98,1365,0.0346508262889346,0.0717948717948718
2010,05035,138,725,72,1012,6,40,78,1052,0.0341724866006172,0.0741444866920152
2010,05037,24,190,10,205,0,17,10,222,0.0186304128902316,0.045045045045045
2010,05039,3,13,0,56,0,0,0,56,0.0100701312713541,0
2010,05041,0,190,0,128,13,79,13,207,0.0239306358381503,0.0628019323671498
2010,05043,75,539,0,153,0,46,0,199,0.0167550728298392,0
2010,05045,429,2354,456,1781,101,226,557,2007,0.0312407577479258,0.277528649725959
2010,05047,54,455,0,97,3,3,3,100,0.00817060217338018,0.03
2010,05049,65,313,0,190,0,0,0,190,0.0215615070358602,0
2010,05051,370,1419,428,2032,95,186,523,2218,0.0326018255846427,0.235798016230839
2010,05053,93,542,13,131,12,65,25,196,0.016537293283834,0.127551020408163
2010,05055,130,924,60,382,54,109,114,491,0.017980737539825,0.232179226069246
2010,05057,69,437,38,229,0,30,38,259,0.0176394469795001,0.146718146718147
2010,05059,134,1008,88,238,4,4,92,242,0.0108311327932686,0.380165289256198
2010,05061,56,185,10,94,0,22,10,116,0.0129478736466123,0.0862068965517241
2010,05063,82,815,52,350,24,65,76,415,0.0171657842488418,0.183132530120482
2010,05065,11,461,54,433,0,0,54,433,0.042807711319822,0.124711316397229
2010,05067,52,1642,35,308,0,0,35,308,0.0242347942403021,0.113636363636364
2010,05069,47,2096,175,972,36,106,211,1078,0.021266941545503,0.195732838589981
2010,05071,34,362,53,230,0,0,53,230,0.0141390545275712,0.230434782608696
2010,05073,4,131,0,96,0,0,0,96,0.0183451175234091,0
2010,05075,5,253,4,182,0,8,4,190,0.0162768782660841,0.0210526315789474
2010,05077,8,622,7,78,28,28,35,106,0.0145444566410538,0.330188679245283
2010,05079,17,960,0,100,0,0,0,100,0.0105965878986966,0
2010,05081,83,169,42,358,0,0,42,358,0.0400581850732908,0.11731843575419
2010,05083,48,440,62,339,0,28,62,367,0.0241701791359326,0.168937329700272
2010,05085,379,2024,340,1190,21,130,361,1320,0.0312477806973937,0.273484848484848
2010,05087,76,327,48,252,0,8,48,260,0.0249257022337264,0.184615384615385
2010,05089,28,332,0,370,0,5,0,375,0.0298163313985847,0
2010,05091,70,762,119,1372,0,58,119,1430,0.0504854368932039,0.0832167832167832
2010,05093,29,670,53,821,87,103,140,924,0.0316081141176068,0.151515151515152
2010,05095,21,153,0,93,0,0,0,93,0.0160400137978613,0
2010,05097,1,294,50,239,0,0,50,239,0.0353654927493341,0.209205020920502
2010,05099,5,205,6,111,0,0,6,111,0.0178370560822754,0.0540540540540541
2010,05101,8,129,29,132,0,5,29,137,0.022955764075067,0.211678832116788
2010,05103,19,435,134,252,15,18,149,270,0.0150720107178743,0.551851851851852
2010,05105,39,399,4,40,0,0,4,40,0.0055005500550055,0.1
2010,05107,0,226,58,296,0,9,58,305,0.0219629869662274,0.19016393442623
2010,05109,33,320,3,68,0,3,3,71,0.00964149918522542,0.0422535211267606
2010,05111,71,692,1,303,0,33,1,336,0.0202275600505689,0.00297619047619048
2010,05113,73,334,34,295,8,8,42,303,0.0214088885748605,0.138613861386139
2010,05115,273,1314,119,753,18,66,137,819,0.0217195290124112,0.167277167277167
2010,05117,11,147,11,56,0,0,11,56,0.00898299647096567,0.196428571428571
2010,05119,1712,6455,3029,6780,681,1161,3710,7941,0.031716172012605,0.467195567308903
2010,05121,55,288,33,202,0,19,33,221,0.0178225806451613,0.149321266968326
2010,05123,46,473,82,881,0,56,82,937,0.0495478821849717,0.0875133404482391
2010,05125,648,3429,731,1564,11,76,742,1640,0.023477874966,0.452439024390244
2010,05127,7,115,17,185,0,26,17,211,0.028848783155592,0.0805687203791469
2010,05129,0,141,0,31,0,0,0,31,0.00518221330658643,0
2010,05131,293,1461,473,2623,75,164,548,2787,0.0346060718942075,0.196627197703624
2010,05133,0,144,23,291,43,158,66,449,0.0432063125481139,0.146993318485523
2010,05135,35,582,25,215,0,0,25,215,0.0169893322797313,0.116279069767442
2010,05137,18,239,0,276,0,0,0,276,0.0307898259705489,0
2010,05139,96,455,132,682,0,7,132,689,0.0241661113254533,0.191582002902758
2010,05141,24,474,56,246,16,38,72,284,0.0229050729897572,0.253521126760563
2010,05143,1178,3972,1352,4305,151,570,1503,4875,0.0411593860286047,0.308307692307692
2010,05145,124,1548,246,1099,0,74,246,1173,0.0247285759460314,0.209718670076726
2010,05147,3,95,0,61,0,9,0,70,0.0135606354126308,0
2010,05149,122,586,0,155,0,6,0,161,0.0113220815752461,0
2010,06001,15864,34361,7496,12782,5241,9883,12737,22665,0.0227798102436279,0.561967791749393
2010,06003,0,19,2,2,0,0,2,2,0.00266666666666667,1
2010,06005,336,1892,72,235,0,22,72,257,0.00880227420625407,0.280155642023346
2010,06007,1019,4402,596,1671,185,452,781,2123,0.0153027758355979,0.367875647668394
2010,06009,363,1361,61,137,21,35,82,172,0.00507809040181866,0.476744186046512
2010,06011,55,439,15,166,72,179,87,345,0.0265916448281178,0.252173913043478
2010,06013,11901,24642,3578,5763,2365,4935,5943,10698,0.0157055149876241,0.555524397083567
2010,06015,97,1765,136,351,0,0,136,351,0.0181151940545004,0.387464387464387
2010,06017,1550,4584,631,1566,86,331,717,1897,0.0153154316901067,0.377965208223511
2010,06019,2417,11574,1258,4447,666,2851,1924,7298,0.013786511207916,0.263633872293779
2010,06021,76,701,21,161,0,19,21,180,0.0103615012664057,0.116666666666667
2010,06023,514,2545,479,1531,4,107,483,1638,0.0184715315132447,0.294871794871795
2010,06025,290,3766,425,980,126,993,551,1973,0.0198443031863534,0.279270146984288
2010,06027,107,678,80,235,0,5,80,240,0.0182080267051058,0.333333333333333
2010,06029,2693,25017,1654,7143,318,2132,1972,9275,0.0194784193813948,0.212614555256065
2010,06031,507,6381,316,1713,46,636,362,2349,0.0257498026835043,0.154108131119625
2010,06033,323,1686,151,658,0,136,151,794,0.0174589911605612,0.190176322418136
2010,06035,209,4125,82,698,8,106,90,804,0.0323827936201063,0.111940298507463
2010,06037,24325,65654,31006,57626,18115,43641,49121,101267,0.0161558782927132,0.485064236128255
2010,06039,589,6225,88,656,53,449,141,1105,0.0122500110859829,0.127601809954751
2010,06041,3763,9576,1165,2119,376,827,1541,2946,0.0161268249423846,0.523082145281738
2010,06043,80,632,71,319,0,27,71,346,0.0253016453382084,0.205202312138728
2010,06045,495,1477,145,730,102,240,247,970,0.0160646561004289,0.254639175257732
2010,06047,645,5387,276,1119,54,335,330,1454,0.010320840431573,0.226960110041265
2010,06049,17,381,38,151,0,0,38,151,0.0220309308433032,0.251655629139073
2010,06051,281,747,0,139,37,86,37,225,0.0242013552758954,0.164444444444444
2010,06053,1983,8488,2097,4291,1083,2331,3180,6622,0.026254752776335,0.480217456961643
2010,06055,949,3305,487,874,195,606,682,1480,0.0163006366059431,0.460810810810811
2010,06057,957,2844,242,652,142,319,384,971,0.0134891086908202,0.395468589083419
2010,06059,18420,44153,11688,21063,7208,15201,18896,36264,0.0187896957192613,0.521067725568056
2010,06061,3378,11517,1407,2911,392,757,1799,3668,0.0161686333802053,0.490458015267176
2010,06063,91,644,50,227,0,0,50,227,0.0148560209424084,0.220264317180617
2010,06065,14168,62578,5622,16589,2107,7341,7729,23930,0.0186310644387246,0.322983702465524
2010,06067,8543,30945,4216,10502,1627,4621,5843,15123,0.0169342539320659,0.386365139191959
2010,06069,181,1418,18,125,26,592,44,717,0.0215263600336256,0.0613668061366806
2010,06071,8728,47795,2993,12780,1580,6523,4573,19303,0.0163389094245619,0.236906180386468
2010,06073,11418,31138,18321,40735,7563,19087,25884,59822,0.0307327159938865,0.432683628096687
2010,06075,11867,19020,8935,11330,4174,7681,13109,19011,0.031239165049469,0.689548156330545
2010,06077,2789,15767,789,3080,398,2269,1187,5349,0.0132616985089577,0.221910637502337
2010,06079,1996,8410,904,1948,206,597,1110,2545,0.0146203869663128,0.43614931237721
2010,06081,10809,20372,2991,4459,2509,4520,5500,8979,0.018236137570221,0.612540371979062
2010,06083,2199,6371,1961,4178,719,2059,2680,6237,0.0243897670126153,0.429693763027096
2010,06085,13717,26360,9142,13787,10639,16832,19781,30619,0.0263536601110298,0.646036774551749
2010,06087,1834,6163,1391,2263,304,790,1695,3053,0.0184674385124427,0.55519161480511
2010,06089,905,3267,294,1046,41,350,335,1396,0.011624421277021,0.239971346704871
2010,06091,74,74,0,21,0,0,0,21,0.00807071483474251,0
2010,06093,185,943,285,772,16,36,301,808,0.025159582749494,0.372524752475248
2010,06095,2677,11280,1081,2849,473,1753,1554,4602,0.0172784068723155,0.33767926988266
2010,06097,2998,8120,1472,3341,413,1178,1885,4519,0.0140098834938213,0.417127683115734
2010,06099,1484,9530,650,2291,280,1658,930,3949,0.0128184320548443,0.235502658900988
2010,06101,352,2806,76,534,88,739,164,1273,0.0217979452054795,0.128829536527887
2010,06103,184,2017,76,308,0,52,76,360,0.00874274473613911,0.211111111111111
2010,06105,137,452,11,72,0,54,11,126,0.0123191239734063,0.0873015873015873
2010,06107,816,5298,280,1301,137,1070,417,2371,0.00976471605721275,0.175875158161113
2010,06109,366,4155,127,469,18,47,145,516,0.012396694214876,0.281007751937984
2010,06111,6004,14899,2526,6583,987,3089,3513,9672,0.0187173795668606,0.363213399503722
2010,06113,2320,6168,911,1779,603,1124,1514,2903,0.0257570514697401,0.521529452290734
2010,06115,373,3338,94,610,75,319,169,929,0.0217488001872878,0.181916038751346
2010,08001,3193,15473,1589,5958,333,1545,1922,7503,0.0284830309012224,0.256164200986272
2010,08003,18,295,16,317,12,36,28,353,0.0389023583865991,0.0793201133144476
2010,08005,6262,18631,3666,9801,539,2163,4205,11964,0.0330880217710555,0.351471079906386
2010,08007,44,59,95,311,0,0,95,311,0.0440447528678657,0.305466237942122
2010,08009,4,18,2,48,0,0,2,48,0.017435524881947,0.0416666666666667
2010,08011,97,828,0,64,0,10,0,74,0.016738294503506,0
2010,08013,2707,5715,4668,7266,1059,1574,5727,8840,0.0477928256697213,0.647850678733032
2010,08014,1144,2666,638,1183,67,75,705,1258,0.0363520776743917,0.560413354531002
2010,08015,187,924,220,442,0,19,220,461,0.0347295464818442,0.477223427331887
2010,08017,0,28,0,9,0,0,0,9,0.00599600266489007,0
2010,08019,164,339,87,157,0,0,87,157,0.0227174070322674,0.554140127388535
2010,08021,44,124,17,170,0,0,17,170,0.0325920245398773,0.1
2010,08023,0,68,16,21,0,0,16,21,0.00840672538030424,0.761904761904762
2010,08025,60,974,0,50,7,171,7,221,0.0523076923076923,0.0316742081447964
2010,08027,12,98,40,54,12,12,52,66,0.0221774193548387,0.787878787878788
2010,08029,141,1005,161,465,0,79,161,544,0.0250575771533855,0.295955882352941
2010,08031,7619,21648,7437,12977,1355,2694,8792,15671,0.0398431799286581,0.561036309105992
2010,08033,0,24,0,58,0,0,0,58,0.0399449035812672,0
2010,08035,3928,8445,4472,7975,362,500,4834,8475,0.0485106236834875,0.570383480825959
2010,08037,478,1004,353,720,23,211,376,931,0.0273928266690205,0.403866809881847
2010,08039,181,807,43,312,7,17,50,329,0.0211385248008224,0.151975683890578
2010,08041,1532,5118,7544,20738,1420,4462,8964,25200,0.066864252301112,0.355714285714286
2010,08043,319,2026,255,1756,37,508,292,2264,0.0641577873498073,0.128975265017668
2010,08045,241,1172,267,967,19,126,286,1093,0.0309237515914557,0.261665141811528
2010,08047,12,151,77,171,0,0,77,171,0.0423896876549331,0.450292397660819
2010,08049,18,99,70,322,8,41,78,363,0.0366111951588502,0.214876033057851
2010,08051,130,234,130,290,23,110,153,400,0.0423414840690166,0.3825
2010,08053,0,17,30,30,0,0,30,30,0.069284064665127,1
2010,08055,12,340,39,193,0,99,39,292,0.0544979469951474,0.133561643835616
2010,08057,4,6,0,42,0,0,0,42,0.0394736842105263,0
2010,08059,5236,16873,3579,8885,655,1329,4234,10214,0.0281710340871167,0.41452907773644
2010,08061,17,35,0,23,0,0,0,23,0.0198789974070873,0
2010,08063,49,253,1,188,0,57,1,245,0.0432403812213202,0.00408163265306122
2010,08065,83,286,15,87,0,0,15,87,0.0183505589538072,0.172413793103448
2010,08067,151,593,731,1719,7,38,738,1757,0.0526410402372892,0.420034149117814
2010,08069,1895,5223,3665,7716,348,624,4013,8340,0.0449721754885467,0.481175059952038
2010,08071,49,259,88,381,0,3,88,384,0.0349917987971569,0.229166666666667
2010,08073,33,429,0,38,0,58,0,96,0.0247358928111312,0
2010,08075,138,850,89,529,22,59,111,588,0.039247096515819,0.188775510204082
2010,08077,1153,2856,644,3022,72,185,716,3207,0.0339121055748245,0.223261615216713
2010,08079,3,28,48,54,0,0,48,54,0.0608108108108108,0.888888888888889
2010,08081,22,443,29,104,0,0,29,104,0.0118694362017804,0.278846153846154
2010,08083,126,359,195,546,0,0,195,546,0.0314262691377921,0.357142857142857
2010,08085,174,813,297,1122,0,144,297,1266,0.0459694989106754,0.234597156398104
2010,08087,113,781,46,236,1,31,47,267,0.0149764415526139,0.176029962546816
2010,08089,95,627,45,241,0,4,45,245,0.0196282647011697,0.183673469387755
2010,08091,77,142,70,163,0,0,70,163,0.0508421709295072,0.429447852760736
2010,08093,136,991,157,610,22,22,179,632,0.0507752872178035,0.283227848101266
2010,08095,5,54,0,9,0,2,0,11,0.00376454483230664,0
2010,08097,57,288,373,511,6,61,379,572,0.0456832521364108,0.662587412587413
2010,08099,156,491,0,142,0,19,0,161,0.0202032877399925,0
2010,08101,371,2843,386,1610,38,245,424,1855,0.0180559881638374,0.228571428571429
2010,08103,36,80,16,103,17,39,33,142,0.0331388564760793,0.232394366197183
2010,08105,8,272,49,209,0,5,49,214,0.0282359150283679,0.228971962616822
2010,08107,311,511,132,437,21,109,153,546,0.033991159808255,0.28021978021978
2010,08109,30,212,31,96,16,53,47,149,0.0353080568720379,0.315436241610738
2010,08111,0,7,0,13,0,0,0,13,0.0210696920583468,0
2010,08113,36,77,236,415,22,73,258,488,0.0907063197026022,0.528688524590164
2010,08115,2,70,5,36,0,0,5,36,0.0199335548172757,0.138888888888889
2010,08117,425,701,685,1034,0,58,685,1092,0.0557598039215686,0.627289377289377
2010,08119,147,649,127,513,23,108,150,621,0.0372614904596184,0.241545893719807
2010,08121,8,171,4,88,0,50,4,138,0.0411817367949866,0.0289855072463768
2010,08123,1903,5971,1030,3659,39,325,1069,3984,0.0269143725722006,0.268323293172691
2010,08125,23,229,21,98,0,78,21,176,0.0269113149847095,0.119318181818182
2010,09001,1799,4019,8859,13831,2275,4634,11134,18465,0.0304027187094034,0.602978608177633
2010,09003,3016,9295,5048,9446,970,3038,6018,12484,0.0206833936405689,0.482057033002243
2010,09005,879,2686,592,1304,57,225,649,1529,0.0113429824105878,0.424460431654676
2010,09007,1027,3302,1226,2177,261,521,1487,2698,0.023209600412921,0.55114899925871
2010,09009,2942,9185,4258,8336,1444,2972,5702,11308,0.0195738007412011,0.504244782454899
2010,09011,928,4248,1802,4936,301,965,2103,5901,0.0318690458188417,0.356380274529741
2010,09013,784,3571,833,1641,278,332,1111,1973,0.0207280558911593,0.563101875316776
2010,09015,437,2567,217,1215,97,179,314,1394,0.0178128753609855,0.225251076040172
2010,10001,212,1479,750,3144,115,530,865,3674,0.0366732546764888,0.235438214480131
2010,10003,339,1615,5193,12245,710,1516,5903,13761,0.0392567995481232,0.428965918174551
2010,10005,221,1200,1851,5263,86,581,1937,5844,0.0426000306160384,0.33145106091718
2010,11001,0,0,17970,26813,3703,4964,21673,31777,0.0795504897898898,0.682034175661642
2010,12001,1878,5299,1912,3234,809,1320,2721,4554,0.0322340899921432,0.597496706192358
2010,12003,73,1158,0,68,0,19,0,87,0.00513668300171223,0
2010,12005,379,2693,1320,4809,218,830,1538,5639,0.0497169861226217,0.272743394218833
2010,12007,51,1801,0,146,0,0,0,146,0.00727526410205302,0
2010,12009,1720,7459,2502,10140,563,1385,3065,11525,0.0296598065228413,0.265943600867679
2010,12011,8392,30001,8055,22758,4483,13005,12538,35763,0.0299331331820621,0.35058580096748
2010,12013,139,1275,18,157,0,7,18,164,0.0163688990917257,0.109756097560976
2010,12015,1025,4604,1383,5026,84,278,1467,5304,0.0418134947851382,0.27658371040724
2010,12017,353,2880,426,2980,12,238,438,3218,0.0292436455502949,0.136109384711001
2010,12019,1032,5320,1050,2889,193,573,1243,3462,0.0287324364475355,0.359041016753322
2010,12021,980,3673,3062,7345,630,2236,3692,9581,0.0412902947767626,0.385345997286296
2010,12023,313,2725,154,1143,9,31,163,1174,0.0262346368715084,0.138841567291312
2010,12027,18,948,67,459,30,359,97,818,0.0357392520097868,0.118581907090465
2010,12029,7,433,0,10,14,14,14,24,0.00211453744493392,0.583333333333333
2010,12031,3194,12199,4710,16383,1078,3252,5788,19635,0.0351413798472643,0.294779730073848
2010,12033,917,5292,1894,7729,345,944,2239,8673,0.0446688847457278,0.258157500288251
2010,12035,463,1972,527,2736,9,160,536,2896,0.0429558871517992,0.185082872928177
2010,12037,15,836,37,161,26,32,63,193,0.0222043258168431,0.326424870466321
2010,12039,128,1825,124,265,29,29,153,294,0.00954979536152797,0.520408163265306
2010,12041,28,672,0,92,0,24,0,116,0.0105878057685287,0
2010,12043,81,450,43,104,0,0,43,104,0.0114185331576636,0.413461538461538
2010,12045,101,1302,26,193,0,0,26,193,0.016376750106067,0.134715025906736
2010,12047,55,1034,7,242,0,3,7,245,0.0248756218905473,0.0285714285714286
2010,12049,66,661,36,425,0,205,36,630,0.0367539816813488,0.0571428571428571
2010,12051,191,1391,19,121,39,778,58,899,0.0384056732740943,0.0645161290322581
2010,12053,519,4485,877,4245,237,450,1114,4695,0.0374817381307829,0.23727369542066
2010,12055,390,1707,201,1895,134,298,335,2193,0.029752537038042,0.152758777929777
2010,12057,5946,19059,8081,20764,2499,5796,10580,26560,0.0338740944801551,0.398343373493976
2010,12059,47,742,105,435,0,4,105,439,0.0315895517018061,0.239179954441913
2010,12061,660,3053,900,2800,187,461,1087,3261,0.0324409824812726,0.333333333333333
2010,12063,116,2510,63,827,11,37,74,864,0.0248740463509429,0.0856481481481482
2010,12065,50,430,0,50,0,46,0,96,0.00938141307534447,0
2010,12067,0,457,0,33,0,0,0,33,0.00631699846860643,0
2010,12069,1677,8250,1775,7126,303,936,2078,8062,0.0380850701989758,0.257752418754651
2010,12071,1630,9303,5429,17267,690,2608,6119,19875,0.0452261649577434,0.307874213836478
2010,12073,1410,4918,1500,3724,392,638,1892,4362,0.0282972967713057,0.433745988078863
2010,12075,175,1712,55,525,0,158,55,683,0.0238827890062242,0.0805270863836018
2010,12077,133,542,0,92,0,0,0,92,0.0172413793103448,0
2010,12079,99,1147,0,109,0,42,0,151,0.0113833396155296,0
2010,12081,1626,6088,2194,7885,344,983,2538,8868,0.0385644022909029,0.286197564276049
2010,12083,1482,8232,1606,6913,89,769,1695,7682,0.0321473707116613,0.220645665191356
2010,12085,980,4148,1002,3404,182,490,1184,3894,0.0357572474081964,0.304057524396507
2010,12086,5270,20823,7460,17430,7207,24744,14667,42174,0.0254742059621022,0.347773509745341
2010,12087,424,1422,533,2108,101,260,634,2368,0.041812338877706,0.267736486486487
2010,12089,184,1301,415,1304,44,124,459,1428,0.0286666399004296,0.321428571428571
2010,12091,460,2099,1759,5950,347,953,2106,6903,0.0567690258063455,0.305084745762712
2010,12093,28,1068,145,535,26,373,171,908,0.034360099901612,0.188325991189427
2010,12095,6895,22350,6095,16983,2746,8571,8841,25554,0.036094036023413,0.345973233153322
2010,12097,1376,7357,1054,4707,314,1776,1368,6483,0.0393753871943442,0.211013419713096
2010,12099,5301,16599,10258,24617,2329,7455,12587,32072,0.0345010832686097,0.392460713394862
2010,12101,3811,14890,2406,10938,328,1665,2734,12603,0.0384605994763279,0.216932476394509
2010,12103,3707,12160,5729,18089,1835,4870,7564,22959,0.0335227098509372,0.329456857877085
2010,12105,2137,11171,2681,11814,627,2580,3308,14394,0.0362100454323621,0.22981797971377
2010,12107,107,1604,104,815,0,198,104,1013,0.0198141809290954,0.102665350444225
2010,12109,1765,5588,2711,5677,279,688,2990,6365,0.0510830571183217,0.469756480754124
2010,12111,1080,7196,1094,5275,197,743,1291,6018,0.0320057012482117,0.214523097374543
2010,12113,828,3783,1263,4569,274,605,1537,5174,0.0520261437908497,0.297062234248164
2010,12115,1793,6631,3439,9935,446,1632,3885,11567,0.0394022387093697,0.335869283305957
2010,12117,3729,12122,2364,6122,680,1570,3044,7692,0.02772101672559,0.395735829433177
2010,12119,242,2781,1125,3580,175,652,1300,4232,0.0573131094257855,0.307183364839319
2010,12121,130,1492,85,359,0,0,85,359,0.0129383356759289,0.236768802228412
2010,12123,70,1004,96,253,15,15,111,268,0.0175829943576958,0.414179104477612
2010,12125,38,1458,19,169,1,2,20,171,0.0169306930693069,0.116959064327485
2010,12127,2225,8506,1562,8313,436,1558,1998,9871,0.027745531510615,0.202411103231689
2010,12129,115,1915,59,233,0,12,59,245,0.0120298536776981,0.240816326530612
2010,12131,281,2337,713,1834,41,148,754,1982,0.0515984588149537,0.380423814328961
2010,12133,106,797,50,312,0,0,50,312,0.0184244714775009,0.16025641025641
2010,13001,19,163,0,32,0,18,0,50,0.0041010498687664,0
2010,13003,26,109,0,96,0,0,0,96,0.0192115269161497,0
2010,13005,8,484,8,146,0,0,8,146,0.0200027401013838,0.0547945205479452
2010,13007,0,0,0,0,0,0,0,0,0,NA
2010,13009,144,1373,146,262,0,101,146,363,0.0126269653541116,0.402203856749311
2010,13011,49,601,11,114,0,14,11,128,0.0108760302489591,0.0859375
2010,13013,312,2384,61,748,0,78,61,826,0.0197872748179379,0.0738498789346247
2010,13015,304,2510,170,1108,92,188,262,1296,0.0206231501225295,0.202160493827161
2010,13017,105,457,45,344,0,17,45,361,0.03176977910763,0.124653739612188
2010,13019,2,559,24,164,0,53,24,217,0.0177606809625143,0.110599078341014
2010,13021,485,3679,688,1790,147,332,835,2122,0.0214986221429729,0.393496701225259
2010,13023,34,209,0,22,0,11,0,33,0.00408415841584158,0
2010,13025,1,559,0,292,0,0,0,292,0.025745018515253,0
2010,13027,140,503,15,147,0,34,15,181,0.0170915958451369,0.0828729281767956
2010,13029,271,886,409,1093,66,141,475,1234,0.0676831943835015,0.384927066450567
2010,13031,308,1298,46,617,0,52,46,669,0.0193991764774111,0.0687593423019432
2010,13033,18,407,5,144,31,31,36,175,0.0123005552822099,0.205714285714286
2010,13035,78,2039,8,85,0,29,8,114,0.00720606826801517,0.0701754385964912
2010,13037,39,742,10,50,0,0,10,50,0.0110570544007077,0.2
2010,13039,134,613,291,1269,63,202,354,1471,0.0503560180747638,0.240652617267165
2010,13043,19,201,28,128,0,0,28,128,0.0189601540512517,0.21875
2010,13045,513,2407,236,1412,16,227,252,1639,0.0243960525728235,0.153752287980476
2010,13047,131,982,402,1692,0,32,402,1724,0.0411024222773221,0.233178654292343
2010,13049,9,277,28,553,0,0,28,553,0.0661245964366854,0.0506329113924051
2010,13051,793,3516,2002,4481,311,931,2313,5412,0.0328591464636345,0.427383592017738
2010,13053,59,230,943,1794,217,705,1160,2499,0.420282542885974,0.464185674269708
2010,13055,50,593,67,191,0,4,67,195,0.0109945872801083,0.343589743589744
2010,13057,1970,5911,1515,3165,278,603,1793,3768,0.0281985272106807,0.475849256900212
2010,13059,836,2376,1035,1645,185,280,1220,1925,0.0325328285815687,0.633766233766234
2010,13061,0,64,28,55,0,3,28,58,0.0288557213930348,0.482758620689655
2010,13063,1945,10503,854,5198,164,740,1018,5938,0.0380177988347525,0.171438194678343
2010,13065,0,69,0,0,0,57,0,57,0.0127090301003344,0
2010,13067,7799,19403,6812,15490,1239,2469,8051,17959,0.040807654815276,0.448298903056963
2010,13069,55,710,52,204,0,33,52,237,0.00905928672451359,0.219409282700422
2010,13071,147,1108,27,646,32,182,59,828,0.0296657231915732,0.071256038647343
2010,13073,772,3187,1041,2207,180,515,1221,2722,0.035939686815073,0.448567229977957
2010,13075,43,333,52,106,0,0,52,106,0.00980301488948488,0.490566037735849
2010,13077,565,2925,647,2127,51,347,698,2474,0.0313855834369371,0.2821341956346
2010,13079,15,406,0,10,0,0,0,10,0.00115566855425864,0
2010,13081,0,446,11,303,0,0,11,303,0.0204343134610197,0.0363036303630363
2010,13083,0,275,71,344,59,59,130,403,0.0375058166589111,0.32258064516129
2010,13085,154,1008,86,227,0,0,86,227,0.015255376344086,0.378854625550661
2010,13087,25,704,33,254,8,10,41,264,0.0146568954030646,0.15530303030303
2010,13089,9493,24970,5901,12311,1929,3909,7830,16220,0.0361100041631139,0.482737361282367
2010,13091,15,293,27,54,0,21,27,75,0.00539529530249622,0.36
2010,13093,8,510,0,34,0,0,0,34,0.0034965034965035,0
2010,13095,316,2810,242,1154,40,231,282,1385,0.0240101241245406,0.203610108303249
2010,13097,1109,5728,889,3353,24,135,913,3488,0.0432041420484808,0.261754587155963
2010,13099,19,105,10,23,0,0,10,23,0.00318603684720875,0.434782608695652
2010,13101,0,134,0,0,0,0,0,0,0,NA
2010,13103,215,1325,68,735,0,43,68,778,0.0245992348309988,0.0874035989717224
2010,13105,30,268,34,106,0,15,34,121,0.00889248181083266,0.28099173553719
2010,13107,20,624,0,342,0,0,0,342,0.023735165521549,0
2010,13109,8,516,0,35,0,11,0,46,0.00662728713441867,0
2010,13111,71,439,27,180,0,36,27,216,0.012494215640907,0.125
2010,13113,941,2746,1039,2000,142,236,1181,2236,0.0321449108683151,0.528175313059034
2010,13115,198,1367,403,1029,32,369,435,1398,0.0223508345590586,0.311158798283262
2010,13117,2646,5215,1310,2606,245,428,1555,3034,0.0288677450047574,0.512524719841793
2010,13119,4,385,12,93,0,27,12,120,0.00809225166902691,0.1
2010,13121,11003,25164,12051,22653,3200,4971,15251,27624,0.0476853841811713,0.552092383434694
2010,13123,96,933,42,347,9,93,51,440,0.0223486387647298,0.115909090909091
2010,13125,13,61,0,75,4,10,4,85,0.0418101328086572,0.0470588235294118
2010,13127,405,1796,625,1497,163,326,788,1823,0.0349053171731097,0.432254525507405
2010,13129,165,884,87,607,0,12,87,619,0.0179051806427352,0.140549273021002
2010,13131,53,648,100,230,14,60,114,290,0.018125,0.393103448275862
2010,13133,206,478,6,98,0,0,6,98,0.00865036631653279,0.0612244897959184
2010,13135,5913,18554,5676,15615,1277,3469,6953,19084,0.0393487781342527,0.364336617061413
2010,13137,144,1377,84,220,0,13,84,233,0.00854512781017347,0.360515021459227
2010,13139,896,4133,713,1924,76,319,789,2243,0.020434750920156,0.351761034329024
2010,13141,0,437,0,81,0,0,0,81,0.0120859444941808,0
2010,13143,1,1029,0,327,0,0,0,327,0.0174038000958007,0
2010,13145,250,1018,238,646,8,41,246,687,0.0326334790043701,0.358078602620087
2010,13147,100,956,11,131,0,0,11,131,0.00752268289881704,0.083969465648855
2010,13149,0,466,24,113,0,25,24,138,0.0178594538630775,0.173913043478261
2010,13151,1312,6817,1041,3925,73,302,1114,4227,0.0348696204515645,0.263543884551692
2010,13153,976,3360,723,2904,90,359,813,3263,0.0382999201840462,0.249157217284707
2010,13155,43,430,0,204,0,86,0,290,0.0454474220341639,0
2010,13157,415,2316,120,514,0,25,120,539,0.0141225174238851,0.222634508348794
2010,13159,72,455,33,54,0,44,33,98,0.0108961529908828,0.336734693877551
2010,13161,77,488,7,105,15,15,22,120,0.0131420435877779,0.183333333333333
2010,13163,4,410,19,126,17,17,36,143,0.0130856515373353,0.251748251748252
2010,13165,0,60,0,0,0,0,0,0,0,NA
2010,13167,8,827,0,53,0,10,0,63,0.00922131147540984,0
2010,13169,185,1129,18,236,20,20,38,256,0.0135845051737862,0.1484375
2010,13171,0,480,0,191,0,60,0,251,0.0217806317250955,0
2010,13173,5,249,0,73,0,55,0,128,0.0219554030874786,0
2010,13175,117,636,58,362,0,62,58,424,0.0135143749601581,0.136792452830189
2010,13177,51,1065,47,236,12,42,59,278,0.015700005647484,0.212230215827338
2010,13179,218,1260,551,3314,202,1199,753,4513,0.129598254027511,0.166851318413472
2010,13181,22,124,0,39,0,0,0,39,0.00698674310283053,0
2010,13183,18,612,0,365,0,33,0,398,0.0544385173026946,0
2010,13185,250,1792,715,2185,49,276,764,2461,0.0407059446227133,0.310442909386428
2010,13187,169,979,53,308,0,68,53,376,0.020749406765631,0.140957446808511
2010,13189,75,550,49,210,0,43,49,253,0.0179305457122608,0.193675889328063
2010,13191,0,496,0,30,0,0,0,30,0.00324289266025295,0
2010,13193,15,531,7,47,0,133,7,180,0.0187032418952618,0.0388888888888889
2010,13195,100,677,31,69,0,26,31,95,0.00508864963308158,0.326315789473684
2010,13197,6,156,24,63,3,40,27,103,0.0187000726216413,0.262135922330097
2010,13199,54,542,0,57,0,36,0,93,0.00622406639004149,0
2010,13201,2,103,11,33,0,0,11,33,0.0078125,0.333333333333333
2010,13205,55,784,9,64,0,8,9,72,0.00466683951257454,0.125
2010,13207,75,878,61,228,0,0,61,228,0.0130869016186431,0.267543859649123
2010,13209,0,112,0,34,5,5,5,39,0.00684931506849315,0.128205128205128
2010,13211,120,556,14,120,0,0,14,120,0.00978234287111763,0.116666666666667
2010,13213,7,596,0,260,0,6,0,266,0.0104510451045105,0
2010,13215,492,3415,1533,6443,339,1126,1872,7569,0.0652100869295517,0.247324613555291
2010,13217,459,3433,284,1205,0,203,284,1408,0.0234455656575749,0.201704545454545
2010,13219,486,1041,167,412,12,31,179,443,0.0219742063492064,0.404063205417607
2010,13221,7,223,0,8,0,0,0,8,0.00083073727933541,0
2010,13223,644,4111,527,1823,23,53,550,1876,0.022545909047207,0.29317697228145
2010,13225,159,640,97,422,0,0,97,422,0.0261559439692575,0.229857819905213
2010,13227,195,928,53,261,20,50,73,311,0.0152548192475597,0.234726688102894
2010,13229,14,578,12,237,0,0,12,237,0.019802807486631,0.0506329113924051
2010,13231,67,859,36,103,4,53,40,156,0.0138346931536006,0.256410256410256
2010,13233,50,939,8,100,0,52,8,152,0.00577047188793136,0.0526315789473684
2010,13235,8,530,0,39,0,11,0,50,0.00604448742746615,0
2010,13237,109,482,133,249,0,0,133,249,0.016889371227023,0.534136546184739
2010,13239,0,7,0,50,0,0,0,50,0.0314070351758794,0
2010,13241,71,272,92,196,0,10,92,206,0.0174665083940987,0.446601941747573
2010,13243,0,105,12,12,0,0,12,12,0.00240096038415366,1
2010,13245,812,3667,1269,4872,592,1461,1861,6333,0.05114723911516,0.293857571451129
2010,13247,605,3751,407,1645,98,203,505,1848,0.0347616718708852,0.273268398268398
2010,13249,4,122,0,0,0,0,0,0,0,NA
2010,13251,62,360,0,103,8,8,8,111,0.0116315624017605,0.0720720720720721
2010,13253,0,145,0,61,0,43,0,104,0.0175231676495366,0
2010,13255,127,1767,42,343,14,68,56,411,0.00994579421159617,0.13625304136253
2010,13257,30,559,0,287,0,0,0,287,0.0163644657315543,0
2010,13259,0,80,3,39,0,8,3,47,0.011688634667993,0.0638297872340425
2010,13261,119,618,107,244,41,96,148,340,0.0170093551453299,0.435294117647059
2010,13263,7,179,0,52,0,0,0,52,0.0105971061748523,0
2010,13265,1,56,0,0,0,0,0,0,0,NA
2010,13267,74,1369,77,331,13,23,90,354,0.0218802150936399,0.254237288135593
2010,13269,8,448,0,77,0,0,0,77,0.0129760701044826,0
2010,13271,0,242,7,179,0,53,7,232,0.0206240554715975,0.0301724137931034
2010,13273,0,213,0,95,0,0,0,95,0.0152634961439589,0
2010,13275,195,917,77,588,86,116,163,704,0.0238498543261739,0.231534090909091
2010,13277,104,950,206,518,77,197,283,715,0.0288294826821499,0.395804195804196
2010,13279,84,478,37,112,4,70,41,182,0.0107115531752104,0.225274725274725
2010,13281,11,117,17,189,0,0,17,189,0.0245741776101937,0.0899470899470899
2010,13283,25,236,0,93,0,10,0,103,0.0226274165202109,0
2010,13285,110,1326,115,851,84,118,199,969,0.0233117617340679,0.205366357069143
2010,13287,0,154,0,198,0,0,0,198,0.034542916957432,0
2010,13289,7,116,0,76,0,19,0,95,0.014955919395466,0
2010,13291,69,422,80,631,0,0,80,631,0.0393072945866816,0.126782884310618
2010,13293,108,721,49,227,0,49,49,276,0.0150704379163481,0.177536231884058
2010,13295,68,1598,261,1207,8,52,269,1259,0.0273173060232599,0.213661636219222
2010,13297,538,3283,137,537,0,16,137,553,0.0104233422550609,0.247739602169982
2010,13299,103,967,159,762,0,71,159,833,0.0348827470686767,0.190876350540216
2010,13301,5,90,8,55,0,0,8,55,0.0136510300322661,0.145454545454545
2010,13303,42,696,27,70,0,11,27,81,0.00576676633917129,0.333333333333333
2010,13305,96,877,66,645,0,73,66,718,0.0364282090309488,0.0919220055710306
2010,13307,7,75,0,85,0,0,0,85,0.0454302512025655,0
2010,13309,81,429,0,26,0,16,0,42,0.00816326530612245,0
2010,13311,25,365,52,172,0,0,52,172,0.00928424916333801,0.302325581395349
2010,13313,181,1645,238,1159,74,149,312,1308,0.0212031318387395,0.238532110091743
2010,13315,11,425,17,45,0,40,17,85,0.0133103664265581,0.2
2010,13317,70,272,7,63,0,0,7,63,0.00847343644922663,0.111111111111111
2010,13319,8,167,21,28,0,18,21,46,0.00715174129353234,0.456521739130435
2010,13321,71,343,64,460,0,0,64,460,0.0324629498941426,0.139130434782609
2010,15001,221,851,1324,3422,141,606,1465,4028,0.0326066719014352,0.363704071499503
2010,15003,515,2376,7863,19292,2891,8482,10754,27774,0.0440080366083991,0.387196658745589
2010,15005,0,4,0,0,0,0,0,0,0,NA
2010,15007,83,389,488,1347,48,273,536,1620,0.0357726449675396,0.330864197530864
2010,15009,266,1253,1737,3616,160,626,1897,4242,0.0408650835701556,0.447194719471947
2010,16001,1177,6216,3945,9917,498,1144,4443,11061,0.04531878019101,0.401681583943586
2010,16003,56,134,22,47,4,4,26,51,0.0178821879382889,0.509803921568627
2010,16005,299,1274,376,1527,55,96,431,1623,0.0339241670498725,0.265557609365373
2010,16007,5,47,3,96,5,6,8,102,0.0257966616084977,0.0784313725490196
2010,16009,20,146,12,148,0,0,12,148,0.0231358449273097,0.0810810810810811
2010,16011,53,657,81,633,0,19,81,652,0.0253272734335548,0.124233128834356
2010,16013,61,307,298,442,104,246,402,688,0.0465872156013001,0.584302325581395
2010,16015,21,141,5,116,0,0,5,116,0.0226429826273668,0.0431034482758621
2010,16017,137,349,256,893,29,81,285,974,0.0333561643835616,0.292607802874743
2010,16019,336,2067,563,1737,58,202,621,1939,0.0324117411072479,0.320268179473956
2010,16021,13,74,0,159,0,0,0,159,0.021694637740483,0
2010,16023,4,47,0,67,0,0,0,67,0.0330700888450148,0
2010,16025,7,39,0,14,0,0,0,14,0.0180878552971576,0
2010,16027,713,3772,607,3347,113,752,720,4099,0.0381298778616013,0.175652598194682
2010,16029,0,87,48,107,0,0,48,107,0.0237303171434908,0.448598130841121
2010,16031,83,507,54,378,0,24,54,402,0.0311458898272255,0.134328358208955
2010,16033,0,5,0,10,0,0,0,10,0.0175746924428823,0
2010,16035,8,358,38,170,0,0,38,170,0.0254072634882678,0.223529411764706
2010,16037,94,169,80,130,0,5,80,135,0.0444225074037512,0.592592592592593
2010,16039,48,124,103,758,71,317,174,1075,0.0689721544976261,0.161860465116279
2010,16041,4,32,71,369,30,91,101,460,0.0644167483545722,0.219565217391304
2010,16043,54,188,78,158,0,46,78,204,0.0254618072890664,0.382352941176471
2010,16045,71,727,78,325,0,0,78,325,0.0285388127853881,0.24
2010,16047,18,229,32,110,0,21,32,131,0.0139036298025897,0.244274809160305
2010,16049,84,394,37,229,8,8,45,237,0.0204981837052413,0.189873417721519
2010,16051,120,741,56,322,2,8,58,330,0.0236813778256189,0.175757575757576
2010,16053,49,428,14,194,0,12,14,206,0.016578142604217,0.0679611650485437
2010,16055,169,953,1242,3795,58,164,1300,3959,0.0442643112701252,0.328365748926497
2010,16057,239,774,534,1285,14,15,548,1300,0.0647603865696921,0.421538461538462
2010,16059,88,164,16,69,0,11,16,80,0.0144118176905062,0.2
2010,16061,17,139,8,77,0,8,8,85,0.0318352059925094,0.0941176470588235
2010,16063,19,121,8,93,0,8,8,101,0.033038927052666,0.0792079207920792
2010,16065,75,519,188,682,11,33,199,715,0.0535380007487832,0.278321678321678
2010,16067,0,438,43,221,0,0,43,221,0.0181415202758168,0.194570135746606
2010,16069,130,566,295,1008,20,29,315,1037,0.039167547967971,0.303760848601736
2010,16071,40,131,30,161,0,0,30,161,0.0605946556266466,0.186335403726708
2010,16073,45,375,0,97,0,6,0,103,0.0145562464669305,0
2010,16075,21,386,112,660,0,109,112,769,0.0545235394214407,0.145643693107932
2010,16077,2,94,31,74,0,0,31,74,0.0163247297595411,0.418918918918919
2010,16079,21,173,9,280,0,7,9,287,0.0305904924323172,0.0313588850174216
2010,16081,99,138,230,423,10,20,240,443,0.0726348581734711,0.54176072234763
2010,16083,223,963,225,1147,17,515,242,1662,0.0353083639608251,0.14560770156438
2010,16085,76,315,66,179,9,9,75,188,0.0260568260568261,0.398936170212766
2010,16087,11,163,44,251,0,10,44,261,0.0367761025785543,0.168582375478927
2010,17001,101,584,146,579,63,87,209,666,0.0146945259581228,0.313813813813814
2010,17003,23,180,0,144,0,11,0,155,0.027027027027027,0
2010,17005,79,351,95,144,0,0,95,144,0.0119502074688797,0.659722222222222
2010,17007,221,1124,207,399,13,40,220,439,0.013124850514231,0.501138952164009
2010,17009,28,1095,9,66,0,0,9,66,0.0130357495555994,0.136363636363636
2010,17011,91,660,35,140,26,70,61,210,0.00863735450170691,0.29047619047619
2010,17013,30,110,7,21,0,0,7,21,0.00580431177446103,0.333333333333333
2010,17015,32,413,13,85,1,17,14,102,0.00899470899470899,0.137254901960784
2010,17017,64,465,11,162,3,144,14,306,0.0337413165729408,0.0457516339869281
2010,17019,931,2469,1896,3220,1162,1553,3058,4773,0.0430411023139214,0.640687198826734
2010,17021,185,1182,32,180,21,27,53,207,0.00856504468718967,0.256038647342995
2010,17023,27,282,73,227,0,15,73,242,0.021220624342336,0.301652892561983
2010,17025,34,220,0,38,0,0,0,38,0.00394764180344899,0
2010,17027,156,1296,89,266,11,50,100,316,0.0123235317057952,0.316455696202532
2010,17029,124,967,78,407,13,18,91,425,0.013899790685505,0.214117647058824
2010,17031,10779,26584,29130,48908,11344,23145,40474,72053,0.0211057672732748,0.561725396583071
2010,17033,30,270,23,472,30,30,53,502,0.0369307731920842,0.105577689243028
2010,17035,88,400,4,48,0,0,4,48,0.00641282565130261,0.0833333333333333
2010,17037,749,2761,446,887,45,221,491,1108,0.0190266854414947,0.443140794223827
2010,17039,75,468,38,101,0,0,38,101,0.00875216637781629,0.376237623762376
2010,17041,58,489,6,121,0,14,6,135,0.0103599109815056,0.0444444444444444
2010,17043,9249,20313,5857,9588,1700,3410,7557,12998,0.0215627431366011,0.581397138021234
2010,17045,39,337,28,189,6,18,34,207,0.0156889495225102,0.164251207729469
2010,17047,45,141,0,21,0,0,0,21,0.00452099031216362,0
2010,17049,112,441,76,196,3,16,79,212,0.00943354247319005,0.372641509433962
2010,17051,21,223,114,386,0,2,114,388,0.0258408258408258,0.293814432989691
2010,17053,56,465,7,107,0,3,7,110,0.0113542526837325,0.0636363636363636
2010,17055,42,584,49,384,17,35,66,419,0.0153025820824659,0.157517899761337
2010,17057,74,1222,9,297,0,22,9,319,0.0120595796159081,0.0282131661442006
2010,17059,20,53,26,104,0,0,26,104,0.0253473068486473,0.25
2010,17061,11,223,10,78,0,0,10,78,0.00811992504684572,0.128205128205128
2010,17063,181,1594,45,271,12,31,57,302,0.00953885028427037,0.188741721854305
2010,17065,0,109,8,70,0,0,8,70,0.0118946474086661,0.114285714285714
2010,17067,58,155,87,394,3,5,90,399,0.0292521994134897,0.225563909774436
2010,17069,6,100,5,35,0,0,5,35,0.0109102244389027,0.142857142857143
2010,17071,38,95,11,76,0,0,11,76,0.0139423958906623,0.144736842105263
2010,17073,231,962,105,687,3,45,108,732,0.021163409274893,0.147540983606557
2010,17075,115,788,29,177,21,21,50,198,0.0095233514501467,0.252525252525253
2010,17077,293,1472,494,867,81,156,575,1023,0.0303254876385842,0.562072336265885
2010,17079,17,330,14,109,0,0,14,109,0.0161004431314623,0.128440366972477
2010,17081,98,898,73,353,17,67,90,420,0.0155699721964782,0.214285714285714
2010,17083,106,397,95,157,3,15,98,172,0.011277209546289,0.569767441860465
2010,17085,87,195,69,425,0,9,69,434,0.026184012066365,0.158986175115207
2010,17087,33,1358,10,62,0,0,10,62,0.00690269427744378,0.161290322580645
2010,17089,3794,13567,1734,3849,369,1415,2103,5264,0.0168163870324699,0.399506079027356
2010,17091,685,2646,83,673,36,81,119,754,0.0104882459312839,0.157824933687003
2010,17093,1731,4446,390,1237,106,282,496,1519,0.0233118477593616,0.326530612244898
2010,17095,173,1215,82,377,17,76,99,453,0.012396694214876,0.218543046357616
2010,17097,5384,10302,3793,8700,1113,2279,4906,10979,0.0249354413043923,0.446853083158758
2010,17099,413,1588,249,863,16,93,265,956,0.01237892992179,0.277196652719665
2010,17101,13,742,4,89,0,17,4,106,0.00896027049873204,0.0377358490566038
2010,17103,137,906,69,264,27,38,96,302,0.0121734924217994,0.317880794701987
2010,17105,169,1816,30,186,0,49,30,235,0.00870789639456034,0.127659574468085
2010,17107,94,1709,98,237,0,45,98,282,0.0134767025089606,0.347517730496454
2010,17109,204,698,111,211,63,114,174,325,0.0180806675938804,0.535384615384615
2010,17111,1927,5356,905,2253,88,377,993,2630,0.0133168602590458,0.377566539923954
2010,17113,1179,2795,1092,1703,370,464,1462,2167,0.0218247373880815,0.674665436086756
2010,17115,496,1712,439,1021,121,190,560,1211,0.0161524815600283,0.46242774566474
2010,17117,137,865,104,323,44,94,148,417,0.0126747720364742,0.354916067146283
2010,17119,483,2944,1279,3290,51,128,1330,3418,0.0191395597565278,0.389116442363956
2010,17121,110,664,38,230,0,30,38,260,0.0096414135795602,0.146153846153846
2010,17123,84,305,37,54,10,18,47,72,0.00796548290740126,0.652777777777778
2010,17125,13,328,0,90,0,18,0,108,0.0103171570500573,0
2010,17127,34,148,65,357,4,18,69,375,0.0346708579881657,0.184
2010,17129,107,437,6,77,0,18,6,95,0.0108028201046168,0.0631578947368421
2010,17131,82,233,23,111,4,4,27,115,0.00992920048350889,0.234782608695652
2010,17133,177,492,76,381,0,0,76,381,0.0172663826701713,0.199475065616798
2010,17135,67,1140,105,335,4,14,109,349,0.016361931551805,0.312320916905444
2010,17137,134,1146,36,348,0,44,36,392,0.0161556214968678,0.0918367346938776
2010,17139,136,367,18,52,0,0,18,52,0.00522455541042902,0.346153846153846
2010,17141,215,954,72,398,3,17,75,415,0.0115895889186774,0.180722891566265
2010,17143,483,2759,1093,2402,392,544,1485,2946,0.0243223830321244,0.504073319755601
2010,17145,32,1108,15,56,0,35,15,91,0.00587703435804702,0.164835164835165
2010,17147,89,287,45,76,0,11,45,87,0.0075,0.517241379310345
2010,17149,15,410,16,252,0,6,16,258,0.0224445411048282,0.062015503875969
2010,17151,6,35,0,43,0,0,0,43,0.0139068564036223,0
2010,17153,23,130,0,39,0,0,0,39,0.00933908045977012,0
2010,17155,11,125,2,13,10,28,12,41,0.00966297431062927,0.292682926829268
2010,17157,75,1532,0,155,0,10,0,165,0.0068916548325119,0
2010,17159,35,114,25,195,58,58,83,253,0.0225269343780607,0.328063241106719
2010,17161,402,1989,654,2229,202,448,856,2677,0.0266893980179857,0.319760926410161
2010,17163,639,3132,1268,4329,284,586,1552,4915,0.0283646604608752,0.315768056968464
2010,17165,45,354,18,79,0,3,18,82,0.0047481181239143,0.219512195121951
2010,17167,828,3302,824,2034,79,465,903,2499,0.0189056081341776,0.361344537815126
2010,17169,26,240,0,20,0,0,0,20,0.0038001140034201,0
2010,17171,36,134,10,12,0,2,10,14,0.00377969762419006,0.714285714285714
2010,17173,28,454,15,57,0,29,15,86,0.00552450696987217,0.174418604651163
2010,17175,16,124,5,53,4,4,9,57,0.013678905687545,0.157894736842105
2010,17177,182,737,121,643,0,9,121,652,0.0195566753651879,0.18558282208589
2010,17179,959,3353,309,1256,8,64,317,1320,0.0143521941460444,0.240151515151515
2010,17181,27,322,14,197,5,25,19,222,0.0176134560456998,0.0855855855855856
2010,17183,174,875,105,682,52,167,157,849,0.0156391032843959,0.1849234393404
2010,17185,0,178,30,110,0,26,30,136,0.0162952312485023,0.220588235294118
2010,17187,59,296,47,134,0,0,47,134,0.0114824335904027,0.350746268656716
2010,17189,50,373,10,56,0,14,10,70,0.00676720804331013,0.142857142857143
2010,17191,0,246,0,72,0,8,0,80,0.00683001792879706,0
2010,17193,35,208,9,168,17,17,26,185,0.017382317015879,0.140540540540541
2010,17195,37,690,46,398,0,6,46,404,0.0100557546794106,0.113861386138614
2010,17197,5015,14805,2283,4508,661,1576,2944,6084,0.0145567303344172,0.483892176199869
2010,17199,325,1483,383,1101,0,53,383,1154,0.0254791133091937,0.331889081455806
2010,17201,901,3474,971,3174,215,476,1186,3650,0.0187560379026125,0.324931506849315
2010,17203,277,1142,113,239,69,86,182,325,0.0129989600831933,0.56
2010,18001,54,356,28,180,0,8,28,188,0.00909926915444557,0.148936170212766
2010,18003,620,2572,1135,3599,242,729,1377,4328,0.0194003290166705,0.318160813308688
2010,18005,248,1401,425,781,230,318,655,1099,0.0217167924752006,0.595996360327571
2010,18007,36,323,0,103,0,14,0,117,0.0199522510231924,0
2010,18009,20,272,46,169,21,21,67,190,0.0213195691202873,0.352631578947368
2010,18011,383,1125,391,606,11,20,402,626,0.0176223854967204,0.642172523961661
2010,18013,141,528,21,226,0,0,21,226,0.0204932898077621,0.0929203539823009
2010,18015,49,373,69,126,3,23,72,149,0.0108894248337353,0.483221476510067
2010,18017,101,659,29,126,0,62,29,188,0.00726710475454194,0.154255319148936
2010,18019,180,1674,475,2074,15,132,490,2206,0.0302316020282308,0.222121486854034
2010,18021,91,335,32,146,5,18,37,164,0.00903929890315824,0.225609756097561
2010,18023,62,649,0,354,4,57,4,411,0.0191020635805912,0.0097323600973236
2010,18025,14,150,15,98,0,29,15,127,0.0173048099196076,0.118110236220472
2010,18027,40,400,29,213,0,43,29,256,0.0131924761659366,0.11328125
2010,18029,26,482,97,1117,12,49,109,1166,0.0351099066546221,0.0934819897084048
2010,18031,82,521,116,337,39,50,155,387,0.0228103265354238,0.400516795865633
2010,18033,158,741,72,269,0,23,72,292,0.010660046728972,0.246575342465753
2010,18035,374,1837,469,1245,128,257,597,1502,0.0212012139177077,0.397470039946738
2010,18037,87,257,181,393,21,30,202,423,0.0150651755823064,0.477541371158392
2010,18039,429,2124,525,2343,161,590,686,2933,0.0239116256318278,0.233890214797136
2010,18041,24,507,15,131,13,23,28,154,0.00920612147297944,0.181818181818182
2010,18043,301,1418,342,1389,30,114,372,1503,0.0305469178708615,0.24750499001996
2010,18045,18,316,0,156,0,0,0,156,0.0132304299889746,0
2010,18047,115,461,64,283,15,61,79,344,0.022289898269941,0.229651162790698
2010,18049,41,449,9,96,0,0,9,96,0.0068259385665529,0.09375
2010,18051,111,526,144,342,0,0,144,342,0.0151723526019254,0.421052631578947
2010,18053,141,1049,250,752,64,108,314,860,0.0188691664655418,0.365116279069767
2010,18055,197,1070,56,237,38,38,94,275,0.0121740670237726,0.341818181818182
2010,18057,4385,8179,2514,4379,372,706,2886,5085,0.0305115866025033,0.567551622418879
2010,18059,610,1924,190,423,24,36,214,459,0.0101573391754631,0.466230936819172
2010,18061,24,236,54,314,0,26,54,340,0.0129726429852341,0.158823529411765
2010,18063,987,4693,746,1793,85,160,831,1953,0.0213814168883634,0.425499231950845
2010,18065,185,1800,48,481,0,1,48,482,0.0140981017286262,0.0995850622406639
2010,18067,175,1198,168,769,17,80,185,849,0.0149611433203517,0.217903415783274
2010,18069,27,369,129,387,0,35,129,422,0.017202723085076,0.305687203791469
2010,18071,67,684,107,255,113,202,220,457,0.0162085476148253,0.481400437636761
2010,18073,216,872,28,154,0,0,28,154,0.00722563693520387,0.181818181818182
2010,18075,20,255,72,184,0,0,72,184,0.0131786277037674,0.391304347826087
2010,18077,109,847,132,322,7,41,139,363,0.0168923635348318,0.382920110192837
2010,18079,5,619,16,389,0,27,16,416,0.0224779813043713,0.0384615384615385
2010,18081,1001,5023,602,1672,48,148,650,1820,0.0206604533947849,0.357142857142857
2010,18083,77,490,96,380,7,54,103,434,0.0174542529660165,0.237327188940092
2010,18085,244,1451,353,745,106,189,459,934,0.0186994474253223,0.491434689507495
2010,18087,106,702,144,375,9,26,153,401,0.0191911940655659,0.381546134663342
2010,18089,602,3398,1566,9708,229,768,1795,10476,0.0324560452327473,0.171344024436808
2010,18091,369,3341,297,1281,76,116,373,1397,0.0183825464498131,0.267000715819613
2010,18093,54,586,65,348,17,32,82,380,0.0119459289531594,0.215789473684211
2010,18095,553,2859,180,1149,32,159,212,1308,0.0146933273421703,0.162079510703364
2010,18097,4085,13448,4057,10291,1503,3323,5560,13614,0.0236863258183387,0.408403114441017
2010,18099,100,1193,155,301,27,99,182,400,0.0130877204462913,0.455
2010,18101,0,147,13,128,25,31,38,159,0.0226012793176972,0.238993710691824
2010,18103,63,1566,48,317,0,0,48,317,0.0124386894251521,0.151419558359621
2010,18105,757,2580,2198,3059,737,986,2935,4045,0.0553351573187415,0.725587144622991
2010,18107,109,657,91,255,0,26,91,281,0.0111782958071446,0.323843416370107
2010,18109,250,1907,56,397,0,0,56,397,0.00867456190184853,0.141057934508816
2010,18111,11,272,26,184,0,14,26,198,0.0200222469410456,0.131313131313131
2010,18113,33,1201,36,379,14,31,50,410,0.0134413008556535,0.121951219512195
2010,18115,8,160,11,68,0,0,11,68,0.0158249941819874,0.161764705882353
2010,18117,36,380,36,154,0,3,36,157,0.0117190415764723,0.229299363057325
2010,18119,43,396,19,131,0,14,19,145,0.00978209539229576,0.131034482758621
2010,18121,96,1073,8,131,17,17,25,148,0.0121351262709085,0.168918918918919
2010,18123,23,741,18,78,0,0,18,78,0.00573698146513681,0.230769230769231
2010,18125,22,295,0,76,0,0,0,76,0.00837650170836548,0
2010,18127,488,3157,578,2103,165,357,743,2460,0.0229833510847021,0.302032520325203
2010,18129,78,360,49,207,0,0,49,207,0.0117606954150332,0.236714975845411
2010,18131,60,357,31,90,0,25,31,115,0.0125081574940178,0.269565217391304
2010,18133,115,1887,53,354,9,29,62,383,0.0155476171145571,0.161879895561358
2010,18135,7,453,10,403,12,45,22,448,0.0250279329608939,0.0491071428571429
2010,18137,64,430,97,403,16,19,113,422,0.0223410450526762,0.267772511848341
2010,18139,57,393,27,70,0,0,27,70,0.00596252129471891,0.385714285714286
2010,18141,607,2403,1735,3863,134,595,1869,4458,0.0262323249560147,0.419246298788694
2010,18143,57,449,0,251,0,0,0,251,0.0154328578455485,0
2010,18145,102,914,55,255,18,103,73,358,0.0120170521298379,0.20391061452514
2010,18147,34,228,27,145,0,9,27,154,0.0106294864715627,0.175324675324675
2010,18149,61,657,11,201,0,0,11,201,0.0128188775510204,0.054726368159204
2010,18151,105,544,44,433,0,5,44,438,0.0194131725910824,0.100456621004566
2010,18153,187,984,26,117,0,4,26,121,0.00809852084867144,0.214876033057851
2010,18155,58,316,19,104,0,0,19,104,0.0149748020158387,0.182692307692308
2010,18157,464,2418,1670,2874,766,1074,2436,3948,0.0433388952314042,0.617021276595745
2010,18159,28,476,10,65,0,0,10,65,0.00581603435934145,0.153846153846154
2010,18161,11,122,6,66,0,0,6,66,0.0131631431990427,0.0909090909090909
2010,18163,896,2434,679,2178,28,192,707,2370,0.0201602613178176,0.29831223628692
2010,18165,61,387,9,94,6,10,15,104,0.00909488412767818,0.144230769230769
2010,18167,295,1317,240,1501,50,149,290,1650,0.0241379814795851,0.175757575757576
2010,18169,115,622,22,146,45,63,67,209,0.00942630344578748,0.320574162679426
2010,18171,16,299,0,51,0,0,0,51,0.00866462793068298,0
2010,18173,183,1189,195,715,37,89,232,804,0.0204892966360856,0.288557213930348
2010,18175,64,636,45,191,0,0,45,191,0.0102111734830259,0.235602094240838
2010,18177,103,838,329,1000,38,139,367,1139,0.0244022624046619,0.322212467076383
2010,18179,59,712,55,199,0,0,55,199,0.0107445602289293,0.276381909547739
2010,18181,138,558,70,142,0,15,70,157,0.00925871321578109,0.445859872611465
2010,18183,86,726,63,323,12,38,75,361,0.0162766581000045,0.207756232686981
2010,19001,28,102,28,58,0,0,28,58,0.0106500183621006,0.482758620689655
2010,19003,41,109,18,46,8,8,26,54,0.0178571428571429,0.481481481481481
2010,19005,19,254,28,126,18,68,46,194,0.0196177571038528,0.237113402061856
2010,19007,46,243,12,133,0,0,12,133,0.0146766718163761,0.0902255639097744
2010,19009,25,112,3,23,0,10,3,33,0.00747621205256004,0.0909090909090909
2010,19011,121,710,9,64,11,29,20,93,0.00528559249786871,0.21505376344086
2010,19013,323,1438,386,1290,228,312,614,1602,0.0199065559918485,0.383270911360799
2010,19015,244,626,60,243,0,13,60,256,0.0141859691898482,0.234375
2010,19017,125,493,61,174,6,11,67,185,0.0117587237017733,0.362162162162162
2010,19019,72,285,88,152,0,6,88,158,0.01152863918278,0.556962025316456
2010,19021,45,159,120,365,28,69,148,434,0.0346562325321409,0.341013824884793
2010,19023,46,301,54,99,0,0,54,99,0.00940796350850518,0.545454545454545
2010,19025,85,565,7,43,0,21,7,64,0.00873720136518771,0.109375
2010,19027,187,572,30,178,3,3,33,181,0.0127608573040045,0.18232044198895
2010,19029,47,248,22,156,0,7,22,163,0.0166241713411525,0.134969325153374
2010,19031,86,396,50,128,30,36,80,164,0.0128355639038898,0.48780487804878
2010,19033,231,718,144,481,0,20,144,501,0.0161712017042704,0.287425149700599
2010,19035,59,311,74,202,10,10,84,212,0.0243566176470588,0.39622641509434
2010,19037,5,218,7,62,0,10,7,72,0.00831120858824887,0.0972222222222222
2010,19039,5,197,12,37,0,33,12,70,0.0113378684807256,0.171428571428571
2010,19041,54,293,20,171,0,13,20,184,0.0158021298522844,0.108695652173913
2010,19043,57,310,19,244,3,6,22,250,0.0196664568911265,0.088
2010,19045,161,521,98,595,0,8,98,603,0.0180565952986974,0.162520729684909
2010,19047,13,152,26,60,0,34,26,94,0.00853614239011987,0.276595744680851
2010,19049,929,2113,679,1169,17,17,696,1186,0.0295642636354572,0.586846543001686
2010,19051,54,147,0,54,0,0,0,54,0.00974729241877256,0
2010,19053,5,69,23,114,0,6,23,120,0.0225098480585256,0.191666666666667
2010,19055,46,318,26,51,0,0,26,51,0.00422115543784142,0.509803921568627
2010,19057,126,490,148,644,0,6,148,650,0.0235208974127013,0.227692307692308
2010,19059,84,279,65,268,17,17,82,285,0.0229283990345937,0.287719298245614
2010,19061,159,587,478,1315,0,22,478,1337,0.0220896804678981,0.357516828721017
2010,19063,53,161,30,70,0,3,30,73,0.0103238580115967,0.410958904109589
2010,19065,75,482,66,333,0,18,66,351,0.0246436846170048,0.188034188034188
2010,19067,0,226,28,130,0,23,28,153,0.013595166163142,0.183006535947712
2010,19069,103,264,25,84,31,51,56,135,0.0181793697818476,0.414814814814815
2010,19071,35,117,34,105,0,27,34,132,0.0250094732853354,0.257575757575758
2010,19073,2,304,36,78,3,3,39,81,0.0122116689280868,0.481481481481481
2010,19075,71,260,0,25,0,8,0,33,0.00383275261324042,0
2010,19077,46,276,21,117,0,2,21,119,0.0152603231597846,0.176470588235294
2010,19079,50,316,7,168,0,10,7,178,0.0162809841763468,0.0393258426966292
2010,19081,34,256,29,95,0,4,29,99,0.0122813546706364,0.292929292929293
2010,19083,74,284,20,81,1,5,21,86,0.00711920529801325,0.244186046511628
2010,19085,15,121,29,135,0,21,29,156,0.0150260065497977,0.185897435897436
2010,19087,105,463,60,219,0,70,60,289,0.021431219873934,0.207612456747405
2010,19089,20,167,32,75,0,4,32,79,0.0121202822951826,0.40506329113924
2010,19091,43,200,7,74,0,2,7,76,0.0110835642409217,0.0921052631578947
2010,19093,16,108,36,63,2,7,38,70,0.0141214444220295,0.542857142857143
2010,19095,101,348,22,209,9,9,31,218,0.0192852087756546,0.142201834862385
2010,19097,30,203,15,59,5,16,20,75,0.00540657439446367,0.266666666666667
2010,19099,86,1251,119,369,13,13,132,382,0.014730266455867,0.345549738219895
2010,19101,42,199,185,444,249,279,434,723,0.0605071554104946,0.600276625172891
2010,19103,1043,2422,1800,2739,520,808,2320,3547,0.0485152712998044,0.65407386523823
2010,19105,121,734,114,167,0,7,114,174,0.0119645190125834,0.655172413793103
2010,19107,20,257,36,106,0,8,36,114,0.0155652648825778,0.315789473684211
2010,19109,29,240,26,118,11,11,37,129,0.0116184814914888,0.286821705426357
2010,19111,72,478,185,701,39,49,224,750,0.0300132058105566,0.298666666666667
2010,19113,777,2662,919,2362,190,498,1109,2860,0.0209915960218724,0.387762237762238
2010,19115,35,284,23,148,0,29,23,177,0.0230769230769231,0.129943502824859
2010,19117,0,156,0,87,19,32,19,119,0.0189944134078212,0.159663865546218
2010,19119,3,79,30,92,3,6,33,98,0.0128205128205128,0.336734693877551
2010,19121,53,412,4,25,0,61,4,86,0.00833333333333333,0.0465116279069767
2010,19123,67,376,18,142,0,14,18,156,0.0106317726436312,0.115384615384615
2010,19125,155,492,171,295,0,0,171,295,0.0136586720992685,0.579661016949153
2010,19127,171,582,171,474,0,66,171,540,0.0203481799683473,0.316666666666667
2010,19129,19,134,79,369,0,0,79,369,0.0356384006181186,0.214092140921409
2010,19131,88,172,22,96,0,0,22,96,0.0131093814010651,0.229166666666667
2010,19133,10,172,23,118,11,16,34,134,0.0200179265013445,0.253731343283582
2010,19135,0,135,21,56,0,0,21,56,0.0101302460202605,0.375
2010,19137,18,191,29,95,0,19,29,114,0.0149567042770926,0.254385964912281
2010,19139,152,609,104,381,45,52,149,433,0.0155364190886258,0.344110854503464
2010,19141,56,321,72,162,0,40,72,202,0.0202080832332933,0.356435643564356
2010,19143,3,113,2,53,0,0,2,53,0.0117908787541713,0.0377358490566038
2010,19145,41,742,32,327,3,3,35,330,0.0285813268664473,0.106060606060606
2010,19147,12,192,6,42,0,0,6,42,0.00643185298621746,0.142857142857143
2010,19149,87,336,24,194,10,28,34,222,0.0132902298850575,0.153153153153153
2010,19151,37,155,19,61,14,22,33,83,0.0153703703703704,0.397590361445783
2010,19153,2343,6523,2350,6087,352,1315,2702,7402,0.0270760631799194,0.365036476627938
2010,19155,195,813,377,2296,9,70,386,2366,0.0387824348025636,0.163144547759932
2010,19157,45,302,53,128,0,3,53,131,0.0105288538820125,0.404580152671756
2010,19159,14,104,34,53,0,0,34,53,0.0146692499308054,0.641509433962264
2010,19161,19,184,13,43,0,9,13,52,0.0069602462856378,0.25
2010,19163,527,1448,1531,3594,143,434,1674,4028,0.0375158333954251,0.415590863952334
2010,19165,13,243,37,166,7,10,44,176,0.0203280203280203,0.25
2010,19167,46,183,49,336,8,24,57,360,0.0182639135508092,0.158333333333333
2010,19169,413,1376,899,1558,297,420,1196,1978,0.0429514461912621,0.604651162790698
2010,19171,62,324,24,86,2,9,26,95,0.00784734842226995,0.273684210526316
2010,19173,2,104,5,86,0,4,5,90,0.0201342281879195,0.0555555555555556
2010,19175,59,187,7,241,0,0,7,241,0.0288795686039545,0.029045643153527
2010,19177,20,128,24,105,3,3,27,108,0.0201079873394154,0.25
2010,19179,22,561,56,320,24,53,80,373,0.0155877805173639,0.214477211796247
2010,19181,293,1271,162,416,37,57,199,473,0.0161831120843027,0.420718816067653
2010,19183,114,585,38,204,0,3,38,207,0.0140396093326099,0.183574879227053
2010,19185,15,123,16,61,0,2,16,63,0.0140249332146037,0.253968253968254
2010,19187,121,718,139,455,0,55,139,510,0.0201310491829162,0.272549019607843
2010,19189,6,76,24,180,5,5,29,185,0.0245455751625315,0.156756756756757
2010,19191,68,178,41,172,10,43,51,215,0.0163498098859316,0.237209302325581
2010,19193,203,1079,396,1653,55,115,451,1768,0.0277272442130356,0.255090497737557
2010,19195,16,118,9,20,0,2,9,22,0.00410677618069815,0.409090909090909
2010,19197,10,174,0,84,0,27,0,111,0.0119560534252477,0
2010,20001,124,261,24,143,0,0,24,143,0.0159526996876394,0.167832167832168
2010,20003,89,293,7,29,1,1,8,30,0.00548446069469835,0.266666666666667
2010,20005,17,128,40,173,0,0,40,173,0.016615443718786,0.23121387283237
2010,20007,16,91,23,93,0,2,23,95,0.0272988505747126,0.242105263157895
2010,20009,177,528,113,390,12,14,125,404,0.0222344523940561,0.309405940594059
2010,20011,51,198,40,117,9,29,49,146,0.0148358906615181,0.335616438356164
2010,20013,36,210,27,161,0,9,27,170,0.0251926496739775,0.158823529411765
2010,20015,389,1860,209,811,8,30,217,841,0.0203493999225707,0.258026159334126
2010,20017,20,62,0,16,0,0,0,16,0.00814663951120163,0
2010,20019,17,94,19,69,0,6,19,75,0.0277572168763879,0.253333333333333
2010,20021,0,182,154,609,0,4,154,613,0.042084305917891,0.251223491027732
2010,20023,3,18,10,41,0,0,10,41,0.0203272186415469,0.24390243902439
2010,20025,5,50,0,35,0,0,0,35,0.0224791265253693,0
2010,20027,22,136,0,61,0,43,0,104,0.0173304449258457,0
2010,20029,23,206,13,108,0,11,13,119,0.0185792349726776,0.109243697478992
2010,20031,28,277,25,129,0,0,25,129,0.0218015886428934,0.193798449612403
2010,20033,6,10,0,6,0,7,0,13,0.00940665701881331,0
2010,20035,106,1070,89,634,0,9,89,643,0.0274915558595921,0.138413685847589
2010,20037,78,305,197,516,41,48,238,564,0.0240511727078891,0.421985815602837
2010,20039,0,28,21,118,0,0,21,118,0.0495382031905961,0.177966101694915
2010,20041,162,399,32,401,0,39,32,440,0.0329489291598023,0.0727272727272727
2010,20043,17,52,37,266,0,24,37,290,0.0560494781600309,0.127586206896552
2010,20045,683,2013,941,1637,351,471,1292,2108,0.0352243295179213,0.612903225806452
2010,20047,36,77,5,21,2,6,7,27,0.0122560145256468,0.259259259259259
2010,20049,81,212,6,36,0,0,6,36,0.016491067338525,0.166666666666667
2010,20051,126,627,225,559,0,0,225,559,0.0335393292134157,0.402504472271914
2010,20053,45,340,3,44,0,0,3,44,0.0094017094017094,0.0681818181818182
2010,20055,108,577,80,411,20,58,100,469,0.0228201634877384,0.213219616204691
2010,20057,144,452,159,696,0,18,159,714,0.0371236936515364,0.222689075630252
2010,20059,152,626,35,364,15,52,50,416,0.0249101796407186,0.120192307692308
2010,20061,103,434,383,1610,142,434,525,2044,0.117904937701892,0.256849315068493
2010,20063,2,48,2,30,0,0,2,30,0.014985014985015,0.0666666666666667
2010,20065,0,40,29,99,0,11,29,110,0.0558943089430894,0.263636363636364
2010,20067,74,108,0,55,0,0,0,55,0.0117120954003407,0
2010,20069,41,193,78,147,0,4,78,151,0.0418514412416851,0.516556291390728
2010,20071,7,18,0,6,0,0,0,6,0.00710900473933649,0
2010,20073,0,160,3,31,0,3,3,34,0.00700164744645799,0.0882352941176471
2010,20075,13,36,16,64,0,9,16,73,0.0445665445665446,0.219178082191781
2010,20077,11,72,2,93,0,0,2,93,0.0221534063839924,0.021505376344086
2010,20079,206,788,97,299,10,48,107,347,0.0155759044797558,0.30835734870317
2010,20081,10,115,0,19,4,21,4,40,0.0160513643659711,0.1
2010,20083,27,46,6,43,0,0,6,43,0.0324528301886792,0.13953488372093
2010,20085,62,352,0,102,0,0,0,102,0.0116186353798838,0
2010,20087,215,452,31,126,0,24,31,150,0.0115589119210912,0.206666666666667
2010,20089,18,44,3,31,0,2,3,33,0.0137214137214137,0.0909090909090909
2010,20091,2287,5721,7668,14598,837,1981,8505,16579,0.0471942224866422,0.512998371433741
2010,20093,11,82,0,82,0,6,0,88,0.0372093023255814,0
2010,20095,44,80,8,11,0,0,8,11,0.00198341146772449,0.727272727272727
2010,20097,0,34,12,75,0,0,12,75,0.0424448217317487,0.16
2010,20099,92,407,60,372,0,15,60,387,0.0267449896337249,0.155038759689922
2010,20101,0,2,2,40,0,0,2,40,0.0317712470214456,0.05
2010,20103,544,2318,1509,3826,608,924,2117,4750,0.0956793231946822,0.445684210526316
2010,20105,9,68,0,22,0,4,0,26,0.011068539804172,0
2010,20107,4,61,13,135,0,0,13,135,0.0196163905841325,0.0962962962962963
2010,20109,16,35,2,45,0,0,2,45,0.0227272727272727,0.0444444444444444
2010,20111,94,669,82,526,43,82,125,608,0.02958349552355,0.205592105263158
2010,20113,41,297,46,383,0,33,46,416,0.0212060967528164,0.110576923076923
2010,20115,31,337,64,100,0,0,64,100,0.0116319646388275,0.64
2010,20117,6,114,23,71,0,8,23,79,0.0110396869759642,0.291139240506329
2010,20119,36,95,2,39,2,4,4,43,0.014977359804946,0.0930232558139535
2010,20121,232,971,46,324,0,0,46,324,0.0152420379169215,0.141975308641975
2010,20123,56,90,49,101,0,1,49,102,0.0226666666666667,0.480392156862745
2010,20125,129,635,191,1013,0,18,191,1031,0.0436014547915081,0.185257032007759
2010,20127,5,132,11,71,6,13,17,84,0.0198910726971347,0.202380952380952
2010,20129,5,33,6,118,12,12,18,130,0.0621712099473936,0.138461538461538
2010,20131,43,187,61,99,0,0,61,99,0.0142774733198731,0.616161616161616
2010,20133,52,303,0,110,0,110,0,220,0.0206166244962984,0
2010,20135,13,68,0,34,0,4,0,38,0.0166011358671909,0
2010,20137,38,374,3,124,21,22,24,146,0.034638196915777,0.164383561643836
2010,20139,12,425,6,75,39,56,45,131,0.0117372995251322,0.343511450381679
2010,20141,41,96,7,67,0,0,7,67,0.0237841675541356,0.104477611940299
2010,20143,7,148,13,51,0,0,13,51,0.0121082621082621,0.254901960784314
2010,20145,24,498,0,63,0,19,0,82,0.0167312793307488,0
2010,20147,14,28,7,59,0,0,7,59,0.0150127226463104,0.11864406779661
2010,20149,183,569,61,175,0,0,61,175,0.013284749108024,0.348571428571429
2010,20151,52,398,31,109,8,19,39,128,0.0199159794616462,0.3046875
2010,20153,16,35,9,28,0,0,9,28,0.0144329896907217,0.321428571428571
2010,20155,281,1666,147,599,20,57,167,656,0.0152565235592353,0.254573170731707
2010,20157,2,74,4,78,0,0,4,78,0.0203814998693494,0.0512820512820513
2010,20159,10,298,63,214,0,12,63,226,0.0340310194247854,0.278761061946903
2010,20161,437,963,667,1918,336,684,1003,2602,0.0796205630354957,0.385472713297463
2010,20163,25,107,23,31,1,4,24,35,0.00960746637386769,0.685714285714286
2010,20165,28,93,3,26,0,0,3,26,0.0106209150326797,0.115384615384615
2010,20167,85,237,5,89,0,2,5,91,0.018048393494645,0.0549450549450549
2010,20169,131,979,251,719,0,11,251,730,0.0201947548965365,0.343835616438356
2010,20171,0,0,0,63,0,0,0,63,0.0189018901890189,0
2010,20173,1485,4929,2144,6788,503,1209,2647,7997,0.0260742547301769,0.330999124671752
2010,20175,24,224,168,853,15,27,183,880,0.0696312707706916,0.207954545454545
2010,20177,538,2697,773,2815,114,333,887,3148,0.0269931916791,0.281766200762389
2010,20179,19,53,0,30,0,0,0,30,0.0165929203539823,0
2010,20181,0,38,0,173,0,0,0,173,0.0398433901427913,0
2010,20183,24,105,6,47,0,4,6,51,0.0167213114754098,0.117647058823529
2010,20185,36,136,17,26,0,0,17,26,0.00842787682333874,0.653846153846154
2010,20187,0,119,0,14,5,5,5,19,0.0129339686861811,0.263157894736842
2010,20189,7,142,13,150,0,2,13,152,0.0420586607636967,0.0855263157894737
2010,20191,111,741,33,227,3,3,36,230,0.0144726906619683,0.156521739130435
2010,20193,39,269,15,72,16,16,31,88,0.0180217079664141,0.352272727272727
2010,20195,0,30,16,16,8,8,24,24,0.0108597285067873,1
2010,20197,32,116,12,42,0,2,12,44,0.00927878532264867,0.272727272727273
2010,20199,0,32,3,9,0,0,3,9,0.00867888138862102,0.333333333333333
2010,20201,19,57,2,23,0,6,2,29,0.00689491203043271,0.0689655172413793
2010,20203,0,23,22,71,0,0,22,71,0.0465879265091864,0.309859154929577
2010,20205,17,258,0,61,0,0,0,61,0.009288868585351,0
2010,20207,0,58,7,52,0,3,7,55,0.0223850223850224,0.127272727272727
2010,20209,591,2377,542,3338,108,548,650,3886,0.040301587795443,0.167267112712301
2010,21001,112,477,16,312,0,8,16,320,0.0261694471704285,0.05
2010,21003,13,356,18,324,0,0,18,324,0.0246537817683762,0.0555555555555556
2010,21005,84,759,15,47,0,0,15,47,0.00332014693416219,0.319148936170213
2010,21007,0,159,26,97,0,0,26,97,0.0167501295113107,0.268041237113402
2010,21009,60,405,68,332,12,73,80,405,0.0141990674192757,0.197530864197531
2010,21011,38,299,0,42,0,0,0,42,0.00534963698891861,0
2010,21013,21,299,52,407,0,12,52,419,0.0212517752079529,0.124105011933174
2010,21015,749,3180,1006,2197,159,367,1165,2564,0.0349652256920769,0.454368174726989
2010,21017,42,482,31,163,0,99,31,262,0.0191969519343494,0.118320610687023
2010,21019,103,801,197,1206,9,56,206,1262,0.0360396378901676,0.163232963549921
2010,21021,178,1252,127,537,34,40,161,577,0.0303956171311173,0.279029462738302
2010,21023,5,173,13,42,0,25,13,67,0.0119429590017825,0.194029850746269
2010,21025,0,299,0,14,0,0,0,14,0.00143604472253564,0
2010,21027,49,678,33,166,0,11,33,177,0.0130530973451327,0.186440677966102
2010,21029,160,1593,170,674,44,50,214,724,0.0150569836120123,0.295580110497238
2010,21031,14,224,6,94,0,81,6,175,0.019945292910873,0.0342857142857143
2010,21033,0,127,0,46,0,14,0,60,0.00658616904500549,0
2010,21035,104,432,367,646,51,162,418,808,0.0361569785653555,0.517326732673267
2010,21037,349,1398,508,1580,44,78,552,1658,0.0283312258637777,0.332931242460796
2010,21039,0,63,3,14,0,0,3,14,0.00388672959466963,0.214285714285714
2010,21041,0,343,37,389,0,2,37,391,0.0553589126433527,0.0946291560102302
2010,21043,25,148,19,230,0,10,19,240,0.0128321659626798,0.0791666666666667
2010,21045,52,392,39,98,0,0,39,98,0.00898093841642229,0.397959183673469
2010,21047,136,754,451,2634,90,1123,541,3757,0.0903928975290523,0.143997870641469
2010,21049,197,927,236,602,0,11,236,613,0.025265847827879,0.384991843393148
2010,21051,0,118,0,290,0,0,0,290,0.0192703834141803,0
2010,21053,0,102,0,90,0,18,0,108,0.0155731795241528,0
2010,21055,0,105,0,23,0,0,0,23,0.00360840916222152,0
2010,21057,0,32,0,49,0,0,0,49,0.010233918128655,0
2010,21059,134,1768,240,752,0,20,240,772,0.0121624602199326,0.310880829015544
2010,21061,57,414,0,54,0,18,0,72,0.00875592849325064,0
2010,21063,67,466,0,0,0,0,0,0,0,NA
2010,21065,10,211,3,21,0,0,3,21,0.00204998047637642,0.142857142857143
2010,21067,1333,6269,3024,5991,701,1636,3725,7627,0.0411447375519232,0.488396486167563
2010,21069,17,37,10,206,0,50,10,256,0.0266029304790606,0.0390625
2010,21071,74,1040,15,527,20,20,35,547,0.0198245868367643,0.0639853747714808
2010,21073,384,1420,214,507,77,116,291,623,0.0185864733434768,0.467094703049759
2010,21075,10,136,28,173,0,16,28,189,0.0386345053147997,0.148148148148148
2010,21077,22,353,54,89,0,10,54,99,0.0181818181818182,0.545454545454545
2010,21079,10,527,0,81,0,35,0,116,0.00972827910097283,0
2010,21081,207,887,53,197,0,34,53,231,0.0148219441770934,0.229437229437229
2010,21083,43,529,28,291,0,49,28,340,0.0135328769304251,0.0823529411764706
2010,21085,56,346,0,311,5,27,5,338,0.0196591636130984,0.014792899408284
2010,21087,19,175,0,79,0,8,0,87,0.0108465278643561,0
2010,21089,39,511,68,433,0,29,68,462,0.0179028132992327,0.147186147186147
2010,21091,5,165,0,125,0,8,0,133,0.0233006306937631,0
2010,21093,253,1489,879,3215,308,894,1187,4109,0.0636028728871277,0.288878072523728
2010,21095,7,299,19,122,0,0,19,122,0.00600955617949855,0.155737704918033
2010,21097,48,520,32,67,0,3,32,70,0.00547302580140735,0.457142857142857
2010,21099,65,460,26,146,0,6,26,152,0.0124682142564187,0.171052631578947
2010,21101,74,611,112,549,0,11,112,560,0.0178782364396769,0.2
2010,21103,43,434,0,63,14,66,14,129,0.0122962539319417,0.108527131782946
2010,21105,30,183,3,41,0,0,3,41,0.0114878117119641,0.0731707317073171
2010,21107,48,752,69,520,0,43,69,563,0.0174152437515466,0.122557726465364
2010,21109,52,333,0,142,0,0,0,142,0.0153596538669551,0
2010,21111,1768,7108,4831,12883,796,2461,5627,15344,0.0311179252553276,0.36672314911366
2010,21113,567,1780,330,666,55,64,385,730,0.0242726517040731,0.527397260273973
2010,21115,25,254,35,178,0,8,35,186,0.0115592567273631,0.188172043010753
2010,21117,925,3703,1249,3151,106,227,1355,3378,0.0323885863312112,0.401124925991711
2010,21119,26,342,31,89,0,0,31,89,0.00787680325692539,0.348314606741573
2010,21121,30,696,19,234,0,36,19,270,0.0129483982351813,0.0703703703703704
2010,21123,54,271,10,158,0,49,10,207,0.0214752567693744,0.0483091787439614
2010,21125,398,1197,107,769,0,9,107,778,0.0199267474323182,0.137532133676093
2010,21127,38,269,6,242,0,32,6,274,0.0255740153070749,0.0218978102189781
2010,21129,45,237,0,178,0,0,0,178,0.0316444444444444,0
2010,21131,64,186,2,65,0,0,2,65,0.00828025477707006,0.0307692307692308
2010,21133,42,410,5,181,0,12,5,193,0.0113236329500117,0.0259067357512953
2010,21135,50,209,41,158,0,34,41,192,0.0199667221297837,0.213541666666667
2010,21137,164,631,0,28,0,33,0,61,0.00367204430532145,0
2010,21139,48,214,24,134,0,19,24,153,0.0223716917678023,0.156862745098039
2010,21141,30,414,32,658,0,86,32,744,0.040655737704918,0.043010752688172
2010,21143,22,643,12,46,0,0,12,46,0.00704225352112676,0.260869565217391
2010,21145,167,1533,435,1791,0,48,435,1839,0.0403413328653534,0.236541598694943
2010,21147,52,208,22,368,0,9,22,377,0.0315270112058873,0.0583554376657825
2010,21149,0,115,49,114,0,0,49,114,0.017449869891321,0.429824561403509
2010,21151,405,1517,326,1066,17,180,343,1246,0.0249494403396007,0.275280898876405
2010,21153,6,163,26,118,0,0,26,118,0.0138367729831144,0.220338983050847
2010,21155,35,958,7,80,0,5,7,85,0.00647125999238675,0.0823529411764706
2010,21157,140,530,108,528,0,12,108,540,0.0240331122880413,0.2
2010,21159,0,228,47,352,0,0,47,352,0.0385753424657534,0.133522727272727
2010,21161,40,377,24,359,12,12,36,371,0.031547619047619,0.0970350404312668
2010,21163,153,1060,132,849,127,213,259,1062,0.057925166357587,0.243879472693032
2010,21165,15,111,0,20,0,0,0,20,0.00435634937922021,0
2010,21167,149,845,26,164,0,5,26,169,0.011482538388368,0.153846153846154
2010,21169,24,291,5,32,0,1,5,33,0.00477845351867941,0.151515151515152
2010,21171,77,188,9,65,19,19,28,84,0.0110569961827037,0.333333333333333
2010,21173,47,465,25,291,17,42,42,333,0.0190372741824834,0.126126126126126
2010,21175,30,465,144,225,0,0,144,225,0.0226814516129032,0.64
2010,21177,13,816,14,148,0,26,14,174,0.00788972521991476,0.0804597701149425
2010,21179,206,880,104,519,28,28,132,547,0.0194364495611697,0.241316270566728
2010,21181,39,160,41,110,0,0,41,110,0.0222267124671651,0.372727272727273
2010,21183,25,470,50,202,8,8,58,210,0.0130548302872063,0.276190476190476
2010,21185,384,2466,339,762,74,160,413,922,0.0238039914284977,0.447939262472885
2010,21187,5,204,28,135,33,49,61,184,0.0248648648648649,0.331521739130435
2010,21189,0,103,14,55,0,0,14,55,0.0168556543058535,0.254545454545455
2010,21191,11,301,29,295,0,8,29,303,0.0310419014445241,0.0957095709570957
2010,21193,29,287,0,173,0,6,0,179,0.00904131730477826,0
2010,21195,62,627,240,915,0,32,240,947,0.0208383760589724,0.253431890179514
2010,21197,40,168,0,174,0,0,0,174,0.0204754059778771,0
2010,21199,139,767,109,680,0,59,109,739,0.0170989611050695,0.147496617050068
2010,21201,0,61,0,0,0,0,0,0,0,NA
2010,21203,107,324,16,109,0,26,16,135,0.0115800308800823,0.118518518518519
2010,21205,155,469,26,377,0,0,26,377,0.028090306236495,0.0689655172413793
2010,21207,36,207,0,136,0,0,0,136,0.0111786947229985,0
2010,21209,544,2291,159,513,25,25,184,538,0.0187534857780257,0.342007434944238
2010,21211,388,1578,140,358,0,69,140,427,0.015662827378769,0.327868852459016
2010,21213,22,395,73,563,0,11,73,574,0.0498956884561891,0.127177700348432
2010,21215,72,420,88,138,0,0,88,138,0.0124436429215509,0.63768115942029
2010,21217,57,394,25,286,10,48,35,334,0.0209181436713221,0.104790419161677
2010,21219,11,152,32,173,0,59,32,232,0.0296523517382413,0.137931034482759
2010,21221,55,371,148,338,0,0,148,338,0.0337022634360355,0.437869822485207
2010,21223,41,196,11,241,0,0,11,241,0.0403010033444816,0.045643153526971
2010,21225,0,109,0,89,0,0,0,89,0.00931644509578143,0
2010,21227,290,1545,576,1639,76,164,652,1803,0.0270810177536123,0.361619523017194
2010,21229,19,267,9,48,0,0,9,48,0.00627943485086342,0.1875
2010,21231,81,359,0,297,0,0,0,297,0.0207750419697818,0
2010,21233,2,271,0,173,12,12,12,185,0.0196913251729643,0.0648648648648649
2010,21235,36,771,97,652,0,37,97,689,0.0296051218149787,0.140783744557329
2010,21237,0,89,0,0,0,0,0,0,0,NA
2010,21239,225,664,115,320,0,23,115,343,0.0204410011918951,0.335276967930029
2010,22001,94,977,73,397,32,94,105,491,0.012735714470988,0.213849287169043
2010,22003,45,1048,36,477,4,45,40,522,0.0296962111730572,0.0766283524904215
2010,22005,905,2737,446,1583,7,100,453,1683,0.0261258324407395,0.269162210338681
2010,22007,10,512,0,22,0,8,0,30,0.00194162190149505,0
2010,22009,116,1439,78,291,0,97,78,388,0.0139003331780891,0.201030927835052
2010,22011,25,985,137,895,55,131,192,1026,0.0450197455024133,0.187134502923977
2010,22013,17,328,0,141,0,0,0,141,0.0144201268152997,0
2010,22015,672,2792,783,2752,93,353,876,3105,0.0426089581732353,0.282125603864734
2010,22017,1207,4510,1086,3454,46,523,1132,3977,0.0241635123065613,0.284636660799598
2010,22019,540,2741,596,2863,156,353,752,3216,0.0264582476347182,0.233830845771144
2010,22021,53,289,17,91,0,0,17,91,0.0133177228157471,0.186813186813187
2010,22023,40,276,20,100,0,20,20,120,0.0244100895036615,0.166666666666667
2010,22025,16,620,14,177,0,17,14,194,0.0275060258046221,0.0721649484536082
2010,22027,45,314,14,141,15,15,29,156,0.0130729908656666,0.185897435897436
2010,22029,50,562,96,461,0,0,96,461,0.0345629029839556,0.20824295010846
2010,22031,20,415,31,202,0,50,31,252,0.0144090571216193,0.123015873015873
2010,22033,2219,8492,2166,4962,607,920,2773,5882,0.0220184997323491,0.471438286297178
2010,22035,71,748,0,8,0,34,0,42,0.00805523590333717,0
2010,22037,127,949,12,63,18,18,30,81,0.00577993435136292,0.37037037037037
2010,22039,113,788,31,497,7,166,38,663,0.0305713100013833,0.057315233785822
2010,22041,28,597,49,251,0,11,49,262,0.0192166642217984,0.187022900763359
2010,22043,68,677,32,513,17,68,49,581,0.0398655139289145,0.0843373493975904
2010,22045,119,978,98,532,21,105,119,637,0.013819586063262,0.186813186813187
2010,22047,83,2220,44,516,0,11,44,527,0.0235973671248825,0.0834914611005693
2010,22049,32,192,0,231,0,0,0,231,0.0213454075032342,0
2010,22051,2763,11418,1621,6783,352,1041,1973,7824,0.0266351656357342,0.252172801635992
2010,22053,76,621,55,294,12,53,67,347,0.0171535913787137,0.193083573487032
2010,22055,1414,4345,667,2042,130,497,797,2539,0.0187304046328059,0.313903111461205
2010,22057,344,1834,64,349,0,88,64,437,0.00708311721991701,0.146453089244851
2010,22059,22,377,8,105,0,36,8,141,0.0143877551020408,0.0567375886524823
2010,22061,364,1023,269,762,62,129,331,891,0.0356029729081755,0.371492704826038
2010,22063,545,2935,201,918,66,93,267,1011,0.0130295258592914,0.264094955489614
2010,22065,24,1090,35,127,0,0,35,127,0.0161208428535161,0.275590551181102
2010,22067,58,308,35,205,0,19,35,224,0.0118706942236354,0.15625
2010,22069,164,708,88,334,20,44,108,378,0.0162050930292378,0.285714285714286
2010,22071,2697,9413,3944,11472,411,876,4355,12348,0.0633169075833637,0.352688694525429
2010,22073,345,1919,389,1371,32,78,421,1449,0.0152159531235233,0.290545203588682
2010,22075,158,719,60,528,51,51,111,579,0.0401860077734592,0.191709844559585
2010,22077,97,359,11,101,0,116,11,217,0.0140198992117845,0.0506912442396313
2010,22079,621,2938,414,1232,74,216,488,1448,0.0170807087078585,0.337016574585635
2010,22081,10,107,9,50,0,0,9,50,0.00841467519353753,0.18
2010,22083,88,1110,28,160,9,20,37,180,0.0132294575922387,0.205555555555556
2010,22085,39,264,14,181,2,22,16,203,0.0126079125520154,0.0788177339901478
2010,22087,116,1250,73,484,0,114,73,598,0.0335992808180694,0.122073578595318
2010,22089,103,868,87,314,42,81,129,395,0.0117273321061695,0.326582278481013
2010,22091,15,272,18,111,0,0,18,111,0.0153314917127072,0.162162162162162
2010,22093,50,227,60,124,9,9,69,133,0.00935499753815854,0.518796992481203
2010,22095,267,1533,66,321,0,28,66,349,0.0120121153713774,0.189111747851003
2010,22097,95,1167,48,294,18,75,66,369,0.00688471369666213,0.178861788617886
2010,22099,27,1627,21,290,0,94,21,384,0.0115770749796497,0.0546875
2010,22101,123,764,40,357,7,297,47,654,0.0186102100051221,0.0718654434250764
2010,22103,1371,4707,1171,4021,201,342,1372,4363,0.0285716156747695,0.31446252578501
2010,22105,295,2192,344,1143,37,125,381,1268,0.0173363776814646,0.300473186119874
2010,22107,13,267,4,37,0,0,4,37,0.0100135317997294,0.108108108108108
2010,22109,316,1325,222,1035,0,0,222,1035,0.014682933749468,0.214492753623188
2010,22111,15,233,28,137,0,0,28,137,0.00889033095392602,0.204379562043796
2010,22113,142,1026,40,151,16,51,56,202,0.00548525498289252,0.277227722772277
2010,22115,104,627,642,2123,143,480,785,2603,0.0877317155375801,0.30157510564733
2010,22117,48,774,66,634,0,0,66,634,0.0205610507540133,0.10410094637224
2010,22119,42,829,23,491,0,15,23,506,0.0182381776239908,0.0454545454545455
2010,22121,90,939,21,168,16,47,37,215,0.0143266475644699,0.172093023255814
2010,22123,0,363,10,390,0,14,10,404,0.0526864893062076,0.0247524752475248
2010,22125,38,393,10,92,0,32,10,124,0.010554988083078,0.0806451612903226
2010,22127,55,599,20,155,0,0,20,155,0.0145158269338827,0.129032258064516
2010,23001,414,2138,279,1030,44,113,323,1143,0.0156179544988727,0.282589676290464
2010,23003,84,535,149,709,13,72,162,781,0.0150807136788445,0.207426376440461
2010,23005,1433,4595,3042,5674,182,505,3224,6179,0.0317898852703607,0.521767276258294
2010,23007,129,407,115,318,6,17,121,335,0.016088752281241,0.361194029850746
2010,23009,210,620,325,670,24,44,349,714,0.0180371352785146,0.488795518207283
2010,23011,444,2091,228,1038,175,279,403,1317,0.0155061577224669,0.305998481397115
2010,23013,113,901,365,778,0,4,365,782,0.0265246591140357,0.466751918158568
2010,23015,134,559,213,393,36,57,249,450,0.0174303753340822,0.553333333333333
2010,23017,202,1080,125,832,9,37,134,869,0.0211687900416555,0.154200230149597
2010,23019,428,2080,637,1630,98,176,735,1806,0.0176537863754998,0.406976744186047
2010,23021,66,299,30,217,8,20,38,237,0.0181428462068438,0.160337552742616
2010,23023,324,1355,252,512,0,33,252,545,0.0214094908862351,0.462385321100917
2010,23025,138,792,145,570,5,8,150,578,0.0155572901246198,0.259515570934256
2010,23027,243,883,225,468,8,20,233,488,0.0178011235135332,0.477459016393443
2010,23029,50,449,135,431,0,18,135,449,0.0187481732013863,0.300668151447661
2010,23031,437,2395,1012,3544,78,150,1090,3694,0.0265887382945491,0.295073091499729
2010,24001,90,1107,97,1234,0,41,97,1275,0.0248189675309507,0.076078431372549
2010,24003,3923,11794,4594,9398,1071,2310,5665,11708,0.0329665378940611,0.48385719166382
2010,24005,5493,18208,5069,8624,1486,2981,6555,11605,0.0214243253322109,0.56484274019819
2010,24009,312,1349,351,1281,32,101,383,1382,0.0241380514898522,0.277134587554269
2010,24011,59,592,23,290,7,43,30,333,0.0154431201595325,0.0900900900900901
2010,24013,1129,3013,603,1211,75,132,678,1343,0.0121267393247673,0.504839910647803
2010,24015,236,1253,617,2169,3,84,620,2253,0.0342245176970986,0.275188637372392
2010,24017,589,2801,764,2585,210,319,974,2904,0.0313600138225956,0.335399449035813
2010,24019,93,509,76,238,18,46,94,284,0.0125011004489832,0.330985915492958
2010,24021,1165,3976,1580,3522,255,790,1835,4312,0.0285716178877411,0.425556586270872
2010,24023,94,178,138,455,0,5,138,460,0.0220179973195482,0.3
2010,24025,1526,3865,904,2215,249,972,1153,3187,0.0197347237014837,0.361782240351428
2010,24027,3851,7364,3440,5143,923,1418,4363,6561,0.0354466625246495,0.664990092973632
2010,24029,108,488,215,354,11,57,226,411,0.0295470884255931,0.549878345498783
2010,24031,3975,9837,15820,22934,5111,9325,20931,32259,0.0500279147669117,0.648842183576676
2010,24033,3222,9490,5516,18509,1513,3950,7029,22459,0.0410162099772812,0.312970301438176
2010,24035,261,1188,132,448,15,40,147,488,0.0151760169175271,0.301229508196721
2010,24037,342,1504,864,2349,140,473,1004,2822,0.0435480386407827,0.355776045357902
2010,24039,34,1381,148,279,13,25,161,304,0.018021222360543,0.529605263157895
2010,24041,247,797,250,470,60,60,310,530,0.0193212059348912,0.584905660377358
2010,24043,319,2773,623,2415,91,340,714,2755,0.0274988521350288,0.259165154264973
2010,24045,196,1375,391,1581,233,390,624,1971,0.0322253650082566,0.316590563165906
2010,24047,258,1257,172,526,0,25,172,551,0.0144286163192626,0.312159709618875
2010,24510,3595,10932,5074,7994,1477,2648,6551,10642,0.0262418133038744,0.615579778237173
2010,25001,1181,2540,1315,2512,144,502,1459,3014,0.0183610312393391,0.484074319840743
2010,25003,250,752,801,1717,134,281,935,1998,0.0214750961972527,0.467967967967968
2010,25005,1394,6245,2066,5314,363,1249,2429,6563,0.0177222231223301,0.370105134846869
2010,25007,94,191,143,152,0,56,143,208,0.0184103381129403,0.6875
2010,25009,3425,7949,3915,7748,855,2316,4770,10064,0.0201958986111306,0.473966613672496
2010,25011,416,1300,384,849,54,186,438,1035,0.0202678886147339,0.423188405797101
2010,25013,954,3502,1405,4657,359,1929,1764,6586,0.0217448006946714,0.267840874582448
2010,25015,1137,3286,855,1509,497,678,1352,2187,0.0227776909857835,0.618198445358939
2010,25017,14155,25566,15032,21024,7181,11055,22213,32079,0.0314782996085697,0.692446772031547
2010,25019,44,92,46,145,0,56,46,201,0.0275229357798165,0.228855721393035
2010,25021,9263,16946,4871,7007,2231,3416,7102,10423,0.0228498896198846,0.681377722344814
2010,25023,2933,9702,1343,2798,261,867,1604,3665,0.0111012836900485,0.437653478854025
2010,25025,9152,18281,8888,12265,3417,6358,12305,18623,0.0409555038012988,0.66074209311067
2010,25027,3611,8974,3246,6772,1310,2493,4556,9265,0.0175508387084553,0.491743119266055
2010,26001,42,297,9,49,0,4,9,53,0.00593505039193729,0.169811320754717
2010,26003,66,599,8,65,0,10,8,75,0.0101722501017225,0.106666666666667
2010,26005,415,2513,136,617,19,49,155,666,0.00912278779244973,0.232732732732733
2010,26007,83,467,60,308,12,63,72,371,0.017394158188382,0.194070080862534
2010,26009,105,595,42,142,25,55,67,197,0.0113479262672811,0.34010152284264
2010,26011,67,599,9,71,0,17,9,88,0.00729201193238316,0.102272727272727
2010,26013,13,389,0,8,0,11,0,19,0.00292352669641483,0
2010,26015,228,989,36,224,33,71,69,295,0.00734616629728316,0.233898305084746
2010,26017,324,1789,36,452,85,106,121,558,0.00748370483624366,0.216845878136201
2010,26019,100,357,68,125,2,12,70,137,0.0107619795758052,0.510948905109489
2010,26021,282,1231,784,1846,116,289,900,2135,0.0200701279411903,0.421545667447307
2010,26023,155,1756,84,368,9,17,93,385,0.0122967836724265,0.241558441558442
2010,26025,442,2400,338,1151,100,368,438,1519,0.0167176597477493,0.288347597103357
2010,26027,73,635,118,851,6,39,124,890,0.0246557885696872,0.139325842696629
2010,26029,115,573,37,163,7,15,44,178,0.00959517007169425,0.247191011235955
2010,26031,100,642,40,137,5,26,45,163,0.00845216489499611,0.276073619631902
2010,26033,146,1714,60,381,0,10,60,391,0.0145035053228977,0.153452685421995
2010,26035,79,883,17,127,5,25,22,152,0.0068962388276394,0.144736842105263
2010,26037,547,1574,187,457,9,49,196,506,0.010543423903984,0.387351778656126
2010,26039,66,684,0,31,0,2,0,33,0.00316972433003554,0
2010,26041,105,456,52,374,22,51,74,425,0.0159492625811536,0.174117647058824
2010,26043,47,351,120,413,0,17,120,430,0.0227657772130453,0.27906976744186
2010,26045,671,3415,435,836,77,175,512,1011,0.0139760568442589,0.506429277942631
2010,26047,237,823,128,298,16,56,144,354,0.0156174173909207,0.406779661016949
2010,26049,960,5758,461,1988,212,503,673,2491,0.00877372180504093,0.270172621437174
2010,26051,104,766,26,101,6,22,32,123,0.00650724791027405,0.260162601626016
2010,26053,30,355,54,314,50,50,104,364,0.0295454545454545,0.285714285714286
2010,26055,613,2807,248,751,31,47,279,798,0.0134135682108519,0.349624060150376
2010,26057,178,1593,29,133,19,42,48,175,0.0062426425997931,0.274285714285714
2010,26059,76,724,91,382,15,120,106,502,0.0161945931995613,0.211155378486056
2010,26061,170,678,155,404,168,227,323,631,0.0296829428920877,0.51188589540412
2010,26063,101,569,44,82,0,6,44,88,0.00362497940352612,0.5
2010,26065,1488,5076,1644,2628,1089,1751,2733,4379,0.0264408417111977,0.624115094770496
2010,26067,215,2824,48,341,19,85,67,426,0.0100673520028359,0.157276995305164
2010,26069,40,891,42,182,33,33,75,215,0.0108377860671439,0.348837209302326
2010,26071,4,140,31,166,0,6,31,172,0.0186006272304531,0.180232558139535
2010,26073,305,1434,173,434,84,138,257,572,0.0164500172552629,0.449300699300699
2010,26075,489,4624,294,1074,43,150,337,1224,0.0112839139693749,0.275326797385621
2010,26077,1338,3890,779,1840,274,467,1053,2307,0.0151637647151618,0.456436931079324
2010,26079,96,457,13,98,0,6,13,104,0.008559670781893,0.125
2010,26081,2338,8617,1890,4649,465,1338,2355,5987,0.0159050637451152,0.393352263237014
2010,26083,14,69,8,29,0,0,8,29,0.0183660544648512,0.275862068965517
2010,26085,18,538,0,74,0,0,0,74,0.00885167464114833,0
2010,26087,340,1944,116,510,0,67,116,577,0.00958567299066352,0.20103986135182
2010,26089,224,490,108,191,3,7,111,198,0.012349529096239,0.560606060606061
2010,26091,259,1735,409,1003,22,385,431,1388,0.020587362800356,0.310518731988473
2010,26093,1365,4151,285,971,67,218,352,1189,0.00984141173354523,0.296047098402018
2010,26095,27,462,24,47,0,4,24,51,0.0100730792020541,0.470588235294118
2010,26097,34,209,36,147,9,9,45,156,0.0184921763869132,0.288461538461538
2010,26099,3083,15745,754,3025,733,2485,1487,5510,0.00961300250182315,0.269872958257713
2010,26101,119,1062,74,148,16,40,90,188,0.0102844638949672,0.478723404255319
2010,26103,137,1070,188,421,46,184,234,605,0.0138055359058029,0.386776859504132
2010,26105,141,523,122,298,3,11,125,309,0.0152404438964242,0.40453074433657
2010,26107,192,1234,26,133,9,64,35,197,0.00784766760944907,0.177664974619289
2010,26109,45,200,96,285,0,6,96,291,0.0166533134943344,0.329896907216495
2010,26111,202,1292,232,876,0,105,232,981,0.0177075812274368,0.236493374108053
2010,26113,71,458,19,130,0,16,19,146,0.0144211774002371,0.13013698630137
2010,26115,474,2325,218,1684,25,167,243,1851,0.0181543561627713,0.13128038897893
2010,26117,288,1874,48,339,40,79,88,418,0.00990920513002868,0.210526315789474
2010,26119,39,309,7,151,0,21,7,172,0.0223987498372184,0.0406976744186047
2010,26121,359,3546,227,1411,25,92,252,1503,0.0132551371373137,0.167664670658683
2010,26123,87,1669,97,276,0,16,97,292,0.00901679841897233,0.332191780821918
2010,26125,9399,26786,5302,9254,3892,6602,9194,15856,0.0192806948637912,0.579843592330979
2010,26127,63,361,16,381,3,54,19,435,0.0240957181631862,0.0436781609195402
2010,26129,76,698,10,127,0,6,10,133,0.00840867421129165,0.075187969924812
2010,26131,8,40,8,39,0,5,8,44,0.00795803942846808,0.181818181818182
2010,26133,86,621,0,100,9,15,9,115,0.0072231643740971,0.0782608695652174
2010,26135,8,216,6,148,0,18,6,166,0.0256251929607904,0.036144578313253
2010,26137,86,682,30,166,0,0,30,166,0.00987566184781962,0.180722891566265
2010,26139,1170,5053,553,1759,220,328,773,2087,0.0131342118843535,0.370388116914231
2010,26141,32,232,30,89,0,6,30,95,0.00903557161879399,0.315789473684211
2010,26143,111,779,20,148,25,34,45,182,0.00942272844939166,0.247252747252747
2010,26145,555,3361,358,1330,56,101,414,1431,0.0107751155821273,0.289308176100629
2010,26147,434,2497,184,766,30,134,214,900,0.00804296731874279,0.237777777777778
2010,26149,91,529,140,555,0,18,140,573,0.0141652863958864,0.244328097731239
2010,26151,86,624,19,134,0,33,19,167,0.00558117772876145,0.11377245508982
2010,26153,25,223,8,91,0,3,8,94,0.0147081833828822,0.0851063829787234
2010,26155,185,1354,101,505,63,116,164,621,0.0130057803468208,0.264090177133655
2010,26157,80,1425,91,361,25,51,116,412,0.0107554952226805,0.281553398058252
2010,26159,233,1230,161,848,55,87,216,935,0.0184527333728044,0.231016042780749
2010,26161,2470,7416,3505,5146,1584,2136,5089,7282,0.0345329609097505,0.698846470749794
2010,26163,4337,18652,3030,9783,2056,4897,5086,14680,0.0121589912344275,0.346457765667575
2010,26165,119,765,82,237,0,23,82,260,0.0118327037728121,0.315384615384615
2010,27001,68,393,7,32,0,7,7,39,0.00311178488789595,0.179487179487179
2010,27003,2346,9627,640,1946,224,801,864,2747,0.0128543485788622,0.314524936294139
2010,27005,83,492,61,363,5,26,66,389,0.0176657584014532,0.169665809768638
2010,27007,200,693,103,307,12,28,115,335,0.0127115428397966,0.343283582089552
2010,27009,337,1615,46,238,5,18,51,256,0.0104952443424073,0.19921875
2010,27011,15,130,5,32,0,4,5,36,0.00930954228083786,0.138888888888889
2010,27013,382,1295,310,508,49,89,359,597,0.0166880975009784,0.601340033500838
2010,27015,74,265,10,137,0,14,10,151,0.00854604108891279,0.0662251655629139
2010,27017,319,1078,84,178,9,29,93,207,0.00862679724942696,0.449275362318841
2010,27019,863,2304,472,890,96,130,568,1020,0.0182338219520915,0.556862745098039
2010,27021,150,738,38,121,9,17,47,138,0.00674915635545557,0.340579710144928
2010,27023,24,257,30,113,3,7,33,120,0.01403672944204,0.275
2010,27025,246,2488,79,131,19,114,98,245,0.00699141055274948,0.4
2010,27027,127,498,529,1097,43,77,572,1174,0.0348223290027882,0.487223168654174
2010,27029,25,160,11,45,2,5,13,50,0.00849184782608696,0.26
2010,27031,25,107,36,37,0,0,36,37,0.00904424346125642,0.972972972972973
2010,27033,38,291,2,55,0,42,2,97,0.0119252520285223,0.0206185567010309
2010,27035,208,1275,139,424,8,38,147,462,0.0108343886309273,0.318181818181818
2010,27037,3130,8818,2063,3880,401,1265,2464,5145,0.0200591833631589,0.47891156462585
2010,27039,67,283,43,72,0,4,43,76,0.00598330971500551,0.565789473684211
2010,27041,274,640,0,99,0,27,0,126,0.00504585318970005,0
2010,27043,20,174,14,91,0,11,14,102,0.0097458436843111,0.137254901960784
2010,27045,67,369,33,120,8,26,41,146,0.0101798912285595,0.280821917808219
2010,27047,36,426,50,204,52,77,102,281,0.0126605091236765,0.362989323843416
2010,27049,227,811,160,513,25,59,185,572,0.018171998602154,0.323426573426573
2010,27051,53,140,10,35,0,2,10,37,0.00848234754699679,0.27027027027027
2010,27053,7574,17748,9378,16910,2898,5119,12276,22029,0.0288820449888098,0.557265422851695
2010,27055,11,96,85,341,51,59,136,400,0.0300548501014351,0.34
2010,27057,93,501,93,302,6,9,99,311,0.0214615968532192,0.318327974276527
2010,27059,142,1393,35,203,0,39,35,242,0.00987795420221233,0.144628099173554
2010,27061,170,697,34,255,4,32,38,287,0.00902572488835776,0.132404181184669
2010,27063,33,199,0,76,3,11,3,87,0.0119407082075213,0.0344827586206897
2010,27065,94,450,19,111,13,17,32,128,0.0113717128642502,0.25
2010,27067,124,793,67,138,4,7,71,145,0.00524450231481481,0.489655172413793
2010,27069,0,41,25,55,0,0,25,55,0.0164277180406213,0.454545454545455
2010,27071,65,195,17,112,0,68,17,180,0.0185375901132853,0.0944444444444444
2010,27073,34,106,4,39,0,0,4,39,0.00727883538633819,0.102564102564103
2010,27075,35,202,15,60,0,4,15,64,0.0078364148402106,0.234375
2010,27077,0,68,41,66,26,26,67,92,0.0302432610124918,0.728260869565217
2010,27079,204,752,10,109,13,47,23,156,0.00839160839160839,0.147435897435897
2010,27081,28,98,27,89,0,29,27,118,0.0276023391812865,0.228813559322034
2010,27083,64,320,128,428,0,10,128,438,0.0274229902329076,0.292237442922374
2010,27085,171,760,117,223,10,34,127,257,0.0104842328560356,0.494163424124514
2010,27087,24,92,8,19,0,0,8,19,0.00564133016627078,0.421052631578947
2010,27089,36,190,11,39,2,4,13,43,0.00637603795966785,0.302325581395349
2010,27091,16,147,27,100,4,11,31,111,0.00753768844221105,0.279279279279279
2010,27093,105,546,10,39,5,30,15,69,0.0043937850229241,0.217391304347826
2010,27095,212,1044,17,123,2,12,19,135,0.00774971297359357,0.140740740740741
2010,27097,97,742,25,158,38,48,63,206,0.00926633979578067,0.305825242718447
2010,27099,118,551,64,346,14,81,78,427,0.0164661422181089,0.182669789227166
2010,27101,21,138,17,74,0,4,17,78,0.0122776640957028,0.217948717948718
2010,27103,287,860,175,285,0,8,175,293,0.0148761169780666,0.597269624573379
2010,27105,41,220,117,337,36,105,153,442,0.0323123035309599,0.346153846153846
2010,27107,3,104,22,83,0,5,22,88,0.018234562784915,0.25
2010,27109,463,1887,1385,2282,299,504,1684,2786,0.0297605059072361,0.604450825556353
2010,27111,220,1112,122,478,0,71,122,549,0.0134644626477657,0.222222222222222
2010,27113,39,424,0,52,4,4,4,56,0.0060098733633827,0.0714285714285714
2010,27115,59,634,27,346,5,37,32,383,0.01860397338126,0.0835509138381201
2010,27117,31,124,16,117,0,5,16,122,0.0187145267679092,0.131147540983607
2010,27119,29,895,117,592,14,23,131,615,0.0297878523684975,0.213008130081301
2010,27121,43,206,30,42,0,18,30,60,0.00753106564578888,0.5
2010,27123,4860,12457,2790,5638,915,2042,3705,7680,0.0236873272799052,0.482421875
2010,27125,6,175,1,28,0,0,1,28,0.00980049002450122,0.0357142857142857
2010,27127,45,231,17,64,15,18,32,82,0.0074851665905979,0.390243902439024
2010,27129,55,346,49,102,5,9,54,111,0.0100144352219415,0.486486486486487
2010,27131,432,1997,287,811,21,83,308,894,0.0231972806767171,0.344519015659955
2010,27133,1,49,17,57,12,28,29,85,0.0131355277391439,0.341176470588235
2010,27135,43,120,0,70,2,30,2,100,0.00949757811758002,0.02
2010,27137,781,2593,613,1844,85,341,698,2185,0.0163308320129152,0.319450800915332
2010,27139,1494,3742,392,818,36,214,428,1032,0.0129796626796966,0.414728682170543
2010,27141,779,3050,176,644,46,97,222,741,0.0137932318230892,0.299595141700405
2010,27143,23,282,5,26,0,14,5,40,0.00389370193711671,0.125
2010,27145,727,2942,360,1225,125,353,485,1578,0.0176377882347681,0.307351077313054
2010,27147,203,988,257,551,0,3,257,554,0.0228906701925461,0.463898916967509
2010,27149,27,141,28,65,2,20,30,85,0.0145572872067135,0.352941176470588
2010,27151,30,430,10,34,0,6,10,40,0.00565450947130336,0.25
2010,27153,113,490,24,67,0,28,24,95,0.005720823798627,0.252631578947368
2010,27155,10,73,4,51,7,18,11,69,0.0257751214045573,0.159420289855072
2010,27157,71,291,49,181,7,65,56,246,0.0163890739506995,0.227642276422764
2010,27159,42,341,13,103,1,11,14,114,0.0119396732299958,0.12280701754386
2010,27161,91,324,28,336,0,0,28,336,0.0254680512392936,0.0833333333333333
2010,27163,2231,5803,1146,2019,306,523,1452,2542,0.0167303983835618,0.571203776553895
2010,27165,18,187,11,37,0,21,11,58,0.00765070571164754,0.189655172413793
2010,27167,59,98,4,159,0,2,4,161,0.035083896273698,0.0248447204968944
2010,27169,203,688,137,447,21,26,158,473,0.0157351962741184,0.334038054968288
2010,27171,943,3367,225,741,80,228,305,969,0.0127160348017795,0.314757481940144
2010,27173,70,238,28,143,0,19,28,162,0.0224906289046231,0.172839506172839
2010,28001,131,223,73,701,12,23,85,724,0.034199338686821,0.117403314917127
2010,28003,190,644,221,562,0,46,221,608,0.0243755763139959,0.363486842105263
2010,28005,0,174,0,235,0,20,0,255,0.0280867936997467,0
2010,28007,62,462,0,115,23,23,23,138,0.010759394978949,0.166666666666667
2010,28009,5,101,0,26,0,0,0,26,0.0044497689543043,0
2010,28011,41,487,85,433,64,67,149,500,0.0232893940099679,0.298
2010,28013,26,300,9,98,0,0,9,98,0.00980196039207842,0.0918367346938776
2010,28015,67,248,0,54,0,0,0,54,0.0071494770289951,0
2010,28017,66,194,0,138,0,16,0,154,0.0136319376825706,0
2010,28019,8,125,0,17,0,0,0,17,0.00287842871655943,0
2010,28021,24,58,4,82,0,0,4,82,0.0141868512110727,0.0487804878048781
2010,28023,22,320,14,46,0,0,14,46,0.00412334169953388,0.304347826086957
2010,28025,88,551,46,183,6,6,52,189,0.0139699903910119,0.275132275132275
2010,28027,73,361,0,196,0,30,0,226,0.0142947501581278,0
2010,28029,75,282,24,119,0,0,24,119,0.00635107007525217,0.201680672268908
2010,28031,42,346,8,50,0,6,8,56,0.00441988950276243,0.142857142857143
2010,28033,360,1467,1271,5341,159,334,1430,5675,0.0575452757103166,0.251982378854626
2010,28035,490,1900,259,1127,77,181,336,1308,0.0296249320529081,0.256880733944954
2010,28037,41,73,0,71,0,0,0,71,0.0133083411433927,0
2010,28039,24,356,50,375,0,102,50,477,0.0337699115044248,0.10482180293501
2010,28041,61,1349,21,177,18,79,39,256,0.0271215171098633,0.15234375
2010,28043,107,628,50,282,0,10,50,292,0.0198950739251891,0.171232876712329
2010,28045,391,1213,196,843,0,26,196,869,0.0301809467578925,0.225546605293441
2010,28047,878,3574,978,4635,241,1038,1219,5673,0.0482119182785464,0.214877489864269
2010,28049,972,3560,633,2034,131,314,764,2348,0.0155616234988468,0.325383304940375
2010,28051,7,486,18,107,0,60,18,167,0.0145597210113339,0.107784431137725
2010,28053,28,165,22,55,0,19,22,74,0.0125893160939095,0.297297297297297
2010,28055,3,148,0,49,0,0,0,49,0.0406301824212272,0
2010,28057,151,469,10,292,0,19,10,311,0.0204363254041267,0.0321543408360129
2010,28059,671,2720,678,2915,40,111,718,3026,0.0337813700098241,0.237276933245208
2010,28061,42,487,8,19,0,0,8,19,0.00165938864628821,0.421052631578947
2010,28063,94,366,0,15,0,0,0,15,0.00279381635313839,0
2010,28065,12,258,20,211,0,0,20,211,0.024463768115942,0.0947867298578199
2010,28067,119,714,81,455,13,67,94,522,0.0120763447079237,0.18007662835249
2010,28069,0,562,0,65,0,0,0,65,0.00935790382954218,0
2010,28071,188,734,509,1131,88,94,597,1225,0.0496292995178868,0.48734693877551
2010,28073,669,2311,414,909,40,152,454,1061,0.0324703146039907,0.427898209236569
2010,28075,242,1722,537,1497,27,134,564,1631,0.0318101144852066,0.345800122624157
2010,28077,36,301,11,99,0,0,11,99,0.0116347396873898,0.111111111111111
2010,28079,48,652,0,200,0,0,0,200,0.0142500890630566,0
2010,28081,331,2251,374,1021,90,138,464,1159,0.0220132953466287,0.400345125107852
2010,28083,102,479,11,158,0,0,11,158,0.00792138774691667,0.069620253164557
2010,28085,106,346,17,298,0,0,17,298,0.0131110035637292,0.0570469798657718
2010,28087,101,873,311,988,34,185,345,1173,0.0310268211395017,0.294117647058824
2010,28089,1489,2801,782,1378,51,118,833,1496,0.0255324959038777,0.556818181818182
2010,28091,31,393,19,293,11,11,30,304,0.0174032516601786,0.0986842105263158
2010,28093,31,880,0,407,0,0,0,407,0.0167173252279635,0
2010,28095,45,577,16,147,0,31,16,178,0.00716615000603889,0.0898876404494382
2010,28097,8,92,0,121,7,7,7,128,0.0176649185757659,0.0546875
2010,28099,107,640,18,124,0,0,18,124,0.00671795427456929,0.145161290322581
2010,28101,70,335,0,164,0,0,0,164,0.0118651425264072,0
2010,28103,9,134,39,78,0,0,39,78,0.0105505207628838,0.5
2010,28105,332,820,376,767,46,76,422,843,0.0360502907971262,0.500593119810202
2010,28107,68,440,66,350,41,138,107,488,0.0221214868540345,0.219262295081967
2010,28109,136,643,124,1388,17,56,141,1444,0.0389375758392881,0.0976454293628809
2010,28111,0,87,0,88,0,98,0,186,0.0229743083003953,0
2010,28113,52,524,50,810,0,0,50,810,0.0313067676728636,0.0617283950617284
2010,28115,6,483,35,225,24,73,59,298,0.0157596911523613,0.197986577181208
2010,28117,0,338,14,153,0,11,14,164,0.00995991740556298,0.0853658536585366
2010,28119,20,124,6,144,0,0,6,144,0.0267111853088481,0.0416666666666667
2010,28121,1451,4546,547,1867,51,111,598,1978,0.0215159030587826,0.302325581395349
2010,28123,0,371,23,202,10,119,33,321,0.0181018440196244,0.102803738317757
2010,28125,25,113,5,28,0,0,5,28,0.00893141945773525,0.178571428571429
2010,28127,50,738,16,182,0,31,16,213,0.0118954540377527,0.0751173708920188
2010,28129,56,320,35,61,0,21,35,82,0.00765496639283047,0.426829268292683
2010,28131,47,671,121,341,0,0,121,341,0.0312643256624186,0.354838709677419
2010,28133,110,1760,15,260,1,21,16,281,0.0146874346644365,0.0569395017793594
2010,28135,27,115,48,373,0,26,48,399,0.0407309105757452,0.120300751879699
2010,28137,58,312,49,113,0,12,49,125,0.00710833096388968,0.392
2010,28139,5,345,0,194,0,0,0,194,0.0133866961081976,0
2010,28141,37,167,8,273,0,11,8,284,0.0210028102351723,0.028169014084507
2010,28143,67,345,21,241,0,60,21,301,0.0458212817780484,0.0697674418604651
2010,28145,113,640,54,236,11,11,65,247,0.0138740661686233,0.263157894736842
2010,28147,134,287,0,246,0,0,0,246,0.0244192972007147,0
2010,28149,42,639,329,899,0,35,329,934,0.029305638354617,0.352248394004283
2010,28151,123,512,232,531,20,76,252,607,0.0187797784790545,0.415156507413509
2010,28153,6,217,10,141,0,42,10,183,0.0135165078661644,0.0546448087431694
2010,28155,80,364,5,56,8,16,13,72,0.0106069534472599,0.180555555555556
2010,28157,18,519,42,136,0,0,42,136,0.0202411073076351,0.308823529411765
2010,28159,25,136,65,216,0,19,65,235,0.0181691665378073,0.276595744680851
2010,28161,17,287,6,12,0,0,6,12,0.00141076886903362,0.5
2010,28163,57,343,90,600,8,49,98,649,0.0349168773874213,0.151001540832049
2010,29001,43,494,159,492,0,17,159,509,0.0373139799134961,0.31237721021611
2010,29003,68,646,18,135,21,23,39,158,0.0136749177773931,0.246835443037975
2010,29005,0,19,2,31,0,0,2,31,0.0074251497005988,0.0645161290322581
2010,29007,67,1072,116,424,0,0,116,424,0.0245044211986361,0.273584905660377
2010,29009,50,765,28,863,0,0,28,863,0.0359868229014637,0.0324449594438007
2010,29011,52,190,17,125,3,6,20,131,0.0156905018565098,0.152671755725191
2010,29013,13,341,22,180,0,4,22,184,0.0159528350962372,0.119565217391304
2010,29015,11,445,72,273,0,4,72,277,0.0193112102621305,0.259927797833935
2010,29017,44,276,14,78,0,7,14,85,0.0100842330051014,0.164705882352941
2010,29019,815,2658,1076,2211,500,651,1576,2862,0.0315552713400516,0.550663871418588
2010,29021,268,2662,254,1803,0,89,254,1892,0.0326330677153403,0.134249471458774
2010,29023,39,597,131,541,56,73,187,614,0.0212229096816564,0.304560260586319
2010,29025,30,169,7,73,3,3,10,76,0.0120177103099304,0.131578947368421
2010,29027,286,1841,68,487,46,66,114,553,0.0194348773458916,0.206148282097649
2010,29029,165,1301,257,809,11,86,268,895,0.027977492966552,0.299441340782123
2010,29031,368,1415,279,911,86,171,365,1082,0.0228617308992563,0.337338262476895
2010,29033,20,159,0,25,0,0,0,25,0.00381970970206264,0
2010,29035,0,84,43,46,0,0,43,46,0.0111245465538089,0.934782608695652
2010,29037,646,2925,348,1346,11,116,359,1462,0.0229078203099293,0.245554035567715
2010,29039,0,344,75,194,0,5,75,199,0.0202585768095287,0.376884422110553
2010,29041,25,175,2,4,0,5,2,9,0.00162132949018195,0.222222222222222
2010,29043,839,3052,495,1469,19,61,514,1530,0.0317559153175592,0.335947712418301
2010,29045,8,88,6,139,0,13,6,152,0.0309572301425662,0.0394736842105263
2010,29047,1720,5291,1389,3282,81,349,1470,3631,0.0256422931879493,0.40484714954558
2010,29049,30,744,44,232,0,0,44,232,0.0166558977672482,0.189655172413793
2010,29051,538,3161,100,610,56,77,156,687,0.0140995382247306,0.22707423580786
2010,29053,96,1112,14,113,0,3,14,116,0.00985975350616235,0.120689655172414
2010,29055,75,628,93,208,0,0,93,208,0.0125338957517325,0.447115384615385
2010,29057,0,333,15,63,0,7,15,70,0.0124821683309558,0.214285714285714
2010,29059,100,458,37,227,0,31,37,258,0.0226952850105559,0.143410852713178
2010,29061,10,148,26,116,0,10,26,126,0.0228633641807294,0.206349206349206
2010,29063,64,1136,34,135,0,1,34,136,0.0143930574663986,0.25
2010,29065,96,299,17,178,0,9,17,187,0.0174717368961973,0.0909090909090909
2010,29067,3,56,0,134,0,9,0,143,0.0154111434421813,0
2010,29069,24,807,40,627,0,21,40,648,0.0303854449967176,0.0617283950617284
2010,29071,338,1954,243,774,0,10,243,784,0.0117330140676444,0.309948979591837
2010,29073,30,374,7,33,0,0,7,33,0.00305018948146779,0.212121212121212
2010,29075,21,157,0,97,0,0,0,97,0.0213562307353589,0
2010,29077,1058,5562,1304,4977,321,692,1625,5669,0.0325565101534503,0.286646674898571
2010,29079,43,278,9,96,0,36,9,132,0.0192195690157251,0.0681818181818182
2010,29081,9,90,0,137,0,0,0,137,0.0222619434514137,0
2010,29083,35,630,24,176,0,4,24,180,0.0113895216400911,0.133333333333333
2010,29085,0,164,2,164,0,0,2,164,0.02215318114278,0.0121951219512195
2010,29087,11,120,5,57,0,6,5,63,0.0173889042230196,0.0793650793650794
2010,29089,68,285,20,42,0,0,20,42,0.00638103919781222,0.476190476190476
2010,29091,31,378,107,496,6,38,113,534,0.020156267693353,0.211610486891386
2010,29093,20,458,0,124,0,4,0,128,0.0173207036535859,0
2010,29095,1924,7015,4371,12031,364,1118,4735,13149,0.0299130521823402,0.360103429918625
2010,29097,341,1573,269,1817,66,86,335,1903,0.0259161911506353,0.176037834997373
2010,29099,842,4666,326,1660,74,275,400,1935,0.0135606761416197,0.20671834625323
2010,29101,282,1088,285,1129,94,267,379,1396,0.0473124110350437,0.271489971346705
2010,29103,97,188,0,77,0,0,0,77,0.0272856130403969,0
2010,29105,115,948,162,451,4,9,166,460,0.0195753010766416,0.360869565217391
2010,29107,79,1084,0,191,15,29,15,220,0.00978517101810257,0.0681818181818182
2010,29109,206,1091,37,619,4,22,41,641,0.0252561071710008,0.0639625585023401
2010,29111,10,125,13,157,0,0,13,157,0.023969465648855,0.0828025477707006
2010,29113,164,982,131,619,18,18,149,637,0.0195219123505976,0.233908948194662
2010,29115,36,172,15,52,0,2,15,54,0.00617425108621084,0.277777777777778
2010,29117,31,423,10,107,5,5,15,112,0.01078063336221,0.133928571428571
2010,29119,40,415,12,494,0,16,12,510,0.0353871773522065,0.0235294117647059
2010,29121,45,158,28,105,0,12,28,117,0.0109468562874251,0.239316239316239
2010,29123,28,140,129,379,0,0,129,379,0.0454490946156614,0.340369393139842
2010,29125,40,367,11,28,0,0,11,28,0.00451248992747784,0.392857142857143
2010,29127,97,647,64,263,0,39,64,302,0.0158805279486775,0.211920529801325
2010,29129,13,105,3,70,0,4,3,74,0.0288499025341131,0.0405405405405405
2010,29131,84,546,32,201,0,51,32,252,0.0150564617314931,0.126984126984127
2010,29133,0,565,7,205,0,92,7,297,0.0310247571294265,0.0235690235690236
2010,29135,148,1088,1,102,12,13,13,115,0.0111911249513429,0.11304347826087
2010,29137,64,268,13,35,0,0,13,35,0.00562339331619537,0.371428571428571
2010,29139,73,477,16,85,0,3,16,88,0.0103920642418517,0.181818181818182
2010,29141,97,556,68,228,0,2,68,230,0.0156985871271586,0.295652173913043
2010,29143,181,652,21,214,0,12,21,226,0.0176465995158897,0.0929203539823009
2010,29145,241,1451,299,1046,9,85,308,1131,0.0299547103848293,0.272325375773652
2010,29147,98,744,87,213,15,40,102,253,0.0202254376848669,0.403162055335968
2010,29149,12,283,10,274,0,0,10,274,0.0362817796610169,0.0364963503649635
2010,29151,65,408,4,28,0,23,4,51,0.00565096952908587,0.0784313725490196
2010,29153,5,102,2,73,0,0,2,73,0.0101941069683005,0.0273972602739726
2010,29155,21,204,31,131,0,4,31,135,0.0115011075140569,0.22962962962963
2010,29157,70,343,32,164,11,18,43,182,0.0144364242087729,0.236263736263736
2010,29159,81,620,123,369,11,83,134,452,0.0167593622543567,0.29646017699115
2010,29161,167,1064,250,481,43,153,293,634,0.0237009345794393,0.462145110410095
2010,29163,55,1115,11,225,30,49,41,274,0.0214414273417325,0.14963503649635
2010,29165,936,3024,1041,2757,98,199,1139,2956,0.0507807802648984,0.38531799729364
2010,29167,132,1011,20,328,1,19,21,347,0.0177312212570261,0.0605187319884726
2010,29169,232,923,838,3211,298,832,1136,4043,0.154827097614215,0.280979470690082
2010,29171,8,90,0,48,0,1,0,49,0.0141454965357968,0
2010,29173,19,198,5,65,0,3,5,68,0.00952914798206278,0.0735294117647059
2010,29175,50,1504,18,184,0,15,18,199,0.0115738048156334,0.0904522613065327
2010,29177,16,422,30,85,0,0,30,85,0.00539169045353631,0.352941176470588
2010,29179,13,104,0,47,0,0,0,47,0.00998512853197366,0
2010,29181,14,247,10,203,0,11,10,214,0.0222176079734219,0.0467289719626168
2010,29183,2769,7918,1808,3947,308,533,2116,4480,0.0196326761353428,0.472321428571429
2010,29185,33,321,28,113,0,17,28,130,0.0181488203266788,0.215384615384615
2010,29186,83,438,0,37,0,0,0,37,0.00294047524437733,0
2010,29187,377,3473,131,508,0,27,131,535,0.0121361976272032,0.244859813084112
2010,29189,6120,19960,6822,12874,1592,2433,8414,15307,0.0227121314861334,0.549683151499314
2010,29195,108,498,79,237,0,21,79,258,0.0171474145952413,0.306201550387597
2010,29197,15,65,28,81,0,0,28,81,0.0276450511945392,0.345679012345679
2010,29199,0,13,11,35,0,0,11,35,0.0109683484801003,0.314285714285714
2010,29201,65,779,48,538,46,55,94,593,0.0227037788583024,0.158516020236088
2010,29203,1,85,90,188,0,13,90,201,0.0351582998075914,0.447761194029851
2010,29205,5,101,5,123,0,0,5,123,0.0279736183761656,0.040650406504065
2010,29207,65,711,25,207,0,14,25,221,0.0107156710628394,0.113122171945701
2010,29209,159,874,104,1062,8,21,112,1083,0.0452513266201479,0.103416435826408
2010,29211,24,205,9,144,5,23,14,167,0.0359913793103448,0.0838323353293413
2010,29213,266,1205,297,2007,4,81,301,2088,0.0620062956583714,0.144157088122605
2010,29215,18,595,62,494,0,11,62,505,0.0286054152033533,0.122772277227723
2010,29217,87,409,46,223,0,0,46,223,0.0161208703824189,0.20627802690583
2010,29219,98,883,64,363,0,12,64,375,0.0177053824362606,0.170666666666667
2010,29221,68,726,9,62,0,7,9,69,0.0041066539697655,0.130434782608696
2010,29223,49,319,12,52,0,0,12,52,0.0054127198917456,0.230769230769231
2010,29225,61,1548,33,290,0,0,33,290,0.0126626495502576,0.113793103448276
2010,29227,9,75,0,11,0,0,0,11,0.00716145833333333,0
2010,29229,29,285,37,169,0,7,37,176,0.0141627102277299,0.210227272727273
2010,29510,3151,9603,3062,5577,677,1268,3739,6845,0.0326092134724406,0.546238130021914
2010,30001,16,132,64,142,0,0,64,142,0.0237180557875397,0.450704225352113
2010,30003,7,242,6,231,0,8,6,239,0.033454647256439,0.0251046025104603
2010,30005,14,59,5,57,0,0,5,57,0.014455997971088,0.087719298245614
2010,30007,0,122,43,185,0,0,43,185,0.0528420451299629,0.232432432432432
2010,30009,44,229,48,168,0,3,48,171,0.023274806043283,0.280701754385965
2010,30011,16,26,0,7,0,0,0,7,0.0070281124497992,0
2010,30013,197,1106,451,2029,47,122,498,2151,0.0401800724773041,0.231520223152022
2010,30015,18,97,4,52,23,23,27,75,0.0199097425006637,0.36
2010,30017,36,257,11,395,0,3,11,398,0.0504180390169749,0.0276381909547739
2010,30019,0,3,0,16,0,0,0,16,0.012987012987013,0
2010,30021,16,345,11,122,0,5,11,127,0.0203232517202752,0.0866141732283465
2010,30023,63,300,16,43,0,9,16,52,0.00790754257907543,0.307692307692308
2010,30025,0,45,32,108,0,14,32,122,0.0616784630940344,0.262295081967213
2010,30027,53,154,17,125,10,21,27,146,0.0174536760310819,0.184931506849315
2010,30029,151,443,442,1200,4,79,446,1279,0.0210216626672365,0.348709929632525
2010,30031,636,1191,1470,2620,172,253,1642,2873,0.0528805448187005,0.57152801949182
2010,30033,9,9,0,0,0,0,0,0,0,NA
2010,30035,34,271,18,152,0,0,18,152,0.0195901533702797,0.118421052631579
2010,30037,6,18,0,0,0,14,0,14,0.0241796200345423,0
2010,30039,24,123,14,45,0,0,14,45,0.0192472198460222,0.311111111111111
2010,30041,17,271,31,242,0,19,31,261,0.0261601683872908,0.118773946360153
2010,30043,63,431,55,147,3,12,58,159,0.0201214882308276,0.364779874213836
2010,30045,9,44,19,24,0,0,19,24,0.0153944836433611,0.791666666666667
2010,30047,69,417,106,477,0,0,106,477,0.0252380952380952,0.222222222222222
2010,30049,449,1191,473,1324,34,60,507,1384,0.0330199933196545,0.366329479768786
2010,30051,0,2,0,0,0,0,0,0,0,NA
2010,30053,29,58,71,445,17,31,88,476,0.0327282728272827,0.184873949579832
2010,30055,0,21,0,0,0,0,0,0,0,NA
2010,30057,63,194,106,180,0,9,106,189,0.0322031010393593,0.560846560846561
2010,30059,0,71,21,45,0,0,21,45,0.0316455696202532,0.466666666666667
2010,30061,4,45,4,6,0,5,4,11,0.00362080315997367,0.363636363636364
2010,30063,441,1651,1271,2483,59,255,1330,2738,0.0399142819656836,0.485756026296567
2010,30065,8,67,0,40,0,2,0,42,0.0128755364806867,0
2010,30067,67,148,151,461,48,55,199,516,0.0439935203342143,0.385658914728682
2010,30069,0,6,0,46,0,0,0,46,0.102222222222222,0
2010,30071,10,14,26,36,0,0,26,36,0.0117878192534381,0.722222222222222
2010,30073,14,88,0,78,0,0,0,78,0.018664752333094,0
2010,30075,0,23,15,57,0,0,15,57,0.0490533562822719,0.263157894736842
2010,30077,38,449,93,136,0,0,93,136,0.0255975908149821,0.683823529411765
2010,30079,1,15,4,4,0,0,4,4,0.00471698113207547,1
2010,30081,116,420,445,1049,23,75,468,1124,0.0396081471562478,0.416370106761566
2010,30083,53,160,45,138,0,0,45,138,0.0210847975553858,0.326086956521739
2010,30085,18,83,29,134,0,7,29,141,0.0239429444727458,0.205673758865248
2010,30087,74,164,42,123,0,8,42,131,0.0234767025089606,0.320610687022901
2010,30089,22,173,10,213,0,0,10,213,0.0254358729400525,0.0469483568075117
2010,30091,7,64,1,62,0,10,1,72,0.0262199563000728,0.0138888888888889
2010,30093,134,747,169,497,30,39,199,536,0.0232386733145458,0.371268656716418
2010,30095,51,201,30,111,0,14,30,125,0.0195740682743501,0.24
2010,30097,0,17,14,110,0,13,14,123,0.0456400742115028,0.113821138211382
2010,30099,17,122,7,85,7,12,14,97,0.0225844004656577,0.144329896907216
2010,30101,16,387,0,110,0,5,0,115,0.0310475161987041,0
2010,30103,0,3,18,28,0,0,18,28,0.0491228070175439,0.642857142857143
2010,30105,24,81,26,78,0,3,26,81,0.0156733746130031,0.320987654320988
2010,30107,5,9,0,6,0,4,0,10,0.00641025641025641,0
2010,30109,0,0,2,46,0,0,2,46,0.0598958333333333,0.0434782608695652
2010,30111,734,2407,683,2825,102,235,785,3060,0.0316279069767442,0.256535947712418
2010,31001,103,553,128,457,0,30,128,487,0.0244612989100407,0.262833675564682
2010,31003,25,154,42,113,0,0,42,113,0.0240476697169611,0.371681415929204
2010,31005,3,18,0,12,0,0,0,12,0.0421052631578947,0
2010,31007,0,9,0,8,0,5,0,13,0.0263157894736842,0
2010,31009,3,11,0,6,0,0,0,6,0.0144927536231884,0
2010,31011,34,100,9,38,0,0,9,38,0.00988553590010406,0.236842105263158
2010,31013,36,117,40,284,23,23,63,307,0.0404266526204899,0.205211726384365
2010,31015,11,39,0,10,0,0,0,10,0.00661813368630046,0
2010,31017,4,40,4,71,0,16,4,87,0.0379746835443038,0.0459770114942529
2010,31019,263,708,188,559,7,47,195,606,0.0225002784687929,0.321782178217822
2010,31021,30,135,15,29,0,0,15,29,0.00581511931020654,0.517241379310345
2010,31023,43,250,30,84,0,2,30,86,0.0148506302883785,0.348837209302326
2010,31025,141,490,59,213,0,33,59,246,0.0143649635036496,0.239837398373984
2010,31027,39,207,9,101,6,12,15,113,0.0188333333333333,0.132743362831858
2010,31029,6,20,20,66,0,15,20,81,0.0294974508375819,0.246913580246914
2010,31031,3,41,18,88,0,0,18,88,0.0215792054928887,0.204545454545455
2010,31033,134,283,13,190,0,5,13,195,0.0280979827089337,0.0666666666666667
2010,31035,19,100,16,71,0,0,16,71,0.0160379489496273,0.225352112676056
2010,31037,66,181,3,96,0,99,3,195,0.0305021116846551,0.0153846153846154
2010,31039,15,24,19,45,0,12,19,57,0.00899479248855926,0.333333333333333
2010,31041,15,128,48,87,18,18,66,105,0.013684347712759,0.628571428571429
2010,31043,14,128,38,513,17,75,55,588,0.0463356973995272,0.0935374149659864
2010,31045,28,108,64,161,0,0,64,161,0.0300822122571002,0.397515527950311
2010,31047,130,324,42,396,0,160,42,556,0.0359963744658811,0.0755395683453237
2010,31049,23,45,3,71,7,7,10,78,0.053025152957172,0.128205128205128
2010,31051,3,111,7,89,0,0,7,89,0.022128294380905,0.0786516853932584
2010,31053,142,872,124,351,0,62,124,413,0.0167301304383051,0.300242130750605
2010,31055,1933,5501,3170,8056,1068,1853,4238,9909,0.030840144163435,0.427691997174286
2010,31057,0,30,7,32,0,0,7,32,0.0218430034129693,0.21875
2010,31059,27,168,15,32,0,0,15,32,0.00758653390232338,0.46875
2010,31061,12,113,4,61,0,8,4,69,0.0292869269949066,0.0579710144927536
2010,31063,9,54,7,27,0,0,7,27,0.0143617021276596,0.259259259259259
2010,31065,35,128,6,100,0,3,6,103,0.0294369819948557,0.058252427184466
2010,31067,123,588,46,305,0,17,46,322,0.0206436722656751,0.142857142857143
2010,31069,19,30,5,100,0,0,5,100,0.0613120784794605,0.05
2010,31071,5,58,17,36,0,10,17,46,0.0305851063829787,0.369565217391304
2010,31073,24,74,0,10,0,0,0,10,0.00664010624169987,0
2010,31075,4,16,0,20,0,0,0,20,0.0427350427350427,0
2010,31077,6,39,0,6,0,0,0,6,0.00339943342776204,0
2010,31079,186,1329,42,958,25,105,67,1063,0.0290898144600733,0.0630291627469426
2010,31081,21,313,13,88,0,8,13,96,0.0154390479253779,0.135416666666667
2010,31083,7,61,39,81,0,6,39,87,0.0340775558166862,0.448275862068966
2010,31085,0,12,0,8,0,0,0,8,0.0110041265474553,0
2010,31087,8,40,3,49,0,0,3,49,0.0228331780055918,0.0612244897959184
2010,31089,35,214,74,140,0,0,74,140,0.0189959294436906,0.528571428571429
2010,31091,2,15,0,0,0,0,0,0,0,NA
2010,31093,1,147,0,16,0,0,0,16,0.00367816091954023,0
2010,31095,43,191,31,77,0,23,31,100,0.0181290790427846,0.31
2010,31097,28,292,1,41,0,11,1,52,0.01295788686768,0.0192307692307692
2010,31099,19,183,55,82,0,0,55,82,0.0180497468633062,0.670731707317073
2010,31101,43,173,26,256,13,13,39,269,0.0441852825229961,0.144981412639405
2010,31103,0,5,3,7,0,0,3,7,0.0119453924914676,0.428571428571429
2010,31105,54,80,32,81,0,0,32,81,0.0298452468680914,0.395061728395062
2010,31107,39,110,16,83,0,7,16,90,0.0145114479200258,0.177777777777778
2010,31109,870,3942,1690,4342,515,911,2205,5253,0.0305426509834931,0.419760137064535
2010,31111,178,498,50,518,0,32,50,550,0.0225493009716699,0.0909090909090909
2010,31113,0,25,1,12,0,0,1,12,0.0242424242424242,0.0833333333333333
2010,31115,0,5,0,2,0,0,0,2,0.00464037122969838,0
2010,31117,0,11,0,5,3,3,3,8,0.0231884057971014,0.375
2010,31119,114,556,244,533,50,81,294,614,0.0276888387824126,0.478827361563518
2010,31121,43,181,26,100,0,2,26,102,0.0192525481313703,0.254901960784314
2010,31123,16,48,46,96,0,0,46,96,0.0278099652375435,0.479166666666667
2010,31125,8,89,4,10,1,4,5,14,0.00534351145038168,0.357142857142857
2010,31127,50,93,57,102,0,0,57,102,0.0216193302246715,0.558823529411765
2010,31129,8,38,11,43,5,20,16,63,0.0188453484893808,0.253968253968254
2010,31131,159,451,18,198,2,2,20,200,0.0184842883548983,0.1
2010,31133,8,73,0,11,0,4,0,15,0.00728508984944148,0
2010,31135,5,60,7,11,0,0,7,11,0.00538160469667319,0.636363636363636
2010,31137,22,295,45,115,0,5,45,120,0.0186190845616757,0.375
2010,31139,47,150,0,5,0,6,0,11,0.00223622687538118,0
2010,31141,142,545,46,248,0,20,46,268,0.0131044936677913,0.171641791044776
2010,31143,21,132,3,40,0,3,3,43,0.0112418300653595,0.0697674418604651
2010,31145,44,215,11,116,0,0,11,116,0.0154543032240874,0.0948275862068965
2010,31147,52,108,25,221,0,0,25,221,0.0362295081967213,0.113122171945701
2010,31149,0,7,0,52,0,0,0,52,0.0417335473515249,0
2010,31151,59,391,3,117,0,6,3,123,0.0141623488773748,0.024390243902439
2010,31153,1285,4083,1289,3112,163,419,1452,3531,0.0375059748260662,0.411214953271028
2010,31155,126,449,14,71,2,9,16,80,0.00578118225177049,0.2
2010,31157,223,534,199,996,16,36,215,1032,0.0425409126509749,0.208333333333333
2010,31159,90,345,111,221,30,46,141,267,0.0256829549826856,0.528089887640449
2010,31161,29,56,31,91,3,3,34,94,0.0238881829733164,0.361702127659574
2010,31163,1,52,0,10,0,0,0,10,0.00442282176028306,0
2010,31165,3,38,12,21,0,0,12,21,0.0207100591715976,0.571428571428571
2010,31167,21,106,2,15,0,11,2,26,0.00646123260437376,0.0769230769230769
2010,31169,32,161,2,24,0,0,2,24,0.00620796689084325,0.0833333333333333
2010,31171,0,8,3,3,0,0,3,3,0.00541516245487365,1
2010,31173,17,43,18,127,0,0,18,127,0.0339753879079722,0.141732283464567
2010,31175,5,26,0,0,0,0,0,0,0,NA
2010,31177,131,409,83,244,0,5,83,249,0.0188922610015174,0.333333333333333
2010,31179,59,120,86,104,0,14,86,118,0.0231645072634472,0.728813559322034
2010,31181,20,167,5,24,3,7,8,31,0.011301494713817,0.258064516129032
2010,31183,0,0,5,9,0,0,5,9,0.0165441176470588,0.555555555555556
2010,31185,85,448,60,145,0,4,60,149,0.015780554967168,0.402684563758389
2010,32001,18,439,145,677,50,149,195,826,0.0503443652099714,0.236077481840194
2010,32003,564,2727,15653,59477,2524,8478,18177,67955,0.0546943538975411,0.267485836215142
2010,32005,116,692,369,1129,32,61,401,1190,0.0348462664714495,0.336974789915966
2010,32007,108,532,145,1061,0,13,145,1074,0.0368578194172758,0.135009310986965
2010,32009,8,39,0,15,0,0,0,15,0.0197628458498024,0
2010,32011,0,17,0,0,0,8,0,8,0.00671704450041982,0
2010,32013,75,373,50,324,0,9,50,333,0.0327659155761094,0.15015015015015
2010,32015,18,68,11,177,0,0,11,177,0.0506148126965971,0.0621468926553672
2010,32017,0,238,8,80,0,0,8,80,0.0260671228413164,0.1
2010,32019,186,2093,64,951,0,0,64,951,0.027506218545728,0.0672975814931651
2010,32021,0,140,29,53,0,0,29,53,0.0139731083575007,0.547169811320755
2010,32023,77,1022,159,1372,0,93,159,1465,0.0462349302531086,0.108532423208191
2010,32027,27,672,10,59,0,0,10,59,0.0115482481894696,0.169491525423729
2010,32029,0,195,0,8,0,0,0,8,0.00264812975835816,0
2010,32031,920,3572,3052,10493,767,1774,3819,12267,0.045361594811169,0.311323061873319
2010,32033,8,156,4,123,0,1,4,124,0.0196295709988919,0.032258064516129
2010,32510,224,1764,362,1017,17,184,379,1201,0.0315952856992529,0.315570358034971
2010,33001,250,1011,315,701,47,83,362,784,0.0181809749083994,0.461734693877551
2010,33003,234,673,362,956,17,20,379,976,0.0274257453564504,0.388319672131148
2010,33005,145,420,700,1665,62,81,762,1746,0.0341282251759187,0.436426116838488
2010,33007,91,535,139,543,12,54,151,597,0.0241719977326099,0.252931323283082
2010,33009,264,1128,1284,2091,376,471,1660,2562,0.0434134273223303,0.647931303669009
2010,33011,1064,4473,2977,6770,420,1185,3397,7955,0.029544154676927,0.427027027027027
2010,33013,643,3124,1087,2425,52,133,1139,2558,0.0254699697307631,0.445269741985927
2010,33015,968,3166,2556,5730,363,699,2919,6429,0.0316145085465882,0.454036397573495
2010,33017,657,2139,865,2316,101,222,966,2538,0.0327091361334141,0.380614657210402
2010,33019,223,740,319,730,24,24,343,754,0.0241829436479682,0.454907161803714
2010,34001,1028,3681,915,3007,278,997,1193,4004,0.0218238503507405,0.297952047952048
2010,34003,4362,9038,4978,9057,2603,4486,7581,13543,0.0216469106439568,0.559772576238647
2010,34005,2256,7317,2393,5909,546,1308,2939,7217,0.0236795306747862,0.40723292226687
2010,34007,2027,7822,2130,5528,174,1227,2304,6755,0.0198795162994376,0.341080680977054
2010,34009,494,1192,657,1812,60,210,717,2022,0.0283968822414156,0.35459940652819
2010,34011,388,4554,144,1029,77,427,221,1456,0.0141313947958421,0.151785714285714
2010,34013,3531,8823,3086,7655,1172,4005,4258,11660,0.0228087643557307,0.365180102915952
2010,34015,1353,4990,947,2386,100,525,1047,2911,0.0154798432340163,0.359670216420474
2010,34017,4317,7606,8154,11742,3313,5838,11467,17580,0.0409971782374478,0.652275312855518
2010,34019,1626,3545,816,1470,160,320,976,1790,0.0203109043458527,0.545251396648045
2010,34021,3234,6470,2968,5118,1381,2605,4349,7723,0.0320133641183371,0.56312313867668
2010,34023,5919,12542,4435,7725,3809,5752,8244,13477,0.0252368352555424,0.611708837278326
2010,34025,3810,8642,2540,6022,602,1475,3142,7497,0.0176133934151235,0.419100973722822
2010,34027,4556,9325,2952,4939,1297,2245,4249,7184,0.0213752904736543,0.591453229398664
2010,34029,2894,9523,1313,4603,402,928,1715,5531,0.0140119320556829,0.310070511661544
2010,34031,2013,6508,939,2687,591,1720,1530,4407,0.0137103498052489,0.34717494894486
2010,34033,159,1023,89,608,49,80,138,688,0.0153739581238408,0.200581395348837
2010,34035,4018,7077,1592,2921,1034,1458,2626,4379,0.0201027401976762,0.599680292304179
2010,34037,944,2853,565,1184,23,87,588,1271,0.0125404530744337,0.462627852084972
2010,34039,3029,8008,1807,3891,703,2100,2510,5991,0.0169146025731879,0.418961775997329
2010,34041,691,2069,235,991,53,113,288,1104,0.0148955691078849,0.260869565217391
2010,35001,1904,7328,5745,13924,1014,1958,6759,15882,0.0375256952484465,0.425576123913865
2010,35003,14,50,16,201,0,0,16,201,0.0636680392777954,0.0796019900497512
2010,35005,179,1120,221,1374,17,115,238,1489,0.0374666599567208,0.159838817998657
2010,35006,69,1161,30,253,0,10,30,263,0.0150037081407953,0.114068441064639
2010,35007,87,411,32,240,23,23,55,263,0.0265468860401736,0.209125475285171
2010,35009,153,484,282,1208,68,235,350,1443,0.0508349186218558,0.242550242550243
2010,35011,0,11,0,6,0,0,0,6,0.00457317073170732,0
2010,35013,414,1910,1464,4526,335,885,1799,5411,0.0448554280787851,0.332470892626132
2010,35015,244,610,169,1090,37,55,206,1145,0.0335777126099707,0.179912663755459
2010,35017,106,246,208,863,28,36,236,899,0.0433273892717721,0.262513904338154
2010,35019,10,365,0,166,0,0,0,166,0.0489820005901446,0
2010,35021,0,8,4,9,0,0,4,9,0.0158730158730159,0.444444444444444
2010,35023,4,29,11,56,15,15,26,71,0.0223130106851037,0.366197183098592
2010,35025,81,1049,257,1335,38,191,295,1526,0.0404892674255088,0.193315858453473
2010,35027,128,390,156,537,0,57,156,594,0.0394160583941606,0.262626262626263
2010,35028,135,298,394,574,23,34,417,608,0.0473889321901793,0.685855263157895
2010,35029,21,309,233,813,6,108,239,921,0.0573653067580193,0.259500542888165
2010,35031,30,282,156,846,100,100,256,946,0.0240473830041435,0.27061310782241
2010,35033,37,145,6,44,0,12,6,56,0.0160642570281124,0.107142857142857
2010,35035,200,701,361,1537,122,365,483,1902,0.0473287381491527,0.253943217665615
2010,35037,20,92,31,211,0,0,31,211,0.0334601966381224,0.146919431279621
2010,35039,89,601,131,503,38,48,169,551,0.0208073713228352,0.306715063520871
2010,35041,15,289,125,447,47,81,172,528,0.047529030515798,0.325757575757576
2010,35043,1087,3360,1229,3268,270,416,1499,3684,0.0455579738820736,0.406894679695983
2010,35045,320,968,364,1960,36,115,400,2075,0.0268960064291177,0.192771084337349
2010,35047,103,540,122,305,0,9,122,314,0.0161373214102169,0.388535031847134
2010,35049,579,2455,2096,4043,222,446,2318,4489,0.0447936935588485,0.516373357095121
2010,35051,13,142,52,131,0,13,52,144,0.0169651272384543,0.361111111111111
2010,35053,40,234,62,143,34,44,96,187,0.0169031908162343,0.513368983957219
2010,35055,132,435,362,801,0,65,362,866,0.0369501216025942,0.418013856812933
2010,35057,64,733,33,431,0,353,33,784,0.0711240134264719,0.0420918367346939
2010,35059,3,33,18,188,0,0,18,188,0.0652777777777778,0.0957446808510638
2010,35061,188,2280,218,1140,41,50,259,1190,0.0249915994623656,0.217647058823529
2010,36001,2236,6643,1731,3093,605,1391,2336,4484,0.0223044628822698,0.520963425512935
2010,36003,98,589,166,323,12,23,178,346,0.0113156948032835,0.514450867052023
2010,36005,3876,23802,2081,7095,1733,7450,3814,14545,0.0173152906695047,0.2622206943967
2010,36007,488,2072,622,1635,208,369,830,2004,0.0149844099327795,0.414171656686627
2010,36009,258,1238,206,668,12,40,218,708,0.0132195604682861,0.307909604519774
2010,36011,132,2150,143,626,59,87,202,713,0.0128807312931315,0.283309957924264
2010,36013,241,1314,329,1086,30,157,359,1243,0.0138224762582568,0.288817377312953
2010,36015,359,2011,372,1245,33,81,405,1326,0.0219206162900266,0.305429864253394
2010,36017,121,735,148,433,3,9,151,442,0.0125879303961496,0.341628959276018
2010,36019,134,2110,86,562,64,124,150,686,0.0124252852744068,0.21865889212828
2010,36021,448,1456,167,624,28,59,195,683,0.0151478187584555,0.285505124450952
2010,36023,102,628,123,251,35,60,158,311,0.0103363467162989,0.508038585209003
2010,36025,222,1012,104,446,0,6,104,452,0.0133605273270078,0.230088495575221
2010,36027,1507,6385,1125,2610,135,545,1260,3155,0.0160384312330021,0.399366085578447
2010,36029,2042,7050,2997,6489,1102,2320,4099,8809,0.0141490038356024,0.465319559541378
2010,36031,248,1172,255,748,21,24,276,772,0.0270848682594815,0.357512953367876
2010,36033,300,2789,91,302,15,43,106,345,0.00970163943646129,0.307246376811594
2010,36035,148,1333,49,295,24,100,73,395,0.0102061908945274,0.184810126582278
2010,36037,209,1119,113,504,0,0,113,504,0.0123091952619367,0.224206349206349
2010,36039,208,1745,88,357,18,36,106,393,0.0113514918690968,0.269720101781171
2010,36041,1,51,1,12,0,0,1,12,0.00313479623824451,0.0833333333333333
2010,36043,164,849,79,351,4,32,83,383,0.00866378627819124,0.216710182767624
2010,36045,343,1614,1121,3540,381,1692,1502,5232,0.0732752583961234,0.287079510703364
2010,36047,12793,24223,9004,15219,4372,13342,13376,28561,0.0177043977399169,0.46833094079339
2010,36049,85,365,17,75,19,92,36,167,0.0092808714015783,0.215568862275449
2010,36051,349,2176,129,293,27,67,156,360,0.00850842570489944,0.433333333333333
2010,36053,292,1268,248,784,25,106,273,890,0.019082741911276,0.306741573033708
2010,36055,2026,6400,2656,5046,1368,2197,4024,7243,0.0148651810379151,0.555570896037553
2010,36057,174,1395,51,171,16,167,67,338,0.00993124522536287,0.198224852071006
2010,36059,7290,15563,2667,5106,1645,3994,4312,9100,0.0100614188811923,0.473846153846154
2010,36061,14964,28743,27065,33377,13444,18306,40509,51683,0.0442961705920669,0.783797380183039
2010,36063,726,3016,359,1121,34,270,393,1391,0.00938767521748227,0.282530553558591
2010,36065,717,5282,328,1606,244,609,572,2215,0.0139010047633691,0.25823927765237
2010,36067,1870,5312,1618,3749,877,1561,2495,5310,0.017448738170347,0.469868173258004
2010,36069,808,2247,405,787,70,145,475,932,0.0129207563910608,0.509656652360515
2010,36071,1730,5505,1593,3577,289,860,1882,4437,0.0191170071134052,0.424160468785215
2010,36073,127,1707,17,198,0,19,17,217,0.00744859781004359,0.0783410138248848
2010,36075,315,1672,230,816,17,123,247,939,0.0120188923163567,0.263045793397231
2010,36077,219,846,210,749,33,44,243,793,0.0198557764535029,0.306431273644388
2010,36079,891,2708,238,634,44,111,282,745,0.0109558823529412,0.378523489932886
2010,36081,11597,29533,6140,12663,6114,15381,12254,28044,0.018355132944466,0.43695621166738
2010,36083,1112,3771,547,1120,216,306,763,1426,0.013414358819988,0.535063113604488
2010,36085,1887,5386,691,1922,329,857,1020,2779,0.00893149839625128,0.367038503058654
2010,36087,1295,2953,798,1308,350,997,1148,2305,0.0119665662963348,0.498047722342733
2010,36089,370,2106,211,954,29,142,240,1096,0.015623663578047,0.218978102189781
2010,36091,1265,4096,1412,2510,133,373,1545,2883,0.0192958971956362,0.535900104058273
2010,36093,1022,3100,568,1173,122,299,690,1472,0.0142146685336295,0.46875
2010,36095,46,738,25,214,0,0,25,214,0.00968501086169442,0.116822429906542
2010,36097,53,477,20,277,0,27,20,304,0.0234260614934114,0.0657894736842105
2010,36099,158,1529,48,390,12,33,60,423,0.017431079243417,0.141843971631206
2010,36101,297,1317,309,873,114,164,423,1037,0.0154141149890005,0.407907425265188
2010,36103,5746,13621,2753,6049,1490,3148,4243,9197,0.00925515942180663,0.461346091116668
2010,36105,407,2383,232,819,90,243,322,1062,0.0198697799730579,0.303201506591337
2010,36107,196,587,97,417,0,20,97,437,0.0124416353490491,0.221967963386728
2010,36109,1075,1907,1029,1628,780,1001,1809,2629,0.0461487150681084,0.688094332445797
2010,36111,1393,5143,655,1319,114,371,769,1690,0.013341859492062,0.455029585798817
2010,36113,237,1318,227,655,67,144,294,799,0.0171180049704345,0.367959949937422
2010,36115,235,2330,156,565,19,55,175,620,0.0141426583635576,0.282258064516129
2010,36117,641,2358,198,898,0,118,198,1016,0.0159552749772292,0.19488188976378
2010,36119,6490,12699,3900,5739,1838,4066,5738,9805,0.0154287233891894,0.585211626721061
2010,36121,164,2359,24,188,17,47,41,235,0.00786268736616702,0.174468085106383
2010,36123,102,396,151,213,13,32,164,245,0.0150556135930683,0.669387755102041
2010,37001,794,3017,641,1958,121,351,762,2309,0.0237429305912596,0.330012992637505
2010,37003,124,793,89,403,0,19,89,422,0.0165256892230576,0.210900473933649
2010,37005,25,68,27,199,0,69,27,268,0.0332464954720258,0.100746268656716
2010,37007,16,1041,9,272,0,0,9,272,0.0147633521493704,0.0330882352941176
2010,37009,75,300,54,297,0,34,54,331,0.0167501644653611,0.163141993957704
2010,37011,94,795,89,343,0,7,89,350,0.0268343172582995,0.254285714285714
2010,37013,157,843,277,698,0,42,277,740,0.0222824450466727,0.374324324324324
2010,37015,40,571,27,261,0,0,27,261,0.0179209008514144,0.103448275862069
2010,37017,90,668,0,497,0,44,0,541,0.0231265763262514,0
2010,37019,631,2372,729,2432,26,279,755,2711,0.0356415076975665,0.278495020287717
2010,37021,1244,3932,2605,5888,167,652,2772,6540,0.0396931368502828,0.423853211009174
2010,37023,171,1583,78,727,10,50,88,777,0.0125565610859729,0.113256113256113
2010,37025,1038,3886,704,2711,33,347,737,3058,0.0276306991705369,0.241007194244604
2010,37027,157,954,213,976,37,81,250,1057,0.0185578594378215,0.236518448438978
2010,37029,57,175,40,97,25,25,65,122,0.0195293740995678,0.532786885245902
2010,37031,397,1777,538,1332,166,342,704,1674,0.0349792088931609,0.420549581839904
2010,37033,89,1069,46,233,0,21,46,254,0.0148694532256176,0.181102362204724
2010,37035,537,3078,605,1720,18,219,623,1939,0.0187117008443908,0.32129963898917
2010,37037,621,1351,538,1171,30,72,568,1243,0.0281833847270089,0.456958970233307
2010,37039,120,325,97,427,0,23,97,450,0.0221565731166913,0.215555555555556
2010,37041,25,376,0,190,7,22,7,212,0.0211323763955343,0.0330188679245283
2010,37043,0,133,43,246,0,0,43,246,0.0313335880779519,0.17479674796748
2010,37045,295,2178,294,1115,0,33,294,1148,0.0174872044845235,0.25609756097561
2010,37047,27,1087,64,493,0,27,64,520,0.0135600292062168,0.123076923076923
2010,37049,504,2181,867,3035,162,631,1029,3666,0.0570317361543248,0.280687397708674
2010,37051,862,3833,3003,10547,1175,4221,4178,14768,0.0788598219673304,0.282908992416035
2010,37053,8,212,144,651,0,0,144,651,0.0408176061195059,0.221198156682028
2010,37055,202,463,326,863,44,85,370,948,0.0384693422067118,0.390295358649789
2010,37057,656,3462,420,1451,31,165,451,1616,0.014722495535877,0.279084158415842
2010,37059,199,610,273,666,25,25,298,691,0.0245218070194116,0.431259044862518
2010,37061,64,1393,66,440,0,172,66,612,0.0164286481262751,0.107843137254902
2010,37063,3329,7201,3863,7140,1253,1778,5116,8918,0.0527339707769361,0.573671226732451
2010,37065,126,1940,85,442,37,107,122,549,0.0148370358359008,0.222222222222222
2010,37067,1540,4943,2271,5128,395,652,2666,5780,0.0256526331673457,0.461245674740484
2010,37069,147,1327,111,618,37,91,148,709,0.0180678372110802,0.208744710860367
2010,37071,578,4118,615,2271,135,333,750,2604,0.0190554246491138,0.288018433179723
2010,37073,0,226,6,188,0,0,6,188,0.0229913171089642,0.0319148936170213
2010,37075,0,89,16,132,0,0,16,132,0.0218869175924391,0.121212121212121
2010,37077,215,1602,186,898,6,84,192,982,0.0247542223342576,0.195519348268839
2010,37079,46,1255,18,115,0,83,18,198,0.0137033704754654,0.0909090909090909
2010,37081,1928,6477,2979,7312,544,1355,3523,8667,0.0280426447511041,0.406484365985924
2010,37083,140,1018,56,364,0,66,56,430,0.0114862699006304,0.130232558139535
2010,37085,459,2939,613,2034,104,514,717,2548,0.0374562667215476,0.281397174254317
2010,37087,238,791,417,1183,0,39,417,1222,0.0285327355935369,0.341243862520458
2010,37089,570,1996,818,2453,19,220,837,2673,0.0352754866380732,0.313131313131313
2010,37091,86,469,131,1048,0,68,131,1116,0.0675503904122026,0.117383512544803
2010,37093,266,2127,168,658,129,396,297,1054,0.0394239760613428,0.281783681214421
2010,37095,1,663,0,90,0,0,0,90,0.0214387803716055,0
2010,37097,671,2733,989,2912,79,255,1068,3167,0.0307332505240276,0.33722766024629
2010,37099,130,666,249,581,23,78,272,659,0.0267299424028555,0.412746585735964
2010,37101,654,3697,405,1892,168,372,573,2264,0.0216962146621945,0.253091872791519
2010,37103,41,338,9,78,0,0,9,78,0.0110387772431361,0.115384615384615
2010,37105,84,937,156,774,33,100,189,874,0.0239072159308496,0.216247139588101
2010,37107,117,954,73,543,0,53,73,596,0.0147923853962423,0.12248322147651
2010,37109,296,1339,332,1196,9,118,341,1314,0.0251589185877307,0.259512937595129
2010,37111,112,773,62,271,0,0,62,271,0.00864047953067211,0.228782287822878
2010,37113,84,270,221,758,44,102,265,860,0.0350562530572314,0.308139534883721
2010,37115,123,345,107,433,5,26,112,459,0.0319304347826087,0.24400871459695
2010,37117,103,524,21,150,0,18,21,168,0.00989923987979494,0.125
2010,37119,4922,11778,11406,27013,2321,4454,13727,31467,0.0549201600812624,0.436234785648457
2010,37121,19,170,11,104,0,0,11,104,0.00902151283830673,0.105769230769231
2010,37123,44,472,51,250,12,27,63,277,0.0148748791751692,0.227436823104693
2010,37125,438,1262,875,1866,70,201,945,2067,0.0335829989114364,0.457184325108853
2010,37127,392,2331,181,706,75,292,256,998,0.0157138133551668,0.256513026052104
2010,37129,1463,4896,2123,5289,135,267,2258,5556,0.0421087734190263,0.406407487401008
2010,37131,23,591,0,182,0,52,0,234,0.0150491993054216,0
2010,37133,240,1625,1231,6636,412,1622,1643,8258,0.095193083573487,0.19895858561395
2010,37135,1442,3388,2092,2772,842,1220,2934,3992,0.0510009837364097,0.73496993987976
2010,37137,14,368,13,89,0,3,13,92,0.00935624936438523,0.141304347826087
2010,37139,41,1044,100,890,0,32,100,922,0.0358169528397172,0.108459869848156
2010,37141,255,1651,228,568,20,94,248,662,0.0188137664478358,0.374622356495468
2010,37143,0,221,67,176,0,0,67,176,0.0187393526405451,0.380681818181818
2010,37145,185,719,87,435,0,55,87,490,0.018315702911823,0.177551020408163
2010,37147,653,3028,1044,2580,171,338,1215,2918,0.030877326645715,0.416381082933516
2010,37149,99,290,256,690,51,54,307,744,0.0486656200941915,0.412634408602151
2010,37151,493,2801,204,921,43,138,247,1059,0.0112245222423606,0.233238904627007
2010,37153,84,671,37,272,0,96,37,368,0.0119842381216009,0.10054347826087
2010,37155,186,1443,237,1379,48,131,285,1510,0.0184775027226784,0.188741721854305
2010,37157,297,1089,361,1051,13,282,374,1333,0.0204250494154421,0.280570142535634
2010,37159,334,2660,349,1464,33,65,382,1529,0.0166997968500841,0.249836494440811
2010,37161,168,965,148,1080,0,10,148,1090,0.0232731931247998,0.135779816513761
2010,37163,128,1466,123,535,45,122,168,657,0.0157871972318339,0.255707762557078
2010,37165,136,1036,78,390,0,18,78,408,0.0173676145070662,0.191176470588235
2010,37167,347,1022,59,257,45,252,104,509,0.0125483815299657,0.204322200392927
2010,37169,130,982,10,141,25,58,35,199,0.00601517395641266,0.175879396984925
2010,37171,167,857,121,504,46,158,167,662,0.0130273929471033,0.25226586102719
2010,37173,38,106,161,422,0,1,161,423,0.04438149197356,0.380614657210402
2010,37175,180,973,345,560,0,24,345,584,0.0241501943594409,0.590753424657534
2010,37177,20,708,0,20,0,0,0,20,0.0058411214953271,0
2010,37179,1388,3683,1045,3188,65,605,1110,3793,0.0318736817337669,0.292644344845769
2010,37181,83,723,64,211,0,38,64,249,0.00853558206499383,0.257028112449799
2010,37183,5473,13508,10943,21187,1926,3663,12869,24850,0.0454585366924478,0.517867203219316
2010,37185,115,310,2,183,44,192,46,375,0.0256357670221493,0.122666666666667
2010,37187,47,196,24,144,0,10,24,154,0.0169491525423729,0.155844155844156
2010,37189,350,717,310,570,26,59,336,629,0.0234596449351037,0.534181240063593
2010,37191,222,2427,468,1583,160,572,628,2155,0.0276420261412758,0.291415313225058
2010,37193,97,679,129,405,0,34,129,439,0.00909185047116082,0.293849658314351
2010,37195,284,1230,283,975,0,30,283,1005,0.0190828823696952,0.281592039800995
2010,37197,121,785,26,170,0,10,26,180,0.00688547165480835,0.144444444444444
2010,37199,31,280,38,171,15,15,53,186,0.0143187066974596,0.28494623655914
2010,38001,3,17,12,57,0,0,12,57,0.0323863636363636,0.210526315789474
2010,38003,58,182,42,79,0,0,42,79,0.010186976144423,0.531645569620253
2010,38005,2,38,0,27,0,9,0,36,0.00942408376963351,0
2010,38007,2,2,15,24,0,0,15,24,0.0367534456355283,0.625
2010,38009,25,87,0,56,11,24,11,80,0.0171858216970999,0.1375
2010,38011,35,77,3,11,0,9,3,20,0.00884173297966401,0.15
2010,38013,10,30,3,28,0,2,3,30,0.0196979645436638,0.1
2010,38015,518,1728,153,1053,43,82,196,1135,0.02168430705743,0.172687224669604
2010,38017,427,1385,1345,3102,130,460,1475,3562,0.0402667872484739,0.414093206064009
2010,38019,3,54,8,24,0,3,8,27,0.00889621087314662,0.296296296296296
2010,38021,21,104,20,84,0,14,20,98,0.0273284997211378,0.204081632653061
2010,38023,0,13,8,31,14,19,22,50,0.0309981401115933,0.44
2010,38025,31,79,0,27,0,6,0,33,0.0136138613861386,0
2010,38027,9,28,0,15,0,17,0,32,0.0182232346241458,0
2010,38029,15,37,16,66,0,4,16,70,0.025974025974026,0.228571428571429
2010,38031,14,71,0,16,0,23,0,39,0.0158924205378973,0
2010,38033,0,9,0,10,0,0,0,10,0.0091324200913242,0
2010,38035,159,552,684,1507,136,293,820,1800,0.047459593429483,0.455555555555556
2010,38037,18,34,7,38,0,0,7,38,0.0203317281968967,0.184210526315789
2010,38039,1,39,6,23,0,0,6,23,0.0122340425531915,0.260869565217391
2010,38041,17,47,3,23,0,2,3,25,0.0132205182443152,0.12
2010,38043,5,42,2,48,0,0,2,48,0.026344676180022,0.0416666666666667
2010,38045,6,28,3,56,0,0,3,56,0.0178913738019169,0.0535714285714286
2010,38047,0,39,11,44,0,0,11,44,0.0292942743009321,0.25
2010,38049,30,141,10,44,0,0,10,44,0.0112704918032787,0.227272727272727
2010,38051,14,46,0,1,0,7,0,8,0.00348583877995643,0
2010,38053,38,102,11,138,0,0,11,138,0.0352220520673813,0.0797101449275362
2010,38055,24,132,29,85,2,2,31,87,0.0129947722180732,0.35632183908046
2010,38057,83,156,0,32,0,0,0,32,0.00537634408602151,0
2010,38059,210,878,102,365,0,42,102,407,0.0222781761453829,0.250614250614251
2010,38061,20,122,18,118,0,0,18,118,0.024748322147651,0.152542372881356
2010,38063,3,30,16,51,0,0,16,51,0.0215553677092139,0.313725490196078
2010,38065,0,0,0,4,0,0,0,4,0.00306748466257669,0
2010,38067,20,117,12,76,0,19,12,95,0.0174664460378746,0.126315789473684
2010,38069,0,225,0,74,0,34,0,108,0.0335195530726257,0
2010,38071,90,248,12,91,0,17,12,108,0.0138125079933495,0.111111111111111
2010,38073,33,150,6,60,10,10,16,70,0.0176812326345037,0.228571428571429
2010,38075,7,46,13,35,0,3,13,38,0.0217640320733104,0.342105263157895
2010,38077,65,252,12,226,7,33,19,259,0.0246338215712383,0.0733590733590734
2010,38079,0,28,39,56,0,128,39,184,0.0237388724035608,0.21195652173913
2010,38081,26,64,3,19,0,0,3,19,0.00675675675675676,0.157894736842105
2010,38083,0,16,0,8,0,0,0,8,0.00772946859903382,0
2010,38085,0,42,11,11,0,10,11,21,0.00973574408901252,0.523809523809524
2010,38087,8,8,0,0,0,0,0,0,0,NA
2010,38089,73,499,166,421,4,4,170,425,0.0275063102711799,0.4
2010,38091,11,54,0,32,0,2,0,34,0.024390243902439,0
2010,38093,37,409,57,336,0,61,57,397,0.0276462395543175,0.143576826196474
2010,38095,9,45,0,15,0,3,0,18,0.0109090909090909,0
2010,38097,75,187,35,173,10,10,45,183,0.0329908058409951,0.245901639344262
2010,38099,34,189,13,83,0,3,13,86,0.0107594144876767,0.151162790697674
2010,38101,177,677,425,1428,318,411,743,1839,0.0498023073173374,0.404023926046765
2010,38103,2,42,78,90,0,7,78,97,0.0294653705953827,0.804123711340206
2010,38105,35,235,46,294,21,48,67,342,0.0238111815080415,0.195906432748538
2010,39001,24,445,93,187,0,23,93,210,0.0110016764459346,0.442857142857143
2010,39003,184,1639,119,622,0,97,119,719,0.0103865711313995,0.165507649513213
2010,39005,136,986,122,392,46,75,168,467,0.0134291876347951,0.359743040685225
2010,39007,195,1633,144,1166,35,142,179,1308,0.0188671080531395,0.136850152905199
2010,39009,171,829,625,949,233,243,858,1192,0.0359707888224998,0.719798657718121
2010,39011,142,966,33,172,0,0,33,172,0.00561357702349869,0.191860465116279
2010,39013,56,1222,105,690,5,103,110,793,0.0156877485212368,0.138713745271122
2010,39015,13,584,20,187,6,29,26,216,0.0072211821342605,0.12037037037037
2010,39017,1730,6959,1124,3319,231,660,1355,3979,0.0172365246245349,0.340537823573762
2010,39019,88,668,15,79,16,16,31,95,0.00471136679230311,0.326315789473684
2010,39021,109,988,69,180,0,26,69,206,0.00776128400271268,0.33495145631068
2010,39023,440,1970,189,928,0,145,189,1073,0.0114709058060102,0.17614165890028
2010,39025,1033,4013,742,2198,99,351,841,2549,0.0198412080641395,0.329933307179286
2010,39027,106,939,23,154,10,95,33,249,0.00900509927308235,0.132530120481928
2010,39029,90,1189,138,1236,13,50,151,1286,0.0169417840251887,0.117418351477449
2010,39031,81,373,29,182,3,3,32,185,0.0074347948398505,0.172972972972973
2010,39033,81,1021,0,166,21,45,21,211,0.00689407305757041,0.0995260663507109
2010,39035,3866,12127,5602,11256,1475,3308,7077,14564,0.0165253621872844,0.485924196649272
2010,39037,122,698,6,381,0,29,6,410,0.0115207373271889,0.0146341463414634
2010,39039,75,407,121,453,0,4,121,457,0.0176495577955432,0.264770240700219
2010,39041,3072,5905,1235,2066,213,394,1448,2460,0.0229005501717541,0.588617886178862
2010,39043,263,1573,105,475,0,74,105,549,0.010165913636027,0.191256830601093
2010,39045,795,3911,476,1242,87,172,563,1414,0.0149767510830076,0.398161244695898
2010,39047,64,647,0,115,0,3,0,118,0.00609063693609993,0
2010,39049,5477,16196,6685,13869,2328,4090,9013,17959,0.0245102454709477,0.501865359986636
2010,39051,170,850,19,353,0,7,19,360,0.0127366000353794,0.0527777777777778
2010,39053,41,265,48,295,0,0,48,295,0.0142601633876347,0.16271186440678
2010,39055,291,1461,222,401,14,27,236,428,0.00685490974902702,0.551401869158878
2010,39057,1217,3382,1149,2306,360,629,1509,2935,0.0289370680390823,0.514139693356048
2010,39059,59,464,17,245,0,21,17,266,0.0097643344835181,0.0639097744360902
2010,39061,2695,8343,4682,9887,1160,2189,5842,12076,0.0229221357295659,0.483769460086121
2010,39063,440,1698,243,619,29,190,272,809,0.0164491073970152,0.336217552533993
2010,39065,103,412,0,174,0,0,0,174,0.00894601542416452,0
2010,39067,27,344,14,76,6,6,20,82,0.00731685553671812,0.24390243902439
2010,39069,44,528,16,123,0,9,16,132,0.0069327731092437,0.121212121212121
2010,39071,85,1065,25,296,19,81,44,377,0.0130725753320157,0.116710875331565
2010,39073,83,835,23,125,0,10,23,135,0.00678153413372181,0.17037037037037
2010,39075,65,272,4,63,0,36,4,99,0.00423203522421237,0.0404040404040404
2010,39077,153,1204,64,660,12,26,76,686,0.0175102738851877,0.110787172011662
2010,39079,50,675,29,219,0,37,29,256,0.0115268584807961,0.11328125
2010,39081,40,689,76,536,51,149,127,685,0.0138810083488693,0.185401459854015
2010,39083,97,1441,166,479,0,26,166,505,0.0131709352668092,0.328712871287129
2010,39085,865,3802,485,1188,187,345,672,1533,0.00955699911474633,0.438356164383562
2010,39087,10,594,253,1091,0,32,253,1123,0.0261942526590782,0.225289403383793
2010,39089,833,3995,429,1490,14,71,443,1561,0.014425253897406,0.283792440743113
2010,39091,108,662,23,370,0,11,23,381,0.012418918478438,0.0603674540682415
2010,39093,1301,6130,563,1927,91,353,654,2280,0.0113118243293527,0.286842105263158
2010,39095,1017,4230,1470,4821,192,439,1662,5260,0.018247099023468,0.315969581749049
2010,39097,310,3027,26,286,11,38,37,324,0.0110346706627614,0.114197530864198
2010,39099,637,3669,456,1652,121,327,577,1979,0.0117455041842246,0.291561394643759
2010,39101,217,2572,129,494,0,38,129,532,0.0116419020942294,0.242481203007519
2010,39103,1062,3982,460,1286,10,87,470,1373,0.0120034270527346,0.34231609613984
2010,39105,54,480,17,185,0,0,17,185,0.011274987810824,0.0918918918918919
2010,39107,156,623,53,202,0,32,53,234,0.00872223050544208,0.226495726495726
2010,39109,479,1857,348,845,50,157,398,1002,0.0144083516673137,0.397205588822355
2010,39111,3,84,16,89,0,0,16,89,0.00843921866110374,0.179775280898876
2010,39113,1672,7548,1925,5071,953,1402,2878,6473,0.0178989166081373,0.444616097636336
2010,39115,16,227,37,126,9,9,46,135,0.0130020225368391,0.340740740740741
2010,39117,152,796,14,172,0,0,14,172,0.00742884291452512,0.0813953488372093
2010,39119,194,1293,57,576,54,104,111,680,0.0118829183049367,0.163235294117647
2010,39121,27,1012,0,54,0,0,0,54,0.00495185694635488,0
2010,39123,191,883,106,276,12,58,118,334,0.0111374170529194,0.353293413173653
2010,39125,49,301,27,135,0,27,27,162,0.0122876213592233,0.166666666666667
2010,39127,61,793,20,151,0,7,20,158,0.00673142467620995,0.126582278481013
2010,39129,285,3231,66,549,18,45,84,594,0.0159471649484536,0.141414141414141
2010,39131,174,927,27,184,0,11,27,195,0.0102783048703352,0.138461538461538
2010,39133,838,2952,420,901,311,439,731,1340,0.0132896955271249,0.545522388059702
2010,39135,138,847,45,434,21,78,66,512,0.0178055990262563,0.12890625
2010,39137,116,357,38,186,30,51,68,237,0.0105352062588905,0.286919831223629
2010,39139,347,3277,127,805,0,60,127,865,0.0100116899501152,0.146820809248555
2010,39141,87,2643,161,703,0,11,161,714,0.0132698955506821,0.225490196078431
2010,39143,170,1002,30,314,24,99,54,413,0.00998501039601567,0.130750605326877
2010,39145,41,1001,105,877,0,36,105,913,0.0171320273211739,0.11500547645126
2010,39147,204,1055,41,188,0,70,41,258,0.00689636737857849,0.158914728682171
2010,39149,48,670,80,342,10,18,90,360,0.011281729865246,0.25
2010,39151,1197,4799,594,2512,136,268,730,2780,0.0108647224805959,0.262589928057554
2010,39153,2441,7260,1321,2856,433,942,1754,3798,0.0103171196818481,0.461822011585045
2010,39155,364,2005,220,1522,35,109,255,1631,0.011035332007199,0.156345800122624
2010,39157,105,1054,84,395,6,96,90,491,0.00777009384247757,0.183299389002037
2010,39159,664,2481,42,289,172,219,214,508,0.0153316834671335,0.421259842519685
2010,39161,3,325,56,296,0,7,56,303,0.0155074466451712,0.184818481848185
2010,39163,0,360,0,0,0,0,0,0,0,NA
2010,39165,1757,6296,1505,2884,294,462,1799,3346,0.0245949839757725,0.53765690376569
2010,39167,40,381,106,1089,48,73,154,1162,0.0269068679664706,0.132530120481928
2010,39169,303,1518,197,571,24,92,221,663,0.00900301458406887,0.333333333333333
2010,39171,92,683,123,554,0,49,123,603,0.0232854494902688,0.203980099502488
2010,39173,972,2768,538,1106,204,271,742,1377,0.0180075325626406,0.538852578068264
2010,39175,79,563,69,151,10,27,79,178,0.0115449474640031,0.443820224719101
2010,40001,19,93,42,133,0,9,42,142,0.0101031661330487,0.295774647887324
2010,40003,20,366,14,79,0,0,14,79,0.018389199255121,0.177215189873418
2010,40005,59,1009,1,135,2,10,3,145,0.0149577057974005,0.0206896551724138
2010,40007,26,79,12,178,0,2,12,180,0.0471945464079706,0.0666666666666667
2010,40009,101,236,85,736,0,26,85,762,0.0555920332676735,0.111548556430446
2010,40011,52,288,31,551,0,29,31,580,0.0697954271961492,0.053448275862069
2010,40013,117,457,121,1063,0,64,121,1127,0.0421734086741758,0.107364685004437
2010,40015,43,589,82,804,0,31,82,835,0.0443818433081748,0.0982035928143713
2010,40017,1030,3728,434,2157,37,171,471,2328,0.0324944516561283,0.202319587628866
2010,40019,72,498,184,597,0,41,184,638,0.0204887761328238,0.288401253918495
2010,40021,109,707,186,468,0,5,186,473,0.0168070212841559,0.39323467230444
2010,40023,18,248,37,303,0,19,37,322,0.0316835580045262,0.114906832298137
2010,40025,0,24,0,68,0,0,0,68,0.0401416765053129,0
2010,40027,1598,7263,1351,4025,419,637,1770,4662,0.0305871392298759,0.37966537966538
2010,40029,17,137,8,65,0,0,8,65,0.0169050715214564,0.123076923076923
2010,40031,177,2378,764,4142,216,1404,980,5546,0.076071600027433,0.176703930760909
2010,40033,19,129,36,123,9,30,45,153,0.0359746061603574,0.294117647058824
2010,40035,25,636,0,364,0,9,0,373,0.0360804797833237,0
2010,40037,254,1977,219,1055,10,54,229,1109,0.0240485742166323,0.206492335437331
2010,40039,186,671,94,378,0,24,94,402,0.0255985736118186,0.233830845771144
2010,40041,28,636,104,891,0,66,104,957,0.0333507579717721,0.108672936259143
2010,40043,38,213,0,3,0,0,0,3,0.0009000900090009,0
2010,40045,15,68,0,21,3,11,3,32,0.0111072544255467,0.09375
2010,40047,198,848,329,1116,103,219,432,1335,0.0343496719413354,0.323595505617978
2010,40049,91,605,0,226,0,9,0,235,0.0125514073599316,0
2010,40051,270,1704,94,805,13,99,107,904,0.0268432461323752,0.118362831858407
2010,40053,5,106,13,72,0,0,13,72,0.0224159402241594,0.180555555555556
2010,40055,20,753,0,117,0,0,0,117,0.0266211604095563,0
2010,40057,0,146,15,53,0,54,15,107,0.0537688442211055,0.14018691588785
2010,40059,26,53,0,60,0,11,0,71,0.0287798946088366,0
2010,40061,67,350,24,260,0,17,24,277,0.0328237942884228,0.0866425992779783
2010,40063,7,499,12,59,0,0,12,59,0.00623151668779045,0.203389830508475
2010,40065,35,472,235,647,23,111,258,758,0.0460846303501946,0.340369393139842
2010,40067,36,345,0,142,0,2,0,144,0.0325423728813559,0
2010,40069,31,221,13,172,0,0,13,172,0.0251461988304094,0.0755813953488372
2010,40071,89,594,118,686,36,188,154,874,0.0285154975530179,0.176201372997712
2010,40073,69,363,10,94,0,9,10,103,0.0106603187745808,0.0970873786407767
2010,40075,49,284,13,133,0,13,13,146,0.0224892174984596,0.089041095890411
2010,40077,5,197,60,110,0,0,60,110,0.0154907759470497,0.545454545454545
2010,40079,55,1082,83,748,6,175,89,923,0.0281599902370565,0.0964247020585049
2010,40081,94,813,33,333,0,2,33,335,0.0150197274031564,0.0985074626865672
2010,40083,357,1053,182,513,32,49,214,562,0.0216336900454231,0.380782918149466
2010,40085,20,178,35,191,37,58,72,249,0.0390833464134359,0.289156626506024
2010,40087,266,1456,31,409,3,3,34,412,0.0187153629508495,0.0825242718446602
2010,40089,62,380,59,453,0,2,59,455,0.0209378307487,0.12967032967033
2010,40091,61,593,30,278,0,8,30,286,0.0199428212816401,0.104895104895105
2010,40093,36,160,0,99,0,0,0,99,0.0188427864484203,0
2010,40095,33,374,31,310,0,0,31,310,0.0291107146210912,0.1
2010,40097,75,761,75,734,0,10,75,744,0.0274832846957999,0.100806451612903
2010,40099,19,343,10,320,6,6,16,326,0.0356595930868519,0.049079754601227
2010,40101,197,2278,76,601,5,41,81,642,0.0138949008743832,0.126168224299065
2010,40103,15,314,29,179,0,0,29,179,0.0228345452226049,0.162011173184358
2010,40105,66,211,19,87,0,60,19,147,0.0205508178386691,0.129251700680272
2010,40107,22,603,24,72,0,0,24,72,0.00871565185812856,0.333333333333333
2010,40109,2624,11360,4120,12177,763,2567,4883,14744,0.0325918524789835,0.331185567010309
2010,40111,137,1137,30,273,0,12,30,285,0.0109577453958245,0.105263157894737
2010,40113,245,2059,103,443,10,29,113,472,0.0147670744298095,0.239406779661017
2010,40115,49,562,62,695,0,33,62,728,0.0344713291349022,0.0851648351648352
2010,40117,81,730,33,98,0,5,33,103,0.0091767640769779,0.320388349514563
2010,40119,411,1743,537,1232,240,321,777,1553,0.0381272709417657,0.50032195750161
2010,40121,50,1418,93,737,0,21,93,758,0.0238185017596782,0.122691292875989
2010,40123,130,730,72,238,11,22,83,260,0.0110860017908157,0.319230769230769
2010,40125,211,1579,45,650,45,88,90,738,0.0166268643265895,0.121951219512195
2010,40127,9,329,36,209,9,15,45,224,0.0281973816717019,0.200892857142857
2010,40129,32,96,0,29,0,0,0,29,0.0118415679869334,0
2010,40131,633,2847,334,1247,48,63,382,1310,0.0237559843319309,0.291603053435115
2010,40133,58,643,37,194,0,12,37,206,0.0126434665193641,0.179611650485437
2010,40135,61,585,38,801,0,28,38,829,0.0300351436542154,0.04583835946924
2010,40137,115,1057,140,688,0,130,140,818,0.0270056124133377,0.171149144254279
2010,40139,5,189,56,706,57,205,113,911,0.0766254520985785,0.12403951701427
2010,40141,18,246,43,281,0,12,43,293,0.0544609665427509,0.146757679180887
2010,40143,1973,9384,2894,9434,396,1406,3290,10840,0.0284239148960718,0.303505535055351
2010,40145,537,2461,382,1304,0,117,382,1421,0.030826969802152,0.268824771287825
2010,40147,187,760,228,919,87,134,315,1053,0.0308390686776981,0.299145299145299
2010,40149,23,288,34,104,0,37,34,141,0.0184458398744113,0.24113475177305
2010,40151,46,320,94,238,0,0,94,238,0.0422885572139304,0.394957983193277
2010,40153,82,620,81,511,0,17,81,528,0.0399092970521542,0.153409090909091
2010,41001,90,247,19,251,0,13,19,264,0.0226862593451921,0.071969696969697
2010,41003,664,1701,1138,1912,363,425,1501,2337,0.0475077248333062,0.642276422764228
2010,41005,2973,9206,2245,5579,334,876,2579,6455,0.0256106076716764,0.399535243996902
2010,41007,296,915,306,890,12,44,318,934,0.0364175147190705,0.340471092077088
2010,41009,167,1291,161,994,6,63,167,1057,0.0317894736842105,0.157994323557237
2010,41011,179,1113,349,1526,33,69,382,1595,0.0344373434666206,0.239498432601881
2010,41013,200,760,9,297,0,16,9,313,0.0204802721978669,0.0287539936102236
2010,41015,0,141,125,935,59,59,184,994,0.0568032458997657,0.185110663983903
2010,41017,687,2793,1237,3451,66,242,1303,3693,0.0345831850617122,0.352829677768752
2010,41019,421,1822,596,2064,39,165,635,2229,0.0291220276979357,0.28488111260655
2010,41021,0,70,6,37,0,0,6,37,0.0276325616131441,0.162162162162162
2010,41023,7,123,19,61,0,11,19,72,0.0132523467697405,0.263888888888889
2010,41025,36,309,14,219,0,1,14,220,0.0425367362722351,0.0636363636363636
2010,41027,80,358,183,390,0,84,183,474,0.0328755722014149,0.386075949367089
2010,41029,472,2550,1504,5133,69,300,1573,5433,0.0391203853714384,0.289526964844469
2010,41031,215,1020,91,385,0,48,91,433,0.0308822480564867,0.210161662817552
2010,41033,181,805,246,1662,43,154,289,1816,0.0306058818572512,0.159140969162996
2010,41035,95,758,350,1775,49,151,399,1926,0.0426710386387806,0.207165109034268
2010,41037,4,378,77,252,0,39,77,291,0.0499742400824317,0.264604810996564
2010,41039,1059,4273,2462,6509,739,1276,3201,7785,0.0335736896126411,0.411175337186898
2010,41041,262,906,287,792,16,52,303,844,0.0243775633989949,0.359004739336493
2010,41043,520,2775,215,1260,17,131,232,1391,0.0181192929437664,0.166786484543494
2010,41045,84,964,106,713,0,22,106,735,0.0361819434872502,0.14421768707483
2010,41047,1535,6687,821,3998,218,778,1039,4776,0.024214891955748,0.217546063651591
2010,41049,64,378,0,236,4,15,4,251,0.0356382223484311,0.0159362549800797
2010,41051,5037,13335,9469,17932,1813,3758,11282,21690,0.0438243792051401,0.520147533425542
2010,41053,536,2268,461,1272,4,41,465,1313,0.0279724749142504,0.354150799695354
2010,41055,7,43,10,45,0,0,10,45,0.0350467289719626,0.222222222222222
2010,41057,105,743,15,152,0,35,15,187,0.0101597305226557,0.0802139037433155
2010,41059,219,1654,193,1520,0,137,193,1657,0.0346051834680367,0.116475558237779
2010,41061,71,431,50,429,18,23,68,452,0.0270124902886512,0.150442477876106
2010,41063,29,97,32,105,0,12,32,117,0.0225086571758369,0.273504273504274
2010,41065,66,414,172,586,7,39,179,625,0.0365925058548009,0.2864
2010,41067,4231,11004,5510,12276,1415,2429,6925,14705,0.0432943130027204,0.470928255695342
2010,41069,7,74,0,7,0,0,0,7,0.00608166811468288,0
2010,41071,546,2311,466,1830,24,170,490,2000,0.0321104599823392,0.245
2010,42001,165,1400,483,1630,0,49,483,1679,0.024701711023819,0.287671232876712
2010,42003,3651,8965,7668,13059,2881,4197,10549,17256,0.0201508511212239,0.611323597589244
2010,42005,145,1017,29,258,54,108,83,366,0.00733555136890207,0.226775956284153
2010,42007,663,2183,290,1515,15,160,305,1675,0.0136723532772835,0.182089552238806
2010,42009,154,413,119,509,0,14,119,523,0.0147777683591874,0.227533460803059
2010,42011,1143,5206,773,3131,317,987,1090,4118,0.0152914396901608,0.26469159786304
2010,42013,246,1447,297,1095,2,118,299,1213,0.0137287080527418,0.246496290189613
2010,42015,45,578,93,789,0,13,93,802,0.018516808274843,0.115960099750623
2010,42017,2668,7090,3223,6294,379,846,3602,7140,0.0166398269830875,0.504481792717087
2010,42019,1247,3004,777,2001,132,236,909,2237,0.0180182357110639,0.40634778721502
2010,42021,419,1926,515,1442,20,99,535,1541,0.0150372271392188,0.347177157689812
2010,42023,12,19,0,8,0,0,0,8,0.0020997375328084,0
2010,42025,123,1154,59,364,0,32,59,396,0.00854055686156102,0.148989898989899
2010,42027,925,2965,1503,2272,524,714,2027,2986,0.0361243179811031,0.678834561286001
2010,42029,4014,7778,4316,7035,911,1597,5227,8632,0.0266450181039193,0.605537534754402
2010,42031,68,698,88,253,3,8,91,261,0.0100651729590066,0.348659003831418
2010,42033,208,2320,59,454,3,60,62,514,0.0088148033818662,0.120622568093385
2010,42035,261,845,31,228,10,49,41,277,0.0110187358287919,0.148014440433213
2010,42037,241,804,102,483,54,141,156,624,0.0143871622244766,0.25
2010,42039,283,1436,364,949,33,124,397,1073,0.0177487387312877,0.369990680335508
2010,42041,1425,6147,1225,2646,483,741,1708,3387,0.0215143238264626,0.504281074697372
2010,42043,1370,5668,1218,2678,245,588,1463,3266,0.018093180433217,0.447948560930802
2010,42045,3012,8844,2575,4483,741,1599,3316,6082,0.0165659327938465,0.545215389674449
2010,42047,10,197,27,140,0,0,27,140,0.0059739705568594,0.192857142857143
2010,42049,317,2052,1063,2610,76,480,1139,3090,0.0168983582889455,0.368608414239482
2010,42051,370,2684,97,1042,14,236,111,1278,0.0128420269903635,0.0868544600938967
2010,42053,86,932,6,96,18,27,24,123,0.0218356115746494,0.195121951219512
2010,42055,244,1244,525,2087,59,181,584,2268,0.0227605724263894,0.257495590828924
2010,42057,21,189,20,132,0,3,20,135,0.0132081009685941,0.148148148148148
2010,42059,124,1335,82,506,21,30,103,536,0.0196740566730289,0.192164179104478
2010,42061,160,2259,74,422,30,108,104,530,0.0165320190898032,0.19622641509434
2010,42063,174,1163,293,746,41,68,334,814,0.0145883364995161,0.41031941031941
2010,42065,105,556,18,229,0,14,18,243,0.00767190755824967,0.0740740740740741
2010,42067,44,337,0,84,0,40,0,124,0.00746583177795171,0
2010,42069,705,2756,568,1665,177,403,745,2068,0.0139203952638346,0.360251450676983
2010,42071,1545,5115,1919,4023,368,1273,2287,5296,0.0159018505117958,0.431835347432024
2010,42073,266,874,76,372,15,64,91,436,0.006805906777809,0.208715596330275
2010,42075,427,1949,282,869,64,311,346,1180,0.0131221920733063,0.293220338983051
2010,42077,1893,6287,1623,4886,397,1447,2020,6333,0.0272935315235333,0.318964156008211
2010,42079,584,3085,511,2756,78,466,589,3222,0.0143013129510773,0.182805710738672
2010,42081,364,1592,242,755,74,200,316,955,0.0120724091725027,0.330890052356021
2010,42083,61,480,139,802,6,33,145,835,0.0273950131233596,0.173652694610778
2010,42085,143,1207,395,1594,13,149,408,1743,0.0216777563584354,0.23407917383821
2010,42087,61,439,43,279,0,93,43,372,0.0115866193234909,0.115591397849462
2010,42089,416,1701,1047,3074,63,286,1110,3360,0.0305674075017513,0.330357142857143
2010,42091,6391,15798,5163,8120,1268,2172,6431,10292,0.0188625991972582,0.624854255732608
2010,42093,111,449,114,261,23,49,137,310,0.0241339042428961,0.441935483870968
2010,42095,1771,5585,1562,4514,334,576,1896,5090,0.0254240674511998,0.372495088408644
2010,42097,302,2352,50,376,9,118,59,494,0.00734234033382381,0.119433198380567
2010,42099,156,947,34,264,9,49,43,313,0.010016,0.137380191693291
2010,42101,4976,10417,9138,15647,2416,6201,11554,21848,0.0226270258738094,0.528835591358477
2010,42103,44,469,224,1620,18,28,242,1648,0.041994750656168,0.146844660194175
2010,42105,54,148,45,259,0,0,45,259,0.0210843373493976,0.173745173745174
2010,42107,417,3282,201,1631,48,424,249,2055,0.0191387114198968,0.121167883211679
2010,42109,180,670,60,331,4,13,64,344,0.0135023746908977,0.186046511627907
2010,42111,173,1239,103,456,4,143,107,599,0.0105496750559186,0.178631051752922
2010,42113,27,131,0,12,0,9,0,21,0.00444821012497352,0
2010,42115,75,517,83,522,15,30,98,552,0.0180062630480167,0.177536231884058
2010,42117,57,442,141,432,11,23,152,455,0.0160828532041992,0.334065934065934
2010,42119,246,1178,345,1447,16,154,361,1601,0.0530237795588527,0.225484072454716
2010,42121,309,1031,134,405,7,7,141,412,0.0105419374648176,0.342233009708738
2010,42123,18,427,62,341,0,19,62,360,0.0120292712266515,0.172222222222222
2010,42125,721,2420,608,1842,47,159,655,2001,0.0137508761802664,0.327336331834083
2010,42127,198,1776,218,1183,64,99,282,1282,0.0334822011543785,0.21996879875195
2010,42129,1222,5104,678,2051,124,334,802,2385,0.00903939813147871,0.336268343815514
2010,42131,74,451,54,168,0,0,54,168,0.00864019749022835,0.321428571428571
2010,42133,1157,4455,1752,6150,232,902,1984,7052,0.024210547998819,0.281338627339762
2010,44001,321,710,460,729,83,153,543,882,0.0260715341412947,0.615646258503401
2010,44003,808,3168,726,1653,38,255,764,1908,0.0159877996665019,0.40041928721174
2010,44005,154,545,2086,2969,400,577,2486,3546,0.0601292116731386,0.70107163000564
2010,44007,961,3243,3519,7074,813,2268,4332,9342,0.0226485355547097,0.463712267180475
2010,44009,870,1605,751,1718,143,279,894,1997,0.0237803208021244,0.447671507260891
2010,45001,146,587,9,100,13,15,22,115,0.00665894614939201,0.191304347826087
2010,45003,253,1333,1024,2926,127,359,1151,3285,0.0310180726304459,0.350380517503805
2010,45005,50,420,0,75,0,12,0,87,0.012123745819398,0
2010,45007,600,2658,825,2298,47,327,872,2625,0.0211818247839454,0.332190476190476
2010,45009,9,172,104,292,0,0,104,292,0.0283330098971473,0.356164383561644
2010,45011,5,273,0,228,0,6,0,234,0.0156031206241248,0
2010,45013,465,1016,2879,6795,132,771,3011,7566,0.071409020981001,0.397964578376949
2010,45015,1005,4865,868,3077,205,642,1073,3719,0.0343210993087791,0.28851841892982
2010,45017,49,157,8,140,0,10,8,150,0.0141843971631206,0.0533333333333333
2010,45019,1599,4986,4961,9269,459,1166,5420,10435,0.0458524110414891,0.519405845711548
2010,45021,33,609,112,530,0,34,112,564,0.0155354781842221,0.198581560283688
2010,45023,29,440,55,340,3,8,58,348,0.0156594519191828,0.166666666666667
2010,45025,26,313,28,666,15,56,43,722,0.0236403523132838,0.0595567867036011
2010,45027,66,445,37,301,0,35,37,336,0.0145612134344529,0.110119047619048
2010,45029,40,636,49,233,0,0,49,233,0.00903170788433212,0.210300429184549
2010,45031,235,977,88,534,72,106,160,640,0.0140135756514123,0.25
2010,45033,0,406,15,367,0,156,15,523,0.0259283129244956,0.0286806883365201
2010,45035,735,3937,933,3080,146,316,1079,3396,0.0407086859581405,0.317726737338045
2010,45037,116,1002,80,576,23,114,103,690,0.0370410135280223,0.149275362318841
2010,45039,146,423,28,103,0,14,28,117,0.00716165758707229,0.239316239316239
2010,45041,377,2254,478,1803,50,90,528,1893,0.0213688238680619,0.27892234548336
2010,45043,227,1206,333,781,18,101,351,882,0.0206945096198968,0.397959183673469
2010,45045,1820,7219,3411,9330,671,1376,4082,10706,0.0370275579658016,0.381281524378853
2010,45047,216,1199,222,968,13,190,235,1158,0.0256070054398302,0.20293609671848
2010,45049,43,242,35,436,0,17,35,453,0.0322488787641489,0.0772626931567329
2010,45051,540,2177,2218,9046,238,754,2456,9800,0.0541454412853465,0.250612244897959
2010,45053,26,974,14,287,8,189,22,476,0.0319484529163031,0.046218487394958
2010,45055,218,995,110,568,49,111,159,679,0.0167865707434053,0.234167893961708
2010,45057,133,948,446,1356,58,94,504,1450,0.0293148413965995,0.347586206896552
2010,45059,181,1432,223,778,0,83,223,861,0.0191977524582488,0.259001161440186
2010,45061,45,342,0,138,7,18,7,156,0.0119972314081366,0.0448717948717949
2010,45063,1725,5370,941,3364,101,331,1042,3695,0.0219661976184956,0.282002706359946
2010,45065,10,386,98,161,7,7,105,168,0.020924149956408,0.625
2010,45067,30,550,45,347,0,39,45,386,0.0173039852960954,0.116580310880829
2010,45069,26,574,119,713,0,32,119,745,0.0370942043417646,0.159731543624161
2010,45071,137,871,140,384,17,58,157,442,0.0176757578181236,0.355203619909502
2010,45073,240,1300,543,1253,46,108,589,1361,0.0264148746215356,0.432770022042616
2010,45075,131,943,130,615,106,151,236,766,0.0129531926406926,0.308093994778068
2010,45077,458,1930,828,1925,177,285,1005,2210,0.0307012669482107,0.454751131221719
2010,45079,2106,9319,3614,9414,792,1730,4406,11144,0.0483890577507599,0.395369705671213
2010,45081,56,331,102,252,0,122,102,374,0.0278958752890281,0.272727272727273
2010,45083,915,3867,1087,3833,147,570,1234,4403,0.0240160143125191,0.280263456734045
2010,45085,66,731,270,1157,102,214,372,1371,0.0203364186543254,0.271334792122538
2010,45087,22,404,71,390,0,9,71,399,0.0198339712680817,0.177944862155388
2010,45089,34,310,0,283,0,26,0,309,0.0134757959005669,0
2010,45091,282,1338,1901,6390,98,219,1999,6609,0.0471707539897793,0.30246633378726
2010,46003,13,84,5,13,0,28,5,41,0.0216701902748414,0.121951219512195
2010,46005,40,198,67,418,0,0,67,418,0.0363636363636364,0.160287081339713
2010,46007,10,37,18,68,0,0,18,68,0.0349974266598044,0.264705882352941
2010,46009,28,359,7,119,4,4,11,123,0.0237039892079399,0.0894308943089431
2010,46011,197,447,136,335,38,47,174,382,0.0236269173676398,0.455497382198953
2010,46013,132,325,247,588,44,91,291,679,0.0285258160736042,0.428571428571429
2010,46015,11,45,22,64,0,13,22,77,0.0237361282367448,0.285714285714286
2010,46017,0,37,8,14,0,0,8,14,0.0150214592274678,0.571428571428571
2010,46019,55,120,28,186,0,0,28,186,0.0277280858676208,0.150537634408602
2010,46021,0,28,10,23,0,0,10,23,0.021415270018622,0.434782608695652
2010,46023,45,244,33,137,4,12,37,149,0.0258950295446646,0.248322147651007
2010,46025,1,45,21,71,0,0,21,71,0.0273814114924798,0.295774647887324
2010,46027,16,171,145,315,0,7,145,322,0.0466058763931104,0.450310559006211
2010,46029,58,418,97,234,0,0,97,234,0.0131283662477558,0.414529914529915
2010,46031,2,22,4,144,0,0,4,144,0.0645739910313901,0.0277777777777778
2010,46033,10,186,81,302,0,0,81,302,0.0488910474340295,0.268211920529801
2010,46035,190,803,36,182,0,1,36,183,0.0144264879779267,0.19672131147541
2010,46037,9,88,9,175,0,11,9,186,0.04534373476353,0.0483870967741935
2010,46039,6,43,23,99,0,10,23,109,0.0355976485956891,0.211009174311927
2010,46041,4,81,13,17,0,0,13,17,0.00567612687813022,0.764705882352941
2010,46043,4,85,8,18,0,3,8,21,0.00971322849213691,0.380952380952381
2010,46045,32,80,0,26,0,7,0,33,0.0112975008558713,0
2010,46047,22,182,99,508,0,11,99,519,0.0987630827783064,0.190751445086705
2010,46049,17,40,3,11,0,0,3,11,0.00652818991097923,0.272727272727273
2010,46051,0,72,5,87,0,0,5,87,0.0165242165242165,0.0574712643678161
2010,46053,23,56,23,72,0,0,23,72,0.0230031948881789,0.319444444444444
2010,46055,0,24,0,0,8,16,8,16,0.0109814687714482,0.5
2010,46057,13,87,3,93,6,27,9,120,0.032967032967033,0.075
2010,46059,11,67,15,30,0,3,15,33,0.012992125984252,0.454545454545455
2010,46061,2,51,0,21,0,0,0,21,0.0099103350637093,0
2010,46063,3,13,10,10,0,0,10,10,0.0114285714285714,1
2010,46065,178,472,109,245,45,61,154,306,0.0265878877400295,0.503267973856209
2010,46067,47,216,15,99,0,0,15,99,0.0188787185354691,0.151515151515152
2010,46069,0,17,9,20,0,0,9,20,0.0187617260787993,0.45
2010,46071,40,103,32,33,0,0,32,33,0.0206637445209768,0.96969696969697
2010,46073,4,39,0,9,0,0,0,9,0.00577293136626042,0
2010,46075,7,19,0,8,0,0,0,8,0.0112359550561798,0
2010,46077,16,64,16,58,0,3,16,61,0.0160484083136017,0.262295081967213
2010,46079,64,80,54,157,0,0,54,157,0.0221563646627152,0.343949044585987
2010,46081,89,329,218,435,0,0,218,435,0.0282761310452418,0.501149425287356
2010,46083,610,1687,404,649,20,47,424,696,0.0266299357208448,0.609195402298851
2010,46085,11,45,54,81,0,0,54,81,0.0351715154146765,0.666666666666667
2010,46087,25,181,12,64,0,25,12,89,0.0228029720727645,0.134831460674157
2010,46089,0,6,4,35,3,3,7,38,0.021505376344086,0.184210526315789
2010,46091,15,64,0,37,0,3,0,40,0.0128658732711483,0
2010,46093,215,824,91,605,19,59,110,664,0.0411349275182753,0.16566265060241
2010,46095,0,6,0,11,0,0,0,11,0.00918196994991653,0
2010,46097,12,48,2,12,0,2,2,14,0.00772200772200772,0.142857142857143
2010,46099,596,2364,807,2826,32,149,839,2975,0.0277136043522003,0.282016806722689
2010,46101,11,79,17,61,0,5,17,66,0.0151202749140893,0.257575757575758
2010,46103,374,1874,1041,2535,139,510,1180,3045,0.0475498922514757,0.38752052545156
2010,46105,9,41,15,49,0,2,15,51,0.023600185099491,0.294117647058824
2010,46107,1,11,0,19,0,0,0,19,0.0108077360637088,0
2010,46109,4,34,21,104,0,0,21,104,0.0162856248042593,0.201923076923077
2010,46111,13,50,8,48,0,0,8,48,0.0300375469336671,0.166666666666667
2010,46113,15,89,21,21,0,0,21,21,0.00338873648539616,1
2010,46115,10,112,19,79,0,0,19,79,0.0176142697881828,0.240506329113924
2010,46117,47,190,39,39,0,0,39,39,0.0192592592592593,1
2010,46119,19,52,3,3,0,0,3,3,0.00315789473684211,1
2010,46121,0,104,88,135,0,0,88,135,0.0295146480104941,0.651851851851852
2010,46123,10,54,84,87,0,0,84,87,0.0212609970674487,0.96551724137931
2010,46125,38,142,24,99,0,5,24,104,0.0177717019822283,0.230769230769231
2010,46127,30,164,198,549,13,13,211,562,0.0593766508188061,0.375444839857651
2010,46129,32,206,62,147,8,9,70,156,0.0387866732968672,0.448717948717949
2010,46135,126,465,57,665,0,3,57,668,0.043404808317089,0.0853293413173653
2010,46137,14,51,3,66,0,0,3,66,0.0464135021097046,0.0454545454545455
2010,47001,342,2040,325,1080,66,126,391,1206,0.0232226758068243,0.324212271973466
2010,47003,129,717,81,428,10,22,91,450,0.0156816281014776,0.202222222222222
2010,47005,22,304,237,424,0,37,237,461,0.0383750936485474,0.51409978308026
2010,47007,13,460,0,30,0,0,0,30,0.00320136591612421,0
2010,47009,556,2047,364,2160,53,266,417,2426,0.0288260456273764,0.171887881286068
2010,47011,187,936,351,1309,47,188,398,1497,0.0231411346421394,0.265865063460254
2010,47013,41,317,46,559,0,39,46,598,0.0209927683774486,0.0769230769230769
2010,47015,26,376,40,101,10,10,50,111,0.0118022328548644,0.45045045045045
2010,47017,79,617,17,359,0,7,17,366,0.0186896798243374,0.046448087431694
2010,47019,133,1094,146,682,0,18,146,700,0.017332309901701,0.208571428571429
2010,47021,120,1232,117,503,0,26,117,529,0.0203837854500617,0.22117202268431
2010,47023,13,403,12,240,0,35,12,275,0.025879917184265,0.0436363636363636
2010,47025,38,224,112,512,0,13,112,525,0.0238127636413117,0.213333333333333
2010,47027,10,129,0,63,0,0,0,63,0.0107124638666893,0
2010,47029,47,457,43,472,15,26,58,498,0.0198264193008998,0.116465863453815
2010,47031,244,922,115,589,67,67,182,656,0.018600430985596,0.277439024390244
2010,47033,59,419,23,81,3,14,26,95,0.00972862263184844,0.273684210526316
2010,47035,134,543,371,1427,0,38,371,1465,0.0360251807406679,0.253242320819113
2010,47037,3379,10983,5945,12249,1125,2430,7070,14679,0.0360553541427182,0.481640438721984
2010,47039,10,199,5,169,0,0,5,169,0.0203027390677559,0.029585798816568
2010,47041,188,682,60,197,0,41,60,238,0.0185777847162595,0.252100840336134
2010,47043,200,1212,181,760,0,75,181,835,0.0257891160664649,0.216766467065868
2010,47045,110,559,32,282,0,0,32,282,0.011070110701107,0.113475177304965
2010,47047,170,1286,60,301,13,60,73,361,0.0139678854710776,0.202216066481994
2010,47049,62,138,19,107,6,6,25,113,0.00913869793772746,0.221238938053097
2010,47051,184,739,217,482,32,75,249,557,0.0200143729787999,0.447037701974865
2010,47053,280,1079,65,475,6,40,71,515,0.0155881106604516,0.137864077669903
2010,47055,12,260,55,418,0,5,55,423,0.020861074123391,0.130023640661939
2010,47057,0,780,2,198,0,0,2,198,0.0125475285171103,0.0101010101010101
2010,47059,96,895,146,831,9,69,155,900,0.0186857676736219,0.172222222222222
2010,47061,11,155,8,57,0,0,8,57,0.00595860338699561,0.140350877192982
2010,47063,190,1264,131,906,0,150,131,1056,0.0250884987289444,0.12405303030303
2010,47065,694,2659,2276,6836,290,615,2566,7451,0.0332113518549059,0.344383304254463
2010,47067,27,166,5,36,0,0,5,36,0.00744724865535788,0.138888888888889
2010,47069,123,1297,52,179,0,23,52,202,0.0105615392659207,0.257425742574257
2010,47071,3,374,0,370,0,6,0,376,0.0206196874143131,0
2010,47073,180,1585,256,1197,19,49,275,1246,0.0313530107445711,0.220706260032103
2010,47075,27,194,0,95,0,18,0,113,0.00912320361698692,0
2010,47077,95,599,39,328,19,40,58,368,0.0194904930882898,0.157608695652174
2010,47079,14,290,94,428,87,90,181,518,0.02281837804502,0.349420849420849
2010,47081,103,1221,42,144,0,0,42,144,0.00852928981816028,0.291666666666667
2010,47083,23,89,10,77,0,0,10,77,0.0136259069191294,0.12987012987013
2010,47085,94,263,17,270,0,18,17,288,0.0226255008248881,0.0590277777777778
2010,47087,0,299,0,80,0,4,0,84,0.0101781170483461,0
2010,47089,180,1323,302,926,3,18,305,944,0.0275829827021973,0.323093220338983
2010,47091,62,345,52,273,0,0,52,273,0.0200986527276743,0.19047619047619
2010,47093,1731,5109,2898,6752,388,813,3286,7565,0.0270131298451342,0.434368803701256
2010,47095,11,670,3,85,21,28,24,113,0.0195874501646733,0.212389380530973
2010,47097,44,943,62,284,35,57,97,341,0.0186420293024273,0.284457478005865
2010,47099,63,351,31,302,3,3,34,305,0.011109896914727,0.111475409836066
2010,47101,0,375,0,124,9,74,9,198,0.0245779543197617,0.0454545454545455
2010,47103,27,331,55,428,0,44,55,472,0.0209712533878349,0.116525423728814
2010,47105,192,1069,225,907,15,64,240,971,0.0285076774023076,0.247167868177137
2010,47107,185,1133,44,468,0,113,44,581,0.0161272414367401,0.0757314974182444
2010,47109,41,231,43,441,0,57,43,498,0.0280026990553306,0.0863453815261044
2010,47111,0,254,0,255,0,75,0,330,0.0229757014551278,0
2010,47113,371,1295,433,1166,91,192,524,1358,0.0216173193250557,0.385861561119293
2010,47115,109,431,156,619,0,16,156,635,0.0322875883459602,0.245669291338583
2010,47117,98,618,81,367,0,31,81,398,0.0198424568750623,0.203517587939698
2010,47119,469,1910,204,1238,37,103,241,1341,0.0252456794307015,0.179716629381059
2010,47121,0,380,62,287,0,0,62,287,0.0351242198017379,0.21602787456446
2010,47123,87,951,125,794,5,44,130,838,0.0276558529421471,0.155131264916468
2010,47125,358,1483,1584,6649,733,1951,2317,8600,0.0879489487032643,0.269418604651163
2010,47127,14,130,0,188,0,0,0,188,0.0437718277066356,0
2010,47129,86,1234,0,68,0,0,0,68,0.00447545083585626,0
2010,47131,47,402,21,360,0,116,21,476,0.0214385443408548,0.0441176470588235
2010,47133,0,523,48,88,0,39,48,127,0.00840280534603679,0.377952755905512
2010,47135,9,73,0,118,0,0,0,118,0.0216236027121129,0
2010,47137,0,94,13,42,0,23,13,65,0.0181108943995542,0.2
2010,47139,0,483,103,234,0,23,103,257,0.0217759701745467,0.400778210116732
2010,47141,209,1162,238,1068,113,148,351,1216,0.0273615048827686,0.288651315789474
2010,47143,35,418,58,458,14,73,72,531,0.0253848360263888,0.135593220338983
2010,47145,162,1070,93,676,38,46,131,722,0.0185014350143501,0.181440443213296
2010,47147,122,1031,95,754,14,72,109,826,0.0194999881961331,0.131961259079903
2010,47149,991,5268,1184,4387,200,327,1384,4714,0.0305316813150515,0.293593551124311
2010,47151,39,103,11,92,0,0,11,92,0.00623728813559322,0.119565217391304
2010,47153,8,137,127,248,0,30,127,278,0.0294304467499471,0.456834532374101
2010,47155,237,1427,417,2436,77,162,494,2598,0.042755578961227,0.190146266358737
2010,47157,1157,3865,5227,15135,965,2121,6192,17256,0.0296521848209545,0.358831710709319
2010,47159,44,279,24,107,0,11,24,118,0.00914303424763676,0.203389830508475
2010,47161,15,228,56,179,0,38,56,217,0.0239514348785872,0.258064516129032
2010,47163,432,2290,538,3112,20,86,558,3198,0.0286520628947722,0.174484052532833
2010,47165,813,4215,910,3294,80,355,990,3649,0.0351155763419751,0.271307207454097
2010,47167,128,1380,132,1023,12,52,144,1075,0.0281974609170077,0.133953488372093
2010,47169,6,222,16,16,0,16,16,32,0.00618477000386548,0.5
2010,47171,67,299,37,271,0,19,37,290,0.0218291305984193,0.127586206896552
2010,47173,75,487,4,135,0,0,4,135,0.0104400278400742,0.0296296296296296
2010,47175,0,82,0,85,0,0,0,85,0.0221990075737791,0
2010,47177,133,364,85,365,0,79,85,444,0.0166198764738911,0.191441441441441
2010,47179,466,2632,773,2128,140,414,913,2542,0.0310617446876107,0.359166011014949
2010,47181,38,810,5,229,0,7,5,236,0.0193744355964207,0.0211864406779661
2010,47183,37,628,117,470,13,39,130,509,0.0234324647822484,0.255402750491159
2010,47185,0,398,27,289,15,15,42,304,0.0172825469016487,0.138157894736842
2010,47187,1627,3352,2372,4103,173,371,2545,4474,0.0396638238266636,0.568842199374162
2010,47189,734,2627,367,1265,49,158,416,1423,0.0192873310833706,0.292340126493324
2010,48001,325,4147,153,552,8,162,161,714,0.017364657814096,0.225490196078431
2010,48003,16,285,17,159,10,34,27,193,0.0225678203928906,0.139896373056995
2010,48005,388,2412,169,993,30,185,199,1178,0.0216910952345879,0.16893039049236
2010,48007,166,872,81,264,20,46,101,310,0.0184820843021523,0.325806451612903
2010,48009,23,162,0,40,0,21,0,61,0.0100510792552315,0
2010,48011,50,125,3,11,0,0,3,11,0.00800582241630277,0.272727272727273
2010,48013,84,933,72,413,0,18,72,431,0.0157041355438149,0.167053364269142
2010,48015,160,706,22,208,8,9,30,217,0.0117806731813246,0.138248847926267
2010,48017,76,179,60,94,6,6,66,100,0.0251635631605435,0.66
2010,48019,171,290,133,212,0,0,133,212,0.0141465367676498,0.627358490566038
2010,48021,354,1832,139,885,50,146,189,1031,0.0216264971786965,0.183317167798254
2010,48023,21,72,0,77,0,0,0,77,0.0284237726098191,0
2010,48025,107,3497,8,272,15,73,23,345,0.0161411060166557,0.0666666666666667
2010,48027,1552,5687,1953,8095,1002,5049,2955,13144,0.0763187690521121,0.224817407181984
2010,48029,7120,21897,9138,23943,3403,7362,12541,31305,0.0308197128022163,0.400606931800032
2010,48031,69,257,24,105,0,0,24,105,0.0145833333333333,0.228571428571429
2010,48033,0,0,0,0,0,4,0,4,0.0103092783505155,0
2010,48035,56,650,54,233,0,30,54,263,0.0206371625863151,0.20532319391635
2010,48037,188,1471,407,2629,24,198,431,2827,0.0466163181848163,0.152458436505129
2010,48039,2948,11549,993,3178,405,959,1398,4137,0.0215630472854641,0.337926033357505
2010,48041,1096,5083,1176,2038,1066,1588,2242,3626,0.0411143741566791,0.618312189740761
2010,48043,118,331,97,198,0,0,97,198,0.0327543424317618,0.48989898989899
2010,48045,0,16,0,10,0,0,0,10,0.00831255195344971,0
2010,48047,0,205,25,125,0,0,25,125,0.027920482465937,0.2
2010,48049,84,1274,5,130,0,47,5,177,0.00705572829466635,0.0282485875706215
2010,48051,76,493,0,118,0,0,0,118,0.0100374276964954,0
2010,48053,434,1588,76,411,0,27,76,438,0.014919272430002,0.17351598173516
2010,48055,155,2336,55,284,34,51,89,335,0.0144117014411701,0.265671641791045
2010,48057,173,658,0,257,57,57,57,314,0.02285797481255,0.181528662420382
2010,48059,158,627,0,72,0,11,0,83,0.00899826539462272,0
2010,48061,625,2726,745,2672,426,1867,1171,4539,0.0203260952312715,0.257986340603657
2010,48063,21,305,36,98,0,76,36,174,0.0216606498194946,0.206896551724138
2010,48065,48,275,38,55,0,0,38,55,0.012892639474918,0.690909090909091
2010,48067,73,452,69,359,6,32,75,391,0.0186367969494757,0.191815856777494
2010,48069,32,161,25,50,0,0,25,50,0.0105864916366716,0.5
2010,48071,125,1097,35,264,0,3,35,267,0.0130104278335445,0.131086142322097
2010,48073,107,1471,38,156,0,70,38,226,0.0070319549457046,0.168141592920354
2010,48075,32,554,0,70,0,24,0,94,0.019591496456857,0
2010,48077,69,222,24,83,0,10,24,93,0.0121823421535237,0.258064516129032
2010,48079,6,75,0,27,0,32,0,59,0.0304280556988138,0
2010,48081,0,144,3,35,0,0,3,35,0.0151777970511709,0.0857142857142857
2010,48083,31,184,19,82,0,0,19,82,0.013600928843921,0.231707317073171
2010,48085,10438,22950,6466,14276,2648,4363,9114,18639,0.0394565541826403,0.488974730403992
2010,48087,12,38,0,33,0,0,0,33,0.017590618336887,0
2010,48089,81,667,43,107,0,0,43,107,0.00758811431813347,0.401869158878505
2010,48091,1337,4818,501,1524,90,487,591,2011,0.0284188064383929,0.293883639980109
2010,48093,68,320,66,79,15,26,81,105,0.0111240597520924,0.771428571428571
2010,48095,16,318,9,217,0,210,9,427,0.13130381303813,0.0210772833723653
2010,48097,280,1115,115,620,12,90,127,710,0.0284683239775461,0.17887323943662
2010,48099,344,2624,359,1986,150,1329,509,3315,0.0772241246767768,0.153544494720965
2010,48101,8,22,37,45,0,0,37,45,0.0402864816472695,0.822222222222222
2010,48103,0,30,0,10,0,0,0,10,0.00386249517188104,0
2010,48105,0,77,0,0,0,0,0,0,0,NA
2010,48107,19,228,7,35,0,8,7,43,0.0110087045570917,0.162790697674419
2010,48109,0,43,0,10,0,28,0,38,0.0262612301313061,0
2010,48111,53,219,0,94,11,119,11,213,0.0566037735849057,0.0516431924882629
2010,48113,13915,43335,11813,25511,4565,11157,16378,36668,0.0254174667101058,0.446656485218719
2010,48115,84,656,0,29,0,3,0,32,0.00354178195904815,0
2010,48117,30,283,13,116,0,17,13,133,0.0121085214857975,0.0977443609022556
2010,48119,8,168,0,11,0,0,0,11,0.00306748466257669,0
2010,48121,8835,24464,5192,11524,1010,2098,6202,13622,0.0350736257766174,0.455292908530319
2010,48123,108,972,35,82,6,15,41,97,0.00691227820138246,0.422680412371134
2010,48125,16,286,0,71,0,9,0,80,0.0454029511918275,0
2010,48127,32,245,0,17,0,0,0,17,0.00280945298297802,0
2010,48129,20,150,0,12,0,0,0,12,0.0050547598989048,0
2010,48131,10,618,0,39,0,15,0,54,0.00721250166956057,0
2010,48133,16,679,22,190,8,38,30,228,0.0184839886501824,0.131578947368421
2010,48135,456,3131,35,1116,24,366,59,1482,0.0187540336357769,0.0398110661268556
2010,48137,22,63,0,0,0,0,0,0,0,NA
2010,48139,847,4584,337,1371,16,145,353,1516,0.0171256862700798,0.232849604221636
2010,48141,709,3636,2698,10458,1532,5422,4230,15880,0.0352065056656313,0.266372795969773
2010,48143,104,885,55,202,34,67,89,269,0.0124629355077835,0.330855018587361
2010,48145,162,895,0,78,0,0,0,78,0.00667922589484501,0
2010,48147,333,1998,16,210,0,117,16,327,0.0140693571981757,0.0489296636085627
2010,48149,52,681,59,155,4,42,63,197,0.011391892673336,0.319796954314721
2010,48151,15,106,0,36,0,0,0,36,0.0125830129325411,0
2010,48153,38,113,0,27,0,0,0,27,0.00640417457305503,0
2010,48155,0,67,5,11,0,0,5,11,0.0114226375908619,0.454545454545455
2010,48157,6037,15588,3167,5828,1393,2896,4560,8724,0.0260067014058643,0.522696011004127
2010,48159,110,411,0,26,0,0,0,26,0.00377852056387153,0
2010,48161,166,912,0,104,0,35,0,139,0.0102484701024847,0
2010,48163,81,709,0,166,0,154,0,320,0.0301318267419962,0
2010,48165,18,232,0,181,0,149,0,330,0.0356063875701338,0
2010,48167,1948,8457,1398,3736,340,653,1738,4389,0.0233622722457909,0.395989974937343
2010,48169,0,182,0,351,0,83,0,434,0.0983680870353581,0
2010,48171,147,643,17,180,0,90,17,270,0.0151515151515152,0.062962962962963
2010,48173,0,30,0,0,0,0,0,0,0,NA
2010,48175,33,296,0,0,0,0,0,0,0,NA
2010,48177,230,487,0,21,0,16,0,37,0.00293069306930693,0
2010,48179,114,1281,21,231,0,28,21,259,0.0170372319431654,0.0810810810810811
2010,48181,535,2445,330,1109,7,111,337,1220,0.0154032624614918,0.276229508196721
2010,48183,593,3826,306,1457,193,448,499,1905,0.0250108314624444,0.261942257217848
2010,48185,203,2053,0,152,0,0,0,152,0.00842105263157895,0
2010,48187,1301,4533,663,2073,166,250,829,2323,0.0296796943873053,0.356866121394748
2010,48189,103,2274,43,384,0,12,43,396,0.018319763138416,0.108585858585859
2010,48191,17,88,0,0,0,0,0,0,0,NA
2010,48193,13,379,5,35,0,0,5,35,0.00581588567630442,0.142857142857143
2010,48195,5,71,41,127,0,0,41,127,0.0376519418914913,0.322834645669291
2010,48197,3,146,0,11,0,0,0,11,0.00373007799253984,0
2010,48199,317,1963,10,447,0,46,10,493,0.0141719607899503,0.0202839756592292
2010,48201,14543,48009,17728,51661,9303,22007,27031,73668,0.0302586948360433,0.366930010316555
2010,48203,276,1605,162,676,19,71,181,747,0.0178772286705756,0.242302543507363
2010,48205,9,661,42,156,0,28,42,184,0.0412094064949608,0.228260869565217
2010,48207,30,144,0,15,0,0,0,15,0.00356718192627824,0
2010,48209,1905,6148,798,1962,64,152,862,2114,0.0253943085036097,0.407757805108798
2010,48211,0,95,7,72,0,0,7,72,0.0289855072463768,0.0972222222222222
2010,48213,447,2812,69,510,15,92,84,602,0.0111522786217117,0.13953488372093
2010,48215,970,6501,1105,5594,896,4282,2001,9876,0.0246342649754929,0.202612393681652
2010,48217,189,1165,63,282,0,50,63,332,0.0142434252863701,0.189759036144578
2010,48219,206,839,0,156,6,18,6,174,0.0126004779491636,0.0344827586206897
2010,48221,340,1537,206,784,28,103,234,887,0.024902439709144,0.263810597519729
2010,48223,129,926,50,207,0,44,50,251,0.0110392751902186,0.199203187250996
2010,48225,142,528,25,359,0,41,25,400,0.0248972986430972,0.0625
2010,48227,104,1774,102,1096,9,207,111,1303,0.0549765832665288,0.0851880276285495
2010,48229,8,118,3,39,0,3,3,42,0.0209371884346959,0.0714285714285714
2010,48231,499,2880,89,630,60,228,149,858,0.015605958638753,0.173659673659674
2010,48233,28,299,0,275,2,32,2,307,0.0214505310229178,0.00651465798045603
2010,48235,0,25,0,0,0,0,0,0,0,NA
2010,48237,69,876,0,88,0,0,0,88,0.0143979057591623,0
2010,48239,96,348,0,92,0,4,0,96,0.0104155365086254,0
2010,48241,118,1142,40,208,23,39,63,247,0.0103742282330211,0.255060728744939
2010,48243,30,109,5,24,0,0,5,24,0.0150187734668335,0.208333333333333
2010,48245,864,6406,868,2671,47,696,915,3367,0.020706620337628,0.271755271755272
2010,48247,7,74,0,68,0,25,0,93,0.0304818092428712,0
2010,48249,56,929,11,256,0,112,11,368,0.0149054234679412,0.0298913043478261
2010,48251,539,4893,231,1105,13,359,244,1464,0.0155320029281645,0.166666666666667
2010,48253,103,2431,45,172,0,10,45,182,0.0124138871836846,0.247252747252747
2010,48255,48,2091,0,169,0,201,0,370,0.0313055250021152,0
2010,48257,728,4417,143,785,81,289,224,1074,0.0172435938603815,0.208566108007449
2010,48259,574,1457,85,324,0,80,85,404,0.0186020812229487,0.21039603960396
2010,48261,0,0,0,0,0,0,0,0,0,NA
2010,48263,10,51,0,18,0,0,0,18,0.0319715808170515,0
2010,48265,503,1762,142,522,23,52,165,574,0.0164961489826417,0.287456445993031
2010,48267,134,567,0,7,0,0,0,7,0.00203252032520325,0
2010,48269,0,20,0,0,0,0,0,0,0,NA
2010,48271,41,278,6,22,0,33,6,55,0.0220794861501405,0.109090909090909
2010,48273,294,815,115,391,78,106,193,497,0.02791037232549,0.388329979879276
2010,48275,0,132,0,17,0,0,0,17,0.00624082232011747,0
2010,48277,207,874,110,704,16,82,126,786,0.0239985344406448,0.16030534351145
2010,48279,74,490,46,108,0,6,46,114,0.0130899069927661,0.403508771929825
2010,48281,158,769,61,211,33,81,94,292,0.0221800227876946,0.321917808219178
2010,48283,39,577,0,19,0,0,0,19,0.00440426518312471,0
2010,48285,58,448,0,26,0,0,0,26,0.00192435793057509,0
2010,48287,69,731,54,270,0,0,54,270,0.0250370919881306,0.2
2010,48289,80,528,22,166,0,2,22,168,0.0142312579415502,0.130952380952381
2010,48291,478,5202,46,677,51,171,97,848,0.0175391424848497,0.11438679245283
2010,48293,83,1375,11,247,0,230,11,477,0.0301421800947867,0.0230607966457023
2010,48295,8,76,46,126,0,0,46,126,0.06158357771261,0.365079365079365
2010,48297,52,672,0,122,0,26,0,148,0.0179677066893286,0
2010,48299,157,649,0,157,0,0,0,157,0.0106016611520022,0
2010,48301,0,3,0,0,0,0,0,0,0,NA
2010,48303,1413,5800,1005,2556,206,534,1211,3090,0.0196561134329498,0.391909385113269
2010,48305,14,108,11,47,0,3,11,50,0.0129836406128278,0.22
2010,48307,109,318,0,33,0,0,0,33,0.00583967439391258,0
2010,48309,1159,3843,403,2131,164,512,567,2643,0.0192719954499716,0.214528944381385
2010,48311,4,33,0,12,0,0,0,12,0.0185185185185185,0
2010,48313,83,646,0,19,0,34,0,53,0.005973177053984,0
2010,48315,21,356,22,40,0,0,22,40,0.0049609326553392,0.55
2010,48317,54,172,0,24,0,20,0,44,0.0154277699859748,0
2010,48319,25,65,0,0,0,0,0,0,0,NA
2010,48321,46,993,22,255,0,94,22,349,0.0148302383886457,0.0630372492836676
2010,48323,97,495,10,244,23,195,33,439,0.015026527468766,0.0751708428246014
2010,48325,134,1162,11,167,15,15,26,182,0.00628040995203423,0.142857142857143
2010,48327,0,75,0,5,0,2,0,7,0.00425273390036452,0
2010,48329,726,3394,548,1143,112,275,660,1418,0.017326279004411,0.465444287729196
2010,48331,116,684,0,60,0,59,0,119,0.00720077453709307,0
2010,48333,29,118,9,9,0,0,9,9,0.00253307064452575,1
2010,48335,59,1300,5,42,0,1,5,43,0.00659509202453988,0.116279069767442
2010,48337,168,609,0,96,9,22,9,118,0.00857433512570847,0.076271186440678
2010,48339,4076,14945,3130,7130,1217,2355,4347,9485,0.0346508068139889,0.45830258302583
2010,48341,79,382,76,482,0,146,76,628,0.0512904279647174,0.121019108280255
2010,48343,99,488,23,83,0,13,23,96,0.0107059217129475,0.239583333333333
2010,48345,0,17,0,5,0,0,0,5,0.00637755102040816,0
2010,48347,419,1588,111,563,13,63,124,626,0.0176085060898428,0.198083067092652
2010,48349,210,1458,49,231,19,99,68,330,0.010928599814545,0.206060606060606
2010,48351,96,676,0,101,0,3,0,104,0.0105188631536361,0
2010,48353,122,317,3,90,0,4,3,94,0.00952670517887909,0.0319148936170213
2010,48355,1183,6518,1789,4058,307,933,2096,4991,0.0235993361356855,0.419955920657183
2010,48357,71,267,44,290,24,182,68,472,0.0804911323328786,0.144067796610169
2010,48359,6,17,0,11,0,0,0,11,0.00882117080994387,0
2010,48361,228,1939,60,658,21,100,81,758,0.0140012560493554,0.106860158311346
2010,48363,120,1142,22,127,0,3,22,130,0.0069836153639538,0.169230769230769
2010,48365,23,394,24,244,0,8,24,252,0.0162120432321153,0.0952380952380952
2010,48367,522,4799,555,1543,38,172,593,1715,0.0233858321401786,0.345772594752187
2010,48369,110,275,25,103,0,40,25,143,0.0237659963436929,0.174825174825175
2010,48371,57,990,0,71,0,27,0,98,0.00966183574879227,0
2010,48373,163,1938,6,287,16,46,22,333,0.0102483611854861,0.0660660660660661
2010,48375,786,5188,418,1971,90,465,508,2436,0.0326414664540594,0.208538587848933
2010,48377,14,123,5,36,4,47,9,83,0.0173967721651645,0.108433734939759
2010,48379,21,479,0,42,0,0,0,42,0.00547802269466545,0
2010,48381,969,4163,252,802,39,88,291,890,0.0119826588038883,0.326966292134831
2010,48383,28,80,0,11,0,0,0,11,0.00573514077163712,0
2010,48385,0,126,0,17,0,0,0,17,0.00735612289052358,0
2010,48387,33,269,13,78,0,34,13,112,0.01212908815248,0.116071428571429
2010,48389,144,436,0,107,0,65,0,172,0.0215107553776888,0
2010,48391,55,389,0,1,0,0,0,1,0.000198255352894528,0
2010,48393,17,17,7,21,0,0,7,21,0.0340909090909091,0.333333333333333
2010,48395,57,520,37,85,0,0,37,85,0.00770136812539639,0.435294117647059
2010,48397,1079,3834,400,979,93,302,493,1281,0.0276280032782642,0.384855581576893
2010,48399,35,227,0,13,5,17,5,30,0.00414823008849558,0.166666666666667
2010,48401,412,3860,98,411,6,56,104,467,0.0132980238054559,0.222698072805139
2010,48403,79,395,0,38,0,0,0,38,0.00483829895594601,0
2010,48405,12,174,0,81,0,0,0,81,0.0131067961165049,0
2010,48407,30,802,3,124,49,49,52,173,0.00981671679055779,0.300578034682081
2010,48409,256,2223,150,922,47,186,197,1108,0.0270224129941712,0.177797833935018
2010,48411,18,84,0,18,0,0,0,18,0.00445765230312036,0
2010,48413,14,110,8,22,0,0,8,22,0.0105011933174224,0.363636363636364
2010,48415,53,504,28,200,0,10,28,210,0.0196463654223969,0.133333333333333
2010,48417,4,38,0,0,0,0,0,0,0,NA
2010,48419,89,517,3,184,0,12,3,196,0.0117119808783986,0.0153061224489796
2010,48421,16,78,16,42,5,27,21,69,0.0371367061356297,0.304347826086957
2010,48423,1506,5375,573,1779,165,463,738,2242,0.0173584496628187,0.329170383586084
2010,48425,36,227,0,104,0,17,0,121,0.0227700414000753,0
2010,48427,102,738,15,205,14,98,29,303,0.00923048802778285,0.0957095709570957
2010,48429,125,703,0,43,22,52,22,95,0.0149300644350149,0.231578947368421
2010,48431,9,54,0,13,0,0,0,13,0.0173333333333333,0
2010,48433,11,27,0,0,0,0,0,0,0,NA
2010,48435,8,114,0,39,0,0,0,39,0.0149827122550903,0
2010,48437,24,555,0,18,0,11,0,29,0.0057780434349472,0
2010,48439,9698,34298,8253,24442,2238,6460,10491,30902,0.0284567407261432,0.339492589476409
2010,48441,835,3148,610,1707,92,477,702,2184,0.0276595744680851,0.321428571428571
2010,48443,12,40,0,0,0,0,0,0,0,NA
2010,48445,33,769,0,31,23,31,23,62,0.00786602385181426,0.370967741935484
2010,48447,0,7,0,9,0,0,0,9,0.0068649885583524,0
2010,48449,172,887,11,428,2,49,13,477,0.025755939524838,0.0272536687631027
2010,48451,547,2318,556,2283,17,376,573,2659,0.0395637424116177,0.215494546822114
2010,48453,10880,24797,11989,19965,2931,6630,14920,26595,0.0428104380524349,0.56100770821583
2010,48455,49,410,0,62,0,38,0,100,0.00984930562395351,0
2010,48457,183,903,18,233,0,0,18,233,0.0152686762778506,0.0772532188841202
2010,48459,134,1070,29,223,0,33,29,256,0.0098208462807381,0.11328125
2010,48461,27,336,0,101,0,0,0,101,0.0433290433290433,0
2010,48463,94,505,14,77,0,47,14,124,0.00767374218701652,0.112903225806452
2010,48465,94,779,365,924,15,112,380,1036,0.0361908754279327,0.366795366795367
2010,48467,193,1818,20,185,0,12,20,197,0.00551126031612813,0.101522842639594
2010,48469,338,2499,46,509,80,128,126,637,0.0116141265702773,0.197802197802198
2010,48471,535,6191,123,432,28,50,151,482,0.0115112724493695,0.313278008298755
2010,48473,90,985,48,484,0,54,48,538,0.0228159457167091,0.0892193308550186
2010,48475,32,352,2,102,0,0,2,102,0.0151740553406724,0.0196078431372549
2010,48477,218,932,15,25,0,56,15,81,0.00373048404181827,0.185185185185185
2010,48479,329,1963,465,1293,452,1420,917,2713,0.0211153052885551,0.338002211573903
2010,48481,173,759,0,97,14,87,14,184,0.00699114708005623,0.0760869565217391
2010,48483,14,171,12,65,0,0,12,65,0.0185767362103458,0.184615384615385
2010,48485,357,3131,449,2138,75,514,524,2652,0.0324375894418827,0.197586726998492
2010,48487,60,438,0,123,0,0,0,123,0.0147041243275553,0
2010,48489,6,851,36,156,0,30,36,186,0.0142332415059688,0.193548387096774
2010,48491,5685,16361,3639,8193,690,1622,4329,9815,0.0394988892823798,0.441059602649007
2010,48493,241,1349,51,252,0,30,51,282,0.0104386451971127,0.180851063829787
2010,48495,3,225,0,98,0,18,0,116,0.0271472033699977,0
2010,48497,457,2168,38,522,6,89,44,611,0.0162638415672913,0.072013093289689
2010,48499,240,1674,52,215,0,18,52,233,0.00792463097748452,0.223175965665236
2010,48501,0,92,0,35,0,5,0,40,0.00855249091297841,0
2010,48503,84,647,49,340,0,32,49,372,0.0296249104085371,0.131720430107527
2010,48505,0,1,1,141,0,0,1,141,0.0187275866648957,0.00709219858156028
2010,48507,0,223,5,182,0,107,5,289,0.0446676970633694,0.0173010380622837
2010,49001,0,184,0,139,0,14,0,153,0.0405190677966102,0
2010,49003,209,822,85,399,31,84,116,483,0.0175330332510527,0.240165631469979
2010,49005,453,1367,771,2045,304,479,1075,2524,0.0468161667872313,0.425911251980983
2010,49007,33,454,55,276,0,13,55,289,0.0220863584256783,0.190311418685121
2010,49009,13,71,35,43,0,0,35,43,0.0671875,0.813953488372093
2010,49011,2329,6283,1786,4398,204,702,1990,5100,0.0310875144008339,0.390196078431373
2010,49013,75,404,25,178,10,23,35,201,0.020190858864892,0.174129353233831
2010,49015,28,68,68,219,0,0,68,219,0.0345208070617907,0.310502283105023
2010,49017,8,100,21,85,0,1,21,86,0.0260133091349062,0.244186046511628
2010,49019,0,156,60,220,0,0,60,220,0.0355756791720569,0.272727272727273
2010,49021,315,667,155,721,29,51,184,772,0.0336676842564326,0.238341968911917
2010,49023,46,181,0,80,12,12,12,92,0.0169024435054198,0.130434782608696
2010,49025,1,162,86,264,0,0,86,264,0.0553575172992242,0.325757575757576
2010,49027,93,244,27,61,0,18,27,79,0.0108770480517692,0.341772151898734
2010,49029,17,104,4,47,0,0,4,47,0.00920846394984326,0.0851063829787234
2010,49031,0,13,8,15,0,0,8,15,0.014792899408284,0.533333333333333
2010,49033,15,36,0,0,0,0,0,0,0,NA
2010,49035,3274,10101,6562,16718,1300,4093,7862,20811,0.0346995159641783,0.377780981211859
2010,49037,39,377,118,185,24,24,142,209,0.0256064690026954,0.679425837320574
2010,49039,150,1100,44,389,0,21,44,410,0.0285714285714286,0.107317073170732
2010,49041,26,375,69,231,16,16,85,247,0.0204334877564527,0.34412955465587
2010,49043,146,408,552,947,120,156,672,1103,0.0482354484628504,0.609247506799637
2010,49045,121,1367,283,1027,15,40,298,1067,0.0344237966189186,0.279287722586692
2010,49047,83,756,90,512,0,0,90,512,0.0289871482760573,0.17578125
2010,49049,1498,5025,2610,6571,1019,1882,3629,8453,0.0361273282103446,0.429315036081864
2010,49051,97,392,81,396,0,12,81,408,0.0319874558996472,0.198529411764706
2010,49053,584,2465,771,3127,89,292,860,3419,0.0427316244016448,0.251535536706639
2010,49055,20,61,12,45,7,114,19,159,0.0908571428571429,0.119496855345912
2010,49057,919,4383,925,2949,12,215,937,3164,0.023942489595157,0.29614412136536
2010,50001,173,436,281,520,19,50,300,570,0.0235410729773262,0.526315789473684
2010,50003,51,221,305,790,0,0,305,790,0.0302832828611952,0.386075949367089
2010,50005,149,524,227,370,0,2,227,372,0.0174443141852286,0.610215053763441
2010,50007,599,1510,1787,3024,174,474,1961,3498,0.0352429121244484,0.560606060606061
2010,50009,32,93,45,138,6,6,51,144,0.030729833546735,0.354166666666667
2010,50011,132,558,112,450,10,68,122,518,0.0162062384632231,0.235521235521236
2010,50013,39,125,59,161,0,7,59,168,0.0324574961360124,0.351190476190476
2010,50015,34,336,307,554,13,28,320,582,0.0356923831718386,0.549828178694158
2010,50017,115,379,149,380,47,52,196,432,0.0212483399734396,0.453703703703704
2010,50019,44,398,111,303,15,71,126,374,0.0194720674753996,0.336898395721925
2010,50021,88,524,335,944,25,45,360,989,0.0226626947754354,0.364004044489383
2010,50023,321,860,608,983,34,84,642,1067,0.0259112654508366,0.601686972820993
2010,50025,99,275,806,1200,37,88,843,1288,0.0408435072142064,0.654503105590062
2010,50027,270,875,962,1657,38,131,1000,1788,0.0430770713373648,0.559284116331096
2010,51001,19,179,146,467,0,0,146,467,0.0192839740678036,0.312633832976445
2010,51003,1513,2776,1738,2472,256,532,1994,3004,0.0475120994527568,0.663781624500666
2010,51005,94,462,0,139,0,20,0,159,0.0135422877097351,0
2010,51007,37,177,0,53,0,49,0,102,0.0118370662643611,0
2010,51009,114,771,63,308,0,36,63,344,0.0156898517673888,0.183139534883721
2010,51011,29,428,8,115,0,0,8,115,0.0112546486592288,0.0695652173913043
2010,51013,3791,5578,8801,11138,2047,2756,10848,13894,0.0948978894884229,0.780768677126817
2010,51015,164,1437,107,299,34,58,141,357,0.0068577356025971,0.394957983193277
2010,51017,0,51,0,9,0,0,0,9,0.00246103363412633,0
2010,51019,208,1587,209,624,30,52,239,676,0.0141330936003847,0.353550295857988
2010,51021,21,159,14,57,0,0,14,57,0.011040092969204,0.245614035087719
2010,51023,149,714,41,129,0,10,41,139,0.00594347286954291,0.294964028776978
2010,51025,25,302,36,110,0,0,36,110,0.00886882205917923,0.327272727272727
2010,51027,11,60,24,305,0,0,24,305,0.0168676031412454,0.0786885245901639
2010,51029,273,1065,32,266,11,19,43,285,0.020692659551296,0.150877192982456
2010,51031,195,1316,165,470,0,0,165,470,0.0127223019245865,0.351063829787234
2010,51033,156,1029,19,204,0,14,19,218,0.0115846529918163,0.0871559633027523
2010,51035,9,270,58,420,0,0,58,420,0.0189985072601438,0.138095238095238
2010,51036,2,118,37,56,0,1,37,57,0.0108447488584475,0.649122807017544
2010,51037,53,214,3,26,0,1,3,27,0.00311886334757999,0.111111111111111
2010,51041,2232,7456,1928,4196,365,770,2293,4966,0.0247479605109063,0.461739830849778
2010,51043,74,484,106,364,0,0,106,364,0.036586591617248,0.291208791208791
2010,51045,37,74,14,32,0,0,14,32,0.0087431693989071,0.4375
2010,51047,363,1671,166,585,16,140,182,725,0.0239123981661664,0.251034482758621
2010,51049,81,418,0,94,12,19,12,113,0.0168305034256777,0.106194690265487
2010,51051,15,152,26,153,0,11,26,164,0.014637629418065,0.158536585365854
2010,51053,66,664,73,137,0,13,73,150,0.008058017727639,0.486666666666667
2010,51057,34,342,19,65,0,0,19,65,0.00853018372703412,0.292307692307692
2010,51059,10823,20906,15427,23688,5697,9584,21124,33272,0.0468891146846978,0.634888194277471
2010,51061,397,1768,258,691,13,93,271,784,0.0181146025878004,0.345663265306122
2010,51063,28,167,108,155,0,0,108,155,0.0143945022288262,0.696774193548387
2010,51065,256,734,38,187,0,54,38,241,0.0134591756952977,0.157676348547718
2010,51067,194,1329,104,448,0,43,104,491,0.0126614920446633,0.211812627291242
2010,51069,416,2348,317,1142,33,61,350,1203,0.0237161163134549,0.29093931837074
2010,51071,37,339,38,307,8,34,46,341,0.027948528809114,0.134897360703812
2010,51073,124,1024,73,478,18,117,91,595,0.0234067663257278,0.152941176470588
2010,51075,162,559,141,193,6,8,147,201,0.0123373434814633,0.73134328358209
2010,51077,46,355,22,238,0,0,22,238,0.0202846671780448,0.092436974789916
2010,51079,134,401,138,311,18,48,156,359,0.0293876882776686,0.434540389972145
2010,51081,22,269,0,70,0,0,0,70,0.00803858520900321,0
2010,51083,125,474,124,519,3,14,127,533,0.0208659567804572,0.23827392120075
2010,51085,731,2602,269,770,14,131,283,901,0.0136896803208946,0.314095449500555
2010,51087,3609,9823,2508,4476,805,1555,3313,6031,0.029872850923032,0.549328469573868
2010,51089,112,1410,19,416,0,54,19,470,0.0119383271101628,0.0404255319148936
2010,51091,15,128,12,29,0,0,12,29,0.0147582697201018,0.413793103448276
2010,51093,280,920,182,418,62,109,244,527,0.0216961712638946,0.462998102466793
2010,51095,919,2218,825,1611,145,312,970,1923,0.0420383001049318,0.504420176807072
2010,51097,38,85,0,0,0,0,0,0,0,NA
2010,51099,98,633,292,832,13,75,305,907,0.0619070370623166,0.336273428886439
2010,51101,73,400,0,27,0,0,0,27,0.00259341081548362,0
2010,51103,35,127,19,37,16,19,35,56,0.00619949075611646,0.625
2010,51105,0,254,56,418,0,40,56,458,0.0253978816613985,0.122270742358079
2010,51107,4234,7330,3829,6182,999,2168,4828,8350,0.0450885842184555,0.578203592814371
2010,51109,160,515,36,245,10,37,46,282,0.0123662515348185,0.163120567375887
2010,51111,31,457,18,69,0,9,18,78,0.0084251458198315,0.230769230769231
2010,51113,53,212,35,81,0,0,35,81,0.00862068965517241,0.432098765432099
2010,51115,44,285,0,30,0,0,0,30,0.00448095593726662,0
2010,51117,100,894,26,257,37,109,63,366,0.0153324117129571,0.172131147540984
2010,51119,42,221,0,33,33,33,33,66,0.00785714285714286,0.5
2010,51121,728,1831,758,1380,154,254,912,1634,0.0340352850507197,0.558139534883721
2010,51125,85,397,0,157,0,0,0,157,0.0140216129320354,0
2010,51127,274,1268,31,135,0,0,31,135,0.0107475519465011,0.22962962962963
2010,51131,20,193,11,121,0,22,11,143,0.0157784398102174,0.0769230769230769
2010,51133,63,218,59,88,37,37,96,125,0.01288394145537,0.768
2010,51135,34,523,43,80,0,79,43,159,0.0142281879194631,0.270440251572327
2010,51137,405,1414,123,472,15,27,138,499,0.0216890511583431,0.276553106212425
2010,51139,13,420,64,161,8,101,72,262,0.0154408297972654,0.274809160305344
2010,51141,5,236,0,53,0,0,0,53,0.00391374981538916,0
2010,51143,246,1144,146,769,0,50,146,819,0.0182458172744893,0.178266178266178
2010,51145,126,2548,90,408,0,5,90,413,0.0202025143080761,0.217917675544794
2010,51147,94,547,167,276,61,61,228,337,0.0268119977722969,0.676557863501484
2010,51149,201,1207,244,1126,14,149,258,1275,0.0554733727810651,0.202352941176471
2010,51153,3833,10530,3641,8280,663,1467,4304,9747,0.0413279908414425,0.441571765671489
2010,51155,189,1242,71,384,0,31,71,415,0.0162248807569005,0.171084337349398
2010,51157,0,106,22,32,49,63,71,95,0.0177404295051354,0.747368421052632
2010,51159,29,303,0,166,0,0,0,166,0.0242938679935607,0
2010,51161,905,3401,462,1109,73,215,535,1324,0.0205007509716179,0.404078549848943
2010,51163,195,430,37,231,0,0,37,231,0.0143193652367964,0.16017316017316
2010,51165,537,1707,214,727,80,167,294,894,0.0177068272296936,0.328859060402685
2010,51167,28,464,0,241,0,0,0,241,0.0116532082587883,0
2010,51169,47,357,7,295,0,12,7,307,0.018266198607723,0.0228013029315961
2010,51171,327,1203,76,522,24,151,100,673,0.0230211397687624,0.148588410104012
2010,51173,114,681,174,393,13,13,187,406,0.0177238398742742,0.460591133004926
2010,51175,60,567,25,132,0,2,25,134,0.0102469985470674,0.186567164179104
2010,51177,798,3218,499,1840,73,245,572,2085,0.0274428766979046,0.274340527577938
2010,51179,1068,3447,2100,4130,329,631,2429,4761,0.062549266908403,0.510186935517748
2010,51181,2,179,2,34,0,0,2,34,0.00710702341137124,0.0588235294117647
2010,51183,17,402,40,107,0,7,40,114,0.0136151916875672,0.350877192982456
2010,51185,10,359,69,696,0,2,69,698,0.021734392028647,0.0988538681948424
2010,51187,120,925,158,356,14,58,172,414,0.0166425470332851,0.415458937198068
2010,51191,98,671,295,884,18,30,313,914,0.0233163265306122,0.342450765864333
2010,51193,103,356,36,250,0,0,36,250,0.0200096046102129,0.144
2010,51195,4,603,32,734,0,20,32,754,0.0262534818941504,0.0424403183023873
2010,51197,0,347,60,252,0,0,60,252,0.0121745011836321,0.238095238095238
2010,51199,559,1490,856,1659,242,606,1098,2265,0.053561293984109,0.48476821192053
2010,51510,3331,5768,5478,7874,1043,1751,6521,9625,0.0952706180464822,0.677506493506494
2010,51515,46,251,0,26,0,0,0,26,0.00625,0
2010,51520,49,855,174,1018,0,0,174,1018,0.0817276814386641,0.170923379174853
2010,51530,35,413,0,77,12,12,12,89,0.0208528584817245,0.134831460674157
2010,51540,905,2427,657,867,283,386,940,1253,0.0528781228899392,0.750199521149242
2010,51550,1450,6002,1387,3802,291,659,1678,4461,0.0315606273921626,0.376148845550325
2010,51570,109,499,37,211,19,66,56,277,0.0229399585921325,0.202166064981949
2010,51580,103,565,9,25,0,0,9,25,0.0060313630880579,0.36
2010,51590,223,1440,219,663,36,113,255,776,0.025804735301942,0.32860824742268
2010,51595,8,195,9,81,0,0,9,81,0.0205219153787687,0.111111111111111
2010,51600,592,1154,366,460,108,138,474,598,0.0385731793846352,0.792642140468227
2010,51610,367,625,284,329,175,222,459,551,0.0712162336823058,0.833030852994555
2010,51620,62,326,43,150,0,0,43,150,0.0264363764540007,0.286666666666667
2010,51630,328,1259,257,395,14,14,271,409,0.0308051517662122,0.662591687041565
2010,51640,28,460,9,53,0,9,9,62,0.0117402007195607,0.145161290322581
2010,51650,520,3700,703,2415,138,319,841,2734,0.0307028872393231,0.30760790051207
2010,51660,461,2365,374,880,129,447,503,1327,0.0651768172888016,0.379050489826677
2010,51670,98,817,87,253,11,42,98,295,0.0200149263857792,0.332203389830508
2010,51678,119,175,66,112,51,68,117,180,0.0602611315701373,0.65
2010,51680,542,2369,408,1038,122,180,530,1218,0.0284852311794008,0.435139573070608
2010,51683,560,2346,97,379,17,100,114,479,0.0214894571556752,0.237995824634656
2010,51685,284,926,159,218,21,50,180,268,0.0331273176761434,0.671641791044776
2010,51690,51,1076,29,215,0,12,29,227,0.0229873417721519,0.127753303964758
2010,51700,1546,6218,1230,4963,387,1130,1617,6093,0.0543809073302214,0.265386509108813
2010,51710,1409,6018,1939,6037,351,885,2290,6922,0.0486457615921964,0.330829240104016
2010,51720,10,188,0,58,0,0,0,58,0.0226739640344019,0
2010,51730,56,617,38,325,0,0,38,325,0.0150728132826268,0.116923076923077
2010,51735,97,346,51,58,0,0,51,58,0.00706972208678693,0.879310344827586
2010,51740,693,3631,334,1553,88,160,422,1713,0.0273489263191506,0.246351430239346
2010,51750,82,397,72,231,0,71,72,302,0.0464901477832512,0.23841059602649
2010,51760,2571,7430,1602,3075,166,782,1768,3857,0.0302597616563238,0.458387347679544
2010,51770,861,3431,535,1392,14,158,549,1550,0.0232669848989763,0.354193548387097
2010,51775,380,1410,107,373,22,32,129,405,0.0247721573184904,0.318518518518519
2010,51790,525,1655,67,258,11,23,78,281,0.0166301710362786,0.277580071174377
2010,51800,457,1690,403,1261,24,97,427,1358,0.0250530393875104,0.314432989690722
2010,51810,2326,9238,3670,10307,934,2733,4604,13040,0.0463028719143255,0.353067484662577
2010,51820,69,632,100,379,0,7,100,386,0.0271048381433888,0.259067357512953
2010,51830,175,475,180,334,22,132,202,466,0.0748113661903997,0.433476394849785
2010,51840,390,1679,230,536,8,996,238,1532,0.0898639136555608,0.155352480417755
2010,53001,17,270,10,137,9,80,19,217,0.0216934919524143,0.0875576036866359
2010,53003,97,263,88,579,46,60,134,639,0.0428169391584026,0.209702660406886
2010,53005,673,4041,1117,3350,194,502,1311,3852,0.0362104946511497,0.340342679127726
2010,53007,447,1826,324,836,0,145,324,981,0.0209097109728025,0.330275229357798
2010,53009,321,1705,506,1637,30,98,536,1735,0.033064623711242,0.308933717579251
2010,53011,841,3162,3809,11510,375,1331,4184,12841,0.0477683786055993,0.325831321548166
2010,53013,33,217,9,42,0,15,9,57,0.0196280991735537,0.157894736842105
2010,53015,380,2222,426,2081,73,207,499,2288,0.0335326533005042,0.218094405594406
2010,53017,167,1373,19,163,21,134,40,297,0.0124685138539043,0.134680134680135
2010,53019,15,164,9,79,3,6,12,85,0.0166601332810662,0.141176470588235
2010,53021,313,2276,233,948,20,236,253,1184,0.0299640633699448,0.213682432432432
2010,53023,19,66,13,67,0,0,13,67,0.0413325107958051,0.194029850746269
2010,53025,242,1383,151,698,49,339,200,1037,0.0205070400253125,0.192864030858245
2010,53027,181,2048,129,591,24,109,153,700,0.0140480443115455,0.218571428571429
2010,53029,455,1522,650,2145,211,523,861,2668,0.0488752106690115,0.322713643178411
2010,53031,188,831,159,691,48,61,207,752,0.0320518284886199,0.275265957446808
2010,53033,6889,20966,22763,37960,8650,14386,31413,52346,0.0402743326337041,0.600103159744775
2010,53035,917,4299,1688,4664,276,1591,1964,6255,0.0378849822840011,0.313988808952838
2010,53037,311,995,147,323,13,19,160,342,0.0148039130811185,0.467836257309941
2010,53039,54,299,90,376,0,13,90,389,0.0270891364902507,0.231362467866324
2010,53041,206,1516,136,894,14,70,150,964,0.0189965711583179,0.155601659751037
2010,53043,27,344,39,98,6,6,45,104,0.0138888888888889,0.432692307692308
2010,53045,353,2501,296,633,32,56,328,689,0.0162262729028308,0.476052249637155
2010,53047,75,489,156,466,0,35,156,501,0.0181548050442093,0.311377245508982
2010,53049,45,441,95,402,7,56,102,458,0.0287363533693061,0.222707423580786
2010,53051,38,260,53,214,0,19,53,233,0.0251456939348155,0.227467811158798
2010,53053,3268,14964,4215,12786,1357,4239,5572,17025,0.0336366061108971,0.327283406754772
2010,53055,143,345,105,259,22,46,127,305,0.0247103621485862,0.416393442622951
2010,53057,623,2297,318,1289,81,399,399,1688,0.0216618543471286,0.236374407582938
2010,53059,26,161,18,189,0,36,18,225,0.029454117031025,0.08
2010,53061,5973,18051,3623,9635,1055,2802,4678,12437,0.0270495992692237,0.376135724049208
2010,53063,1286,6094,2831,8536,316,1131,3147,9667,0.0322403132316353,0.325540498603496
2010,53065,141,689,98,472,2,54,100,526,0.0176794837321861,0.190114068441065
2010,53067,1324,5006,1796,4323,412,1627,2208,5950,0.0361706525307299,0.37109243697479
2010,53069,71,103,0,53,0,0,0,53,0.0175729442970822,0
2010,53071,230,1744,277,1298,46,148,323,1446,0.0389285233544219,0.223374827109267
2010,53073,844,2252,916,2666,331,662,1247,3328,0.0266084606589752,0.374699519230769
2010,53075,476,918,486,878,209,262,695,1140,0.0538675991116571,0.609649122807018
2010,53077,407,2683,755,2696,104,813,859,3509,0.0248796432192514,0.244799088059276
2010,54001,28,175,10,166,0,0,10,166,0.0148095280578107,0.0602409638554217
2010,54003,128,911,553,2482,29,169,582,2651,0.0392636037797328,0.219539796303282
2010,54005,27,411,0,126,0,0,0,126,0.00724762726488352,0
2010,54007,19,474,2,212,0,0,2,212,0.0204238921001927,0.00943396226415094
2010,54009,23,204,12,187,0,35,12,222,0.0127718329306179,0.0540540540540541
2010,54011,209,966,483,1979,73,105,556,2084,0.032237605383247,0.26679462571977
2010,54013,0,173,23,95,0,0,23,95,0.0172790105492907,0.242105263157895
2010,54015,0,281,0,17,0,0,0,17,0.00258319404345844,0
2010,54017,0,124,0,112,3,3,3,115,0.0205210563882941,0.0260869565217391
2010,54019,62,607,97,576,4,13,101,589,0.0179732080192853,0.171477079796265
2010,54021,0,208,100,569,0,30,100,599,0.102061680013631,0.1669449081803
2010,54023,0,203,14,108,0,0,14,108,0.0126849894291755,0.12962962962963
2010,54025,29,289,319,695,6,6,325,701,0.0274170838548185,0.463623395149786
2010,54027,43,136,22,401,0,0,22,401,0.0242941960499212,0.0548628428927681
2010,54029,27,383,198,819,0,24,198,843,0.0372382719321495,0.234875444839858
2010,54031,0,86,0,112,0,9,0,121,0.0135574229691877,0
2010,54033,172,1017,227,770,0,30,227,800,0.0165899382024802,0.28375
2010,54035,94,389,0,191,0,0,0,191,0.00938482704402516,0
2010,54037,61,424,311,1040,43,145,354,1185,0.0343677494199536,0.29873417721519
2010,54039,764,2628,771,2500,33,184,804,2684,0.0194628147116835,0.299552906110283
2010,54041,14,302,17,282,0,0,17,282,0.0238316572297811,0.0602836879432624
2010,54043,25,235,0,195,0,38,0,233,0.0152917240926692,0
2010,54045,46,496,14,367,0,8,14,375,0.0142780992994213,0.0373333333333333
2010,54047,33,194,0,121,0,0,0,121,0.00747975520801137,0
2010,54049,245,567,96,519,16,71,112,590,0.0150953051042599,0.189830508474576
2010,54051,43,629,35,414,0,8,35,422,0.0176561650140162,0.0829383886255924
2010,54053,27,409,27,362,0,0,27,362,0.0188169248362616,0.074585635359116
2010,54055,158,968,202,971,0,127,202,1098,0.0250982902075523,0.183970856102004
2010,54057,9,123,53,531,0,0,53,531,0.0275101025800435,0.0998116760828625
2010,54059,42,268,36,343,0,0,36,343,0.0182514766136327,0.104956268221574
2010,54061,324,746,760,1538,162,272,922,1810,0.0343394866151891,0.50939226519337
2010,54063,36,214,53,210,0,0,53,210,0.0215849522047487,0.252380952380952
2010,54065,16,142,16,306,0,4,16,310,0.0246933248367054,0.0516129032258065
2010,54067,42,264,19,210,0,30,19,240,0.0128404044727409,0.0791666666666667
2010,54069,93,355,322,839,6,14,328,853,0.0274135492993958,0.384525205158265
2010,54071,7,30,55,86,3,110,58,196,0.0339276441059373,0.295918367346939
2010,54073,29,301,0,46,0,0,0,46,0.00839569264464318,0
2010,54075,29,118,0,156,67,86,67,242,0.0366944655041698,0.276859504132231
2010,54077,47,574,99,686,0,10,99,696,0.0292682926829268,0.142241379310345
2010,54079,244,1281,123,335,18,37,141,372,0.00970721778612807,0.379032258064516
2010,54081,234,1391,189,1589,8,70,197,1659,0.0296732189808439,0.118746232670283
2010,54083,96,877,0,215,0,7,0,222,0.0106037447458922,0
2010,54085,2,151,14,113,0,0,14,113,0.0149867374005305,0.123893805309735
2010,54087,0,202,5,254,0,0,5,254,0.0236015610481323,0.0196850393700787
2010,54089,23,261,47,533,0,9,47,542,0.0519654841802493,0.0867158671586716
2010,54091,99,453,16,79,0,12,16,91,0.00760360962566845,0.175824175824176
2010,54093,30,75,22,68,0,0,22,68,0.0129449838187702,0.323529411764706
2010,54095,9,69,9,166,0,3,9,169,0.0253715658309563,0.0532544378698225
2010,54097,45,256,53,326,0,11,53,337,0.0207053330056525,0.15727002967359
2010,54099,102,432,22,435,0,0,22,435,0.0145948666331152,0.0505747126436782
2010,54101,11,59,16,18,0,0,16,18,0.00271206870574055,0.888888888888889
2010,54103,12,92,15,104,0,9,15,113,0.00950138737072227,0.132743362831858
2010,54105,9,171,0,65,0,0,0,65,0.0156287569127194,0
2010,54107,192,845,361,1759,24,94,385,1853,0.0303055083082559,0.207771181867242
2010,54109,0,222,0,137,0,0,0,137,0.00807449755407556,0
2010,55001,64,658,24,325,4,48,28,373,0.0230431828010132,0.0750670241286863
2010,55003,52,205,77,210,0,8,77,218,0.0201777119585339,0.353211009174312
2010,55005,175,708,87,600,8,11,95,611,0.0190889777555611,0.155482815057283
2010,55007,166,462,66,126,0,2,66,128,0.0112359550561798,0.515625
2010,55009,972,3068,882,1870,185,396,1067,2266,0.014349310080612,0.470873786407767
2010,55011,33,212,17,98,2,14,19,112,0.0116242864556305,0.169642857142857
2010,55013,46,135,100,248,3,19,103,267,0.0226156191766898,0.385767790262172
2010,55015,355,1413,32,65,16,53,48,118,0.00372169305494228,0.406779661016949
2010,55017,303,1797,104,584,33,56,137,640,0.0152569848383713,0.2140625
2010,55019,73,570,30,161,3,22,33,183,0.00839449541284404,0.180327868852459
2010,55021,518,1918,136,351,9,50,145,401,0.0102589029881293,0.361596009975062
2010,55023,36,427,29,157,0,8,29,165,0.0140748955045637,0.175757575757576
2010,55025,2283,5895,4825,6955,1231,2033,6056,8988,0.0291657202193594,0.673787271918113
2010,55027,462,4300,138,645,3,32,141,677,0.010955756222287,0.208271787296898
2010,55029,142,410,102,264,13,13,115,277,0.0129906673544998,0.415162454873646
2010,55031,47,506,286,1034,8,13,294,1047,0.0349395982113061,0.28080229226361
2010,55033,184,892,151,476,9,30,160,506,0.0197679415556511,0.316205533596838
2010,55035,275,1284,443,1018,18,135,461,1153,0.0195672464997879,0.399826539462272
2010,55037,0,31,24,76,0,0,24,76,0.0221897810218978,0.315789473684211
2010,55039,369,1870,123,553,52,118,175,671,0.00979933989543476,0.26080476900149
2010,55041,9,218,9,35,0,17,9,52,0.00785854616895874,0.173076923076923
2010,55043,86,715,320,539,9,24,329,563,0.0180686158092365,0.58436944937833
2010,55045,64,567,47,216,0,10,47,226,0.00903277378097522,0.207964601769911
2010,55047,90,452,28,93,4,11,32,104,0.00773521755299368,0.307692307692308
2010,55049,162,470,68,189,0,8,68,197,0.0121762778910934,0.345177664974619
2010,55051,20,86,28,154,12,13,40,167,0.0352172079291438,0.239520958083832
2010,55053,42,796,54,172,5,13,59,185,0.0131345402910898,0.318918918918919
2010,55055,351,1595,95,379,6,70,101,449,0.00825049153819298,0.224944320712695
2010,55057,96,550,24,293,2,8,26,301,0.01609539596813,0.0863787375415282
2010,55059,285,1653,876,3027,167,368,1043,3395,0.032225607730349,0.307216494845361
2010,55061,81,344,39,115,6,31,45,146,0.0102592930925444,0.308219178082192
2010,55063,293,1312,520,1492,24,50,544,1542,0.0218742020597498,0.352788586251621
2010,55065,44,278,17,127,0,41,17,168,0.0150984092747371,0.101190476190476
2010,55067,18,349,11,143,2,2,13,145,0.0100138121546961,0.0896551724137931
2010,55069,69,557,37,141,10,100,47,241,0.0116206181590241,0.195020746887967
2010,55071,257,924,221,601,25,98,246,699,0.0123563726356726,0.351931330472103
2010,55073,489,1864,371,933,7,101,378,1034,0.0116459802221071,0.365570599613153
2010,55075,142,789,100,446,31,40,131,486,0.0162016201620162,0.269547325102881
2010,55077,60,439,41,170,0,20,41,190,0.0168380007089685,0.215789473684211
2010,55078,12,82,0,17,0,0,0,17,0.00685483870967742,0
2010,55079,2922,8612,4077,8499,745,2428,4822,10927,0.0182978188973082,0.441292211952045
2010,55081,185,817,204,487,11,39,215,526,0.0181204354416426,0.408745247148289
2010,55083,69,759,24,126,11,39,35,165,0.00618510327248191,0.212121212121212
2010,55085,124,1009,149,423,0,30,149,453,0.0167171008930548,0.328918322295806
2010,55087,955,3547,559,1184,203,279,762,1463,0.0128110825058232,0.520847573479152
2010,55089,880,1837,466,999,33,84,499,1083,0.0185001708233686,0.460757156048015
2010,55091,16,141,3,20,0,4,3,24,0.0046029919447641,0.125
2010,55093,109,450,223,881,7,31,230,912,0.037303664921466,0.25219298245614
2010,55095,46,423,141,562,7,39,148,601,0.0195752719692528,0.246256239600666
2010,55097,306,1032,183,329,3,74,186,403,0.00936882482854818,0.461538461538462
2010,55099,47,216,9,112,3,18,12,130,0.0120459599703484,0.0923076923076923
2010,55101,791,3635,254,1453,81,216,335,1669,0.0128812669795011,0.200718993409227
2010,55103,111,575,27,117,3,30,30,147,0.0117047535631818,0.204081632653061
2010,55105,276,1612,336,1967,86,156,422,2123,0.0201886684798113,0.198775317946302
2010,55107,21,384,86,221,0,0,86,221,0.0209577999051683,0.389140271493213
2010,55109,463,1041,849,2141,0,107,849,2248,0.0413935331811151,0.377669039145907
2010,55111,259,1050,87,561,20,56,107,617,0.0148270973013241,0.173419773095624
2010,55113,37,277,16,171,3,16,19,187,0.0154814140243398,0.101604278074866
2010,55115,117,946,43,254,0,6,43,260,0.00895101043136985,0.165384615384615
2010,55117,376,1487,141,665,12,106,153,771,0.00988778454632895,0.198443579766537
2010,55119,69,247,37,147,3,11,40,158,0.0112647939540853,0.253164556962025
2010,55121,63,335,76,227,3,52,79,279,0.0141999185667752,0.283154121863799
2010,55123,103,466,114,258,6,14,120,272,0.0138260560158593,0.441176470588235
2010,55125,152,463,76,250,0,15,76,265,0.0157606756274533,0.286792452830189
2010,55127,507,1391,405,1371,66,218,471,1589,0.0242814137925765,0.296412838263059
2010,55129,8,285,41,132,4,4,45,136,0.0115606936416185,0.330882352941176
2010,55131,1035,3206,280,681,8,97,288,778,0.00876886489410863,0.370179948586118
2010,55133,3095,8580,2173,3428,333,626,2506,4054,0.0153577476313686,0.618154908732116
2010,55135,213,1221,29,288,0,58,29,346,0.00941061277776267,0.0838150289017341
2010,55137,125,877,15,186,0,26,15,212,0.0116965517241379,0.0707547169811321
2010,55139,889,4479,347,917,98,225,445,1142,0.0104528022113809,0.389667250437828
2010,55141,204,1208,247,480,19,94,266,574,0.0111018702976616,0.463414634146341
2010,56001,132,337,371,849,51,136,422,985,0.0531283710895361,0.428426395939086
2010,56003,21,56,31,244,0,21,31,265,0.0342554291623578,0.116981132075472
2010,56005,22,302,261,1336,39,49,300,1385,0.0517524848666019,0.216606498194946
2010,56007,47,594,100,711,6,6,106,717,0.065767749036874,0.147838214783821
2010,56009,59,469,132,403,0,0,132,403,0.0446586879432624,0.327543424317618
2010,56011,3,43,38,158,2,2,40,160,0.0352035203520352,0.25
2010,56013,106,339,261,882,0,46,261,928,0.0360878864475987,0.28125
2010,56015,0,171,121,414,0,6,121,420,0.0472653612424038,0.288095238095238
2010,56017,20,87,31,177,48,55,79,232,0.0663236134934248,0.34051724137931
2010,56019,60,248,63,198,12,12,75,210,0.0352112676056338,0.357142857142857
2010,56021,126,728,533,2201,103,390,636,2591,0.044495964279581,0.245465071401003
2010,56023,50,246,117,396,0,0,117,396,0.0348040077342239,0.295454545454545
2010,56025,123,934,514,1601,18,34,532,1635,0.0336780093927659,0.325382262996942
2010,56027,5,156,17,79,7,13,24,92,0.0525114155251142,0.260869565217391
2010,56029,177,517,287,1007,6,57,293,1064,0.0551953104736214,0.275375939849624
2010,56031,0,240,13,69,0,2,13,71,0.0114350136898051,0.183098591549296
2010,56033,105,418,165,502,7,46,172,548,0.0276167918157537,0.313868613138686
2010,56035,38,84,92,572,0,76,92,648,0.100278551532033,0.141975308641975
2010,56037,48,232,222,1022,12,77,234,1099,0.0415736712691507,0.212920837124659
2010,56039,126,155,563,730,90,188,653,918,0.0616066035836521,0.711328976034858
2010,56041,0,61,116,554,0,11,116,565,0.0443415476377335,0.205309734513274
2010,56043,109,186,0,72,0,0,0,72,0.0129823296069239,0
2010,56045,33,185,26,157,4,7,30,164,0.0330378726833199,0.182926829268293
2010,72001,NA,NA,NA,NA,NA,NA,NA,NA,NA,NA
2010,72003,NA,NA,NA,NA,NA,NA,NA,NA,NA,NA
2010,72005,NA,NA,NA,NA,NA,NA,NA,NA,NA,NA
2010,72007,NA,NA,NA,NA,NA,NA,NA,NA,NA,NA
2010,72009,NA,NA,NA,NA,NA,NA,NA,NA,NA,NA
2010,72011,NA,NA,NA,NA,NA,NA,NA,NA,NA,NA
2010,72013,NA,NA,NA,NA,NA,NA,NA,NA,NA,NA
2010,72015,NA,NA,NA,NA,NA,NA,NA,NA,NA,NA
2010,72017,NA,NA,NA,NA,NA,NA,NA,NA,NA,NA
2010,72019,NA,NA,NA,NA,NA,NA,NA,NA,NA,NA
2010,72021,NA,NA,NA,NA,NA,NA,NA,NA,NA,NA
2010,72023,NA,NA,NA,NA,NA,NA,NA,NA,NA,NA
2010,72025,NA,NA,NA,NA,NA,NA,NA,NA,NA,NA
2010,72027,NA,NA,NA,NA,NA,NA,NA,NA,NA,NA
2010,72029,NA,NA,NA,NA,NA,NA,NA,NA,NA,NA
2010,72031,NA,NA,NA,NA,NA,NA,NA,NA,NA,NA
2010,72033,NA,NA,NA,NA,NA,NA,NA,NA,NA,NA
2010,72035,NA,NA,NA,NA,NA,NA,NA,NA,NA,NA
2010,72037,NA,NA,NA,NA,NA,NA,NA,NA,NA,NA
2010,72039,NA,NA,NA,NA,NA,NA,NA,NA,NA,NA
2010,72041,NA,NA,NA,NA,NA,NA,NA,NA,NA,NA
2010,72043,NA,NA,NA,NA,NA,NA,NA,NA,NA,NA
2010,72045,NA,NA,NA,NA,NA,NA,NA,NA,NA,NA
2010,72047,NA,NA,NA,NA,NA,NA,NA,NA,NA,NA
2010,72049,NA,NA,NA,NA,NA,NA,NA,NA,NA,NA
2010,72051,NA,NA,NA,NA,NA,NA,NA,NA,NA,NA
2010,72053,NA,NA,NA,NA,NA,NA,NA,NA,NA,NA
2010,72054,NA,NA,NA,NA,NA,NA,NA,NA,NA,NA
2010,72055,NA,NA,NA,NA,NA,NA,NA,NA,NA,NA
2010,72057,NA,NA,NA,NA,NA,NA,NA,NA,NA,NA
2010,72059,NA,NA,NA,NA,NA,NA,NA,NA,NA,NA
2010,72061,NA,NA,NA,NA,NA,NA,NA,NA,NA,NA
2010,72063,NA,NA,NA,NA,NA,NA,NA,NA,NA,NA
2010,72065,NA,NA,NA,NA,NA,NA,NA,NA,NA,NA
2010,72067,NA,NA,NA,NA,NA,NA,NA,NA,NA,NA
2010,72069,NA,NA,NA,NA,NA,NA,NA,NA,NA,NA
2010,72071,NA,NA,NA,NA,NA,NA,NA,NA,NA,NA
2010,72073,NA,NA,NA,NA,NA,NA,NA,NA,NA,NA
2010,72075,NA,NA,NA,NA,NA,NA,NA,NA,NA,NA
2010,72077,NA,NA,NA,NA,NA,NA,NA,NA,NA,NA
2010,72079,NA,NA,NA,NA,NA,NA,NA,NA,NA,NA
2010,72081,NA,NA,NA,NA,NA,NA,NA,NA,NA,NA
2010,72083,NA,NA,NA,NA,NA,NA,NA,NA,NA,NA
2010,72085,NA,NA,NA,NA,NA,NA,NA,NA,NA,NA
2010,72087,NA,NA,NA,NA,NA,NA,NA,NA,NA,NA
2010,72089,NA,NA,NA,NA,NA,NA,NA,NA,NA,NA
2010,72091,NA,NA,NA,NA,NA,NA,NA,NA,NA,NA
2010,72093,NA,NA,NA,NA,NA,NA,NA,NA,NA,NA
2010,72095,NA,NA,NA,NA,NA,NA,NA,NA,NA,NA
2010,72097,NA,NA,NA,NA,NA,NA,NA,NA,NA,NA
2010,72099,NA,NA,NA,NA,NA,NA,NA,NA,NA,NA
2010,72101,NA,NA,NA,NA,NA,NA,NA,NA,NA,NA
2010,72103,NA,NA,NA,NA,NA,NA,NA,NA,NA,NA
2010,72105,NA,NA,NA,NA,NA,NA,NA,NA,NA,NA
2010,72107,NA,NA,NA,NA,NA,NA,NA,NA,NA,NA
2010,72109,NA,NA,NA,NA,NA,NA,NA,NA,NA,NA
2010,72111,NA,NA,NA,NA,NA,NA,NA,NA,NA,NA
2010,72113,NA,NA,NA,NA,NA,NA,NA,NA,NA,NA
2010,72115,NA,NA,NA,NA,NA,NA,NA,NA,NA,NA
2010,72117,NA,NA,NA,NA,NA,NA,NA,NA,NA,NA
2010,72119,NA,NA,NA,NA,NA,NA,NA,NA,NA,NA
2010,72121,NA,NA,NA,NA,NA,NA,NA,NA,NA,NA
2010,72123,NA,NA,NA,NA,NA,NA,NA,NA,NA,NA
2010,72125,NA,NA,NA,NA,NA,NA,NA,NA,NA,NA
2010,72127,NA,NA,NA,NA,NA,NA,NA,NA,NA,NA
2010,72129,NA,NA,NA,NA,NA,NA,NA,NA,NA,NA
2010,72131,NA,NA,NA,NA,NA,NA,NA,NA,NA,NA
2010,72133,NA,NA,NA,NA,NA,NA,NA,NA,NA,NA
2010,72135,NA,NA,NA,NA,NA,NA,NA,NA,NA,NA
2010,72137,NA,NA,NA,NA,NA,NA,NA,NA,NA,NA
2010,72139,NA,NA,NA,NA,NA,NA,NA,NA,NA,NA
2010,72141,NA,NA,NA,NA,NA,NA,NA,NA,NA,NA
2010,72143,NA,NA,NA,NA,NA,NA,NA,NA,NA,NA
2010,72145,NA,NA,NA,NA,NA,NA,NA,NA,NA,NA
2010,72147,NA,NA,NA,NA,NA,NA,NA,NA,NA,NA
2010,72149,NA,NA,NA,NA,NA,NA,NA,NA,NA,NA
2010,72151,NA,NA,NA,NA,NA,NA,NA,NA,NA,NA
2010,72153,NA,NA,NA,NA,NA,NA,NA,NA,NA,NA
2011,01001,115,1100,534,1088,33,44,567,1132,0.0327347387293601,0.500883392226148
2011,01003,798,3322,1396,5156,237,332,1633,5488,0.0440980313378867,0.297558309037901
2011,01005,49,1395,24,275,0,12,24,287,0.0151659268653562,0.0836236933797909
2011,01007,1,670,0,68,0,0,0,68,0.00444706036230462,0
2011,01009,79,1501,64,412,0,180,64,592,0.015387414550464,0.108108108108108
2011,01011,80,289,0,127,0,0,0,127,0.0168502056521162,0
2011,01013,18,138,50,86,0,41,50,127,0.00900964812712826,0.393700787401575
2011,01015,165,1716,227,1565,55,156,282,1721,0.0220341587073976,0.163858221963974
2011,01017,40,433,99,593,17,35,116,628,0.0264532434709351,0.184713375796178
2011,01019,196,641,26,357,0,17,26,374,0.0200708382526564,0.0695187165775401
2011,01021,52,623,47,407,0,24,47,431,0.0149543735470664,0.109048723897912
2011,01023,20,112,30,88,0,0,30,88,0.00906002265005663,0.340909090909091
2011,01025,52,193,63,177,44,68,107,245,0.0142284685521807,0.436734693877551
2011,01027,60,299,0,197,0,2,0,199,0.0202133062468258,0
2011,01029,18,225,53,301,0,0,53,301,0.0295997639885928,0.176079734219269
2011,01031,185,1038,388,1169,118,344,506,1513,0.0459752651250418,0.334434897554527
2011,01033,152,1124,94,603,21,63,115,666,0.0175300063171194,0.172672672672673
2011,01035,0,122,0,6,0,0,0,6,0.000680117887100431,0
2011,01037,12,397,7,62,0,52,7,114,0.0140480591497227,0.0614035087719298
2011,01039,125,515,121,445,0,13,121,458,0.0175029617457102,0.264192139737991
2011,01041,0,303,11,129,0,5,11,134,0.0141067480787451,0.082089552238806
2011,01043,201,1444,55,781,0,91,55,872,0.0159403334308277,0.0630733944954128
2011,01045,197,1562,590,2050,85,368,675,2418,0.0738568679556492,0.279156327543424
2011,01047,75,411,15,459,0,15,15,474,0.0169008058190116,0.0316455696202532
2011,01049,99,821,147,752,0,162,147,914,0.0196128921505515,0.160831509846827
2011,01051,495,3880,201,1009,0,83,201,1092,0.0207813957028946,0.184065934065934
2011,01053,61,759,100,449,49,324,149,773,0.0296805406235601,0.192755498059508
2011,01055,316,2379,321,1126,0,7,321,1133,0.0159039865244245,0.283318623124448
2011,01057,19,355,46,262,0,3,46,265,0.0218809346874742,0.173584905660377
2011,01059,50,654,10,198,0,14,10,212,0.0100703021090633,0.0471698113207547
2011,01061,93,692,24,430,3,3,27,433,0.0234573920580747,0.0623556581986143
2011,01063,27,193,0,28,0,9,0,37,0.00627863566943832,0
2011,01065,36,370,29,217,0,0,29,217,0.0206312987259935,0.133640552995392
2011,01067,21,160,24,113,0,48,24,161,0.0135101116052698,0.149068322981366
2011,01069,221,1272,392,1854,65,153,457,2007,0.0298465290583546,0.227703039362232
2011,01071,95,544,93,481,0,11,93,492,0.0132354127996126,0.189024390243902
2011,01073,2684,9348,3602,8293,323,1043,3925,9336,0.0213153118186281,0.42041559554413
2011,01075,6,267,15,125,0,17,15,142,0.0138698964641532,0.105633802816901
2011,01077,236,2030,403,1171,8,46,411,1217,0.0195135247807334,0.33771569433032
2011,01079,196,493,66,296,0,37,66,333,0.0142979819665092,0.198198198198198
2011,01081,630,2706,1409,3418,357,571,1766,3989,0.0515214920438107,0.44271747305089
2011,01083,525,2360,138,866,70,178,208,1044,0.0189511517725862,0.199233716475096
2011,01085,81,227,75,84,0,0,75,84,0.0111731843575419,0.892857142857143
2011,01087,58,217,128,211,2,4,130,215,0.0166434432574702,0.604651162790698
2011,01089,1100,3417,2746,6824,577,1079,3323,7903,0.0364322824227952,0.420473238010882
2011,01091,117,497,58,176,0,0,58,176,0.0125543904700763,0.329545454545455
2011,01093,50,731,9,141,0,4,9,145,0.0066529020417527,0.0620689655172414
2011,01095,131,1505,241,1147,0,178,241,1325,0.0217366340207031,0.18188679245283
2011,01097,535,2428,1464,4878,280,838,1744,5716,0.0215026257580089,0.305108467459762
2011,01099,55,232,48,158,10,22,58,180,0.0117677824267782,0.322222222222222
2011,01101,914,3729,1806,3975,445,765,2251,4740,0.0324868921558548,0.474894514767932
2011,01103,229,2559,371,1041,15,77,386,1118,0.013966096613409,0.34525939177102
2011,01105,17,161,19,36,0,21,19,57,0.00836022293927838,0.333333333333333
2011,01107,1,164,50,164,0,0,50,164,0.0123113880339314,0.304878048780488
2011,01109,10,377,200,544,91,142,291,686,0.0363193562049979,0.424198250728863
2011,01111,16,243,64,494,10,28,74,522,0.0338807035762965,0.14176245210728
2011,01113,36,513,208,1881,84,242,292,2123,0.0622106311902948,0.137541215261423
2011,01115,422,2762,107,895,0,150,107,1045,0.0186417396578483,0.102392344497608
2011,01117,2294,6001,1108,2592,149,325,1257,2917,0.0228304426773527,0.430922180322249
2011,01119,0,8,0,57,0,32,0,89,0.0104841559665449,0
2011,01121,169,2029,85,1343,86,186,171,1529,0.0274654212322615,0.111837802485284
2011,01123,159,985,11,449,0,37,11,486,0.0168311688311688,0.0226337448559671
2011,01125,824,2949,842,2324,197,304,1039,2628,0.0233483776964356,0.395357686453577
2011,01127,116,1093,66,456,15,32,81,488,0.0104579645543578,0.165983606557377
2011,01129,1,205,34,176,0,0,34,176,0.0152130694096292,0.193181818181818
2011,01131,5,177,0,42,0,12,0,54,0.00708568429339982,0
2011,01133,97,697,4,241,0,0,4,241,0.0139750652363004,0.016597510373444
2011,02013,18,74,76,568,7,37,83,605,0.245436105476673,0.137190082644628
2011,02016,7,121,54,347,5,72,59,419,0.0989140698772427,0.140811455847255
2011,02020,1011,3266,2628,7593,774,1765,3402,9358,0.0519706991441884,0.363539217781577
2011,02050,53,256,120,198,0,6,120,204,0.0232293327260305,0.588235294117647
2011,02060,15,36,7,17,0,5,7,22,0.0316546762589928,0.318181818181818
2011,02068,4,19,43,61,0,3,43,64,0.049079754601227,0.671875
2011,02070,57,117,19,81,0,2,19,83,0.03101644245142,0.228915662650602
2011,02090,276,1299,884,2914,257,645,1141,3559,0.0612891560040641,0.320595672941838
2011,02100,40,70,3,8,0,0,3,8,0.00428036383092563,0.375
2011,02105,12,75,8,35,10,10,18,45,0.0285351934051997,0.4
2011,02110,209,521,404,941,27,98,431,1039,0.0495351609058403,0.414821944177093
2011,02122,151,745,309,1130,39,109,348,1239,0.0333584621183566,0.280871670702179
2011,02130,16,261,90,351,0,7,90,358,0.0398131672597865,0.251396648044693
2011,02150,38,380,209,504,3,63,212,567,0.0708927231807952,0.373897707231041
2011,02164,7,24,15,37,0,2,15,39,0.0444697833523375,0.384615384615385
2011,02170,428,1987,426,1646,23,69,449,1715,0.0315901932251469,0.261807580174927
2011,02180,8,153,32,130,0,34,32,164,0.0319563522992985,0.195121951219512
2011,02185,113,239,93,233,22,22,115,255,0.0500883912787272,0.450980392156863
2011,02188,43,168,46,114,0,0,46,114,0.029434546862897,0.403508771929825
2011,02195,23,80,19,61,5,5,24,66,0.0243183492999263,0.363636363636364
2011,02198,35,148,25,93,0,4,25,97,0.0265244736122505,0.257731958762887
2011,02220,0,125,158,329,47,83,205,412,0.0699134566434753,0.497572815533981
2011,02230,0,0,46,65,0,10,46,75,0.094577553593947,0.613333333333333
2011,02240,13,151,115,388,0,0,115,388,0.0885642547363616,0.29639175257732
2011,02261,45,215,93,183,9,62,102,245,0.0384736180904523,0.416326530612245
2011,02270,14,93,55,75,0,0,55,75,0.0226928895612708,0.733333333333333
2011,02275,12,32,14,32,0,0,14,32,0.0200250312891114,0.4375
2011,02282,6,8,0,7,0,0,0,7,0.014,0
2011,02290,21,202,42,74,0,0,42,74,0.0211973646519622,0.567567567567568
2011,04001,215,872,112,775,122,144,234,919,0.0224837304888193,0.254624591947769
2011,04003,416,2869,1556,4707,284,728,1840,5435,0.061587100137112,0.338546458141674
2011,04005,567,1944,1309,3038,25,288,1334,3326,0.0429993535875889,0.401082381238725
2011,04007,163,1281,251,720,1,65,252,785,0.0206856570660623,0.321019108280255
2011,04009,62,1008,69,546,6,65,75,611,0.0281203976435935,0.122749590834697
2011,04011,26,292,39,147,14,14,53,161,0.0298923134051244,0.329192546583851
2011,04012,10,374,120,742,3,38,123,780,0.0491400491400491,0.157692307692308
2011,04013,5117,20101,30547,83907,6124,16957,36671,100864,0.0417869142461792,0.363568765862944
2011,04015,227,2335,1128,8498,23,413,1151,8911,0.0614997066841506,0.129166199079789
2011,04017,362,2519,258,1187,63,138,321,1325,0.0204791344667697,0.242264150943396
2011,04019,1707,7982,7853,20226,1845,4478,9698,24704,0.0384188311991266,0.392568005181347
2011,04021,2391,15984,2371,11648,244,2685,2615,14333,0.0618428149202856,0.182446103397753
2011,04023,138,640,66,280,30,199,96,479,0.0170008873114463,0.200417536534447
2011,04025,851,4632,2289,5856,146,352,2435,6208,0.0400250156347717,0.392235824742268
2011,04027,185,2059,919,4615,259,1379,1178,5994,0.0506339806891425,0.19652986319653
2011,05001,50,341,34,245,31,152,65,397,0.0302545343697607,0.163727959697733
2011,05003,25,165,14,99,0,0,14,99,0.00666532013734599,0.141414141414141
2011,05005,68,492,219,1383,54,87,273,1470,0.0467616745132969,0.185714285714286
2011,05007,807,2895,2578,6006,573,765,3151,6771,0.0490865593736407,0.465367006350613
2011,05009,89,415,120,862,0,8,120,870,0.0342304060434372,0.137931034482759
2011,05011,96,162,4,101,0,28,4,129,0.0162776025236593,0.0310077519379845
2011,05013,4,217,0,25,0,0,0,25,0.00660676532769556,0
2011,05015,66,509,114,625,27,34,141,659,0.0344161270106539,0.213960546282246
2011,05017,4,312,4,66,0,7,4,73,0.00899901380670612,0.0547945205479452
2011,05019,18,338,77,335,0,0,77,335,0.0250748502994012,0.229850746268657
2011,05021,0,190,19,196,0,0,19,196,0.0173328616908383,0.0969387755102041
2011,05023,133,793,88,537,14,27,102,564,0.0298839612144333,0.180851063829787
2011,05025,16,90,0,55,0,1,0,56,0.00952057123427406,0
2011,05027,102,265,56,217,0,11,56,228,0.0148902821316614,0.245614035087719
2011,05029,127,701,208,435,0,0,208,435,0.030582114735658,0.47816091954023
2011,05031,222,1678,541,1135,34,119,575,1254,0.021078818644837,0.458532695374801
2011,05033,52,1276,107,1142,0,73,107,1215,0.0304946916647843,0.0880658436213992
2011,05035,115,734,69,1012,5,32,74,1044,0.0335907335907336,0.0708812260536398
2011,05037,47,352,10,209,0,15,10,224,0.018392314639954,0.0446428571428571
2011,05039,18,113,0,20,0,0,0,20,0.00360490266762797,0
2011,05041,4,223,0,101,23,80,23,181,0.0208453299550846,0.12707182320442
2011,05043,73,463,22,168,0,42,22,210,0.0177514792899408,0.104761904761905
2011,05045,467,2517,420,1462,97,147,517,1609,0.0243040345603674,0.321317588564326
2011,05047,61,584,3,82,3,13,6,95,0.00775953606142285,0.0631578947368421
2011,05049,44,330,0,129,0,3,0,132,0.0148331273176761,0
2011,05051,361,1443,466,1877,115,253,581,2130,0.0311221507890123,0.272769953051643
2011,05053,126,476,4,95,0,73,4,168,0.0139442231075697,0.0238095238095238
2011,05055,111,805,49,482,14,61,63,543,0.0196696370354271,0.116022099447514
2011,05057,52,369,6,198,0,16,6,214,0.0145301466594242,0.0280373831775701
2011,05059,127,926,89,222,5,5,94,227,0.0100987632351633,0.414096916299559
2011,05061,56,210,6,153,0,45,6,198,0.0221327967806841,0.0303030303030303
2011,05063,107,820,49,412,38,106,87,518,0.0211930283937485,0.167953667953668
2011,05065,44,538,11,217,0,0,11,217,0.0214554083448685,0.0506912442396313
2011,05067,107,1271,37,304,0,5,37,309,0.0243364574308892,0.119741100323625
2011,05069,54,1778,135,859,52,94,187,953,0.0188866208208645,0.196222455403987
2011,05071,52,455,28,233,0,50,28,283,0.0172813873961895,0.0989399293286219
2011,05073,3,170,0,108,0,0,0,108,0.0210690596956691,0
2011,05075,3,152,4,173,0,10,4,183,0.0156143344709898,0.0218579234972678
2011,05077,0,421,3,97,33,56,36,153,0.0209876543209877,0.235294117647059
2011,05079,4,956,0,128,0,0,0,128,0.0132245066639116,0
2011,05081,80,177,19,252,0,0,19,252,0.027906976744186,0.0753968253968254
2011,05083,22,429,51,460,0,5,51,465,0.030654624563254,0.109677419354839
2011,05085,375,1740,247,851,13,177,260,1028,0.0237836337135321,0.252918287937743
2011,05087,74,304,23,196,0,5,23,201,0.0190593589986725,0.114427860696517
2011,05089,19,322,28,352,0,4,28,356,0.0281623289296733,0.0786516853932584
2011,05091,33,913,112,1205,0,76,112,1281,0.0448027420257415,0.087431693989071
2011,05093,63,807,107,703,74,95,181,798,0.0273615635179153,0.226817042606516
2011,05095,6,115,0,95,0,0,0,95,0.0168678977272727,0
2011,05097,2,260,19,138,0,0,19,138,0.0204293116210215,0.13768115942029
2011,05099,0,218,17,74,0,1,17,75,0.0119865750359597,0.226666666666667
2011,05101,8,125,20,89,0,5,20,94,0.0157533098709569,0.212765957446809
2011,05103,34,387,95,212,15,19,110,231,0.0129144071113099,0.476190476190476
2011,05105,80,383,4,40,0,10,4,50,0.00684556407447974,0.08
2011,05107,0,230,39,316,0,6,39,322,0.023402863580202,0.12111801242236
2011,05109,31,357,3,59,0,3,3,62,0.00832326486776748,0.0483870967741935
2011,05111,51,693,2,206,0,17,2,223,0.0134548087365754,0.00896860986547085
2011,05113,79,345,31,250,14,14,45,264,0.0185797733830671,0.170454545454545
2011,05115,289,1370,65,707,22,74,87,781,0.0204686025788867,0.111395646606914
2011,05117,15,110,9,58,0,0,9,58,0.00931128592069353,0.155172413793103
2011,05119,1617,6089,2885,6403,529,1085,3414,7488,0.0296101800811433,0.455929487179487
2011,05121,51,218,27,351,0,9,27,360,0.029116790682627,0.075
2011,05123,37,810,64,636,0,95,64,731,0.0386486200697896,0.0875512995896033
2011,05125,544,3276,709,1609,10,12,719,1621,0.022604936549993,0.443553362122147
2011,05127,0,158,45,232,0,20,45,252,0.0342670655425619,0.178571428571429
2011,05129,0,135,0,12,0,0,0,12,0.00201850294365013,0
2011,05131,153,1400,419,2450,87,190,506,2640,0.0325307440175469,0.191666666666667
2011,05133,19,179,18,287,51,151,69,438,0.0416349809885932,0.157534246575342
2011,05135,46,473,23,253,0,0,23,253,0.0201529393022144,0.0909090909090909
2011,05137,11,286,0,148,0,1,0,149,0.0167415730337079,0
2011,05139,171,523,126,715,0,6,126,721,0.0254347902776308,0.174757281553398
2011,05141,24,453,47,253,16,37,63,290,0.0234078618128985,0.217241379310345
2011,05143,1132,4039,1296,3786,149,584,1445,4370,0.0362887488270513,0.330663615560641
2011,05145,128,1680,257,1165,0,52,257,1217,0.0251659463595194,0.211175020542317
2011,05147,4,135,0,62,0,9,0,71,0.0138132295719844,0
2011,05149,135,681,0,143,8,8,8,151,0.0105255820437753,0.0529801324503311
2011,06001,15675,32797,7648,12234,5074,9407,12722,21641,0.0214497327332179,0.587865625433206
2011,06003,0,14,6,6,4,4,10,10,0.0140252454417952,1
2011,06005,279,1452,64,134,0,33,64,167,0.00575782650668873,0.383233532934132
2011,06007,910,3696,522,1550,182,531,704,2081,0.0149068767908309,0.338298894762134
2011,06009,339,1281,28,180,16,42,44,222,0.00657271435338702,0.198198198198198
2011,06011,57,339,72,242,52,120,124,362,0.0277863064169481,0.342541436464088
2011,06013,12075,25046,3757,6426,2057,4656,5814,11082,0.0160051530758143,0.524634542501354
2011,06015,91,1829,114,291,13,33,127,324,0.016519655330648,0.391975308641975
2011,06017,1339,4202,520,1493,191,284,711,1777,0.014206453263407,0.400112549240293
2011,06019,2023,11579,1056,4501,641,2633,1697,7134,0.0132595083164662,0.237874964956546
2011,06021,66,983,50,234,0,21,50,255,0.0145656023304964,0.196078431372549
2011,06023,518,2232,509,1528,8,107,517,1635,0.0183193277310924,0.316207951070336
2011,06025,331,2859,521,1311,128,756,649,2067,0.0202561665180365,0.313981615868408
2011,06027,153,784,96,248,0,5,96,253,0.0190426012343821,0.379446640316206
2011,06029,2190,22370,1298,6050,337,2242,1635,8292,0.0170855638112428,0.197178002894356
2011,06031,385,6469,322,1361,86,576,408,1937,0.0210353702637838,0.210635002581311
2011,06033,351,1581,190,825,0,153,190,978,0.0213649073750437,0.194274028629857
2011,06035,191,4378,112,521,0,43,112,564,0.0226106478511867,0.198581560283688
2011,06037,24644,66640,30757,56342,19099,43075,49856,99417,0.0157347579770207,0.50148364967762
2011,06039,571,6034,74,641,48,390,122,1031,0.0112957829807281,0.118331716779825
2011,06041,3747,9020,1366,2454,460,836,1826,3290,0.0178535574162809,0.555015197568389
2011,06043,107,686,110,290,12,35,122,325,0.0234436990550386,0.375384615384615
2011,06045,323,1477,153,837,31,88,184,925,0.0152336094596598,0.198918918918919
2011,06047,590,5176,226,871,56,338,282,1209,0.00844350394938088,0.233250620347395
2011,06049,3,265,37,224,0,0,37,224,0.0323139065204847,0.165178571428571
2011,06051,339,742,36,254,36,79,72,333,0.0348107882082375,0.216216216216216
2011,06053,1646,7333,2345,4848,1143,2359,3488,7207,0.0282420342729058,0.483973914250035
2011,06055,1049,3066,352,727,145,414,497,1141,0.0124176960330848,0.43558282208589
2011,06057,999,2658,165,634,144,304,309,938,0.01295293857711,0.329424307036247
2011,06059,18857,44660,11526,20840,6833,14548,18359,35388,0.0181218199247843,0.51879168079575
2011,06061,3238,11034,1634,3066,325,689,1959,3755,0.0161420673882952,0.521704394141145
2011,06063,141,464,17,204,0,0,17,204,0.0134617922660684,0.0833333333333333
2011,06065,13386,58400,5211,16566,2090,7167,7301,23733,0.0180288242408037,0.307630725150634
2011,06067,7796,29859,4162,10468,1530,4115,5692,14583,0.0161207235809386,0.390317492971268
2011,06069,292,1878,31,116,31,149,62,265,0.0078660690433079,0.233962264150943
2011,06071,8748,47685,2863,12074,1832,6177,4695,18251,0.0152274141846646,0.2572461782916
2011,06073,10863,28270,17364,37887,7728,18971,25092,56858,0.0287427559236627,0.441309930001055
2011,06075,11781,18735,8928,11705,4344,7697,13272,19402,0.0314946058872609,0.684053190392743
2011,06077,2715,15383,869,3258,587,2604,1456,5862,0.0143328337298376,0.248379392698738
2011,06079,2047,7934,966,1912,255,619,1221,2531,0.0143820709954939,0.482418016594232
2011,06081,10655,20588,2717,4305,2487,4510,5204,8815,0.017678474376741,0.590357345433919
2011,06083,2262,6438,2071,3905,721,2226,2792,6131,0.0237859689552563,0.455390637742619
2011,06085,13676,25573,9677,13950,10908,16418,20585,30368,0.0257251723454397,0.677851685985248
2011,06087,2110,5872,1400,2269,376,841,1776,3110,0.0186191867426601,0.571061093247588
2011,06089,929,3570,356,1412,83,380,439,1792,0.0148162846843271,0.244977678571429
2011,06091,45,50,0,0,0,0,0,0,0,NA
2011,06093,203,826,218,732,26,61,244,793,0.0246518279035066,0.307692307692308
2011,06095,2650,11755,1029,2748,416,1541,1445,4289,0.0159490997255669,0.336908370249475
2011,06097,2752,7682,1604,3318,531,1211,2135,4529,0.0138544321028819,0.471406491499227
2011,06099,1578,8937,612,2477,265,1580,877,4057,0.0130463584677523,0.216169583436036
2011,06101,329,2850,78,528,80,478,158,1006,0.0170231487748748,0.157057654075547
2011,06103,151,1764,126,457,0,49,126,506,0.0121669712417043,0.24901185770751
2011,06105,176,477,12,79,0,58,12,137,0.01323287935864,0.0875912408759124
2011,06107,815,5681,408,1611,147,1019,555,2630,0.0106395028965339,0.211026615969582
2011,06109,278,3464,110,483,10,35,120,518,0.0125281157036786,0.231660231660232
2011,06111,5765,14630,2520,6458,1108,2953,3628,9411,0.0179791723581926,0.385506322388694
2011,06113,2304,6390,688,1579,788,1337,1476,2916,0.0255352686194667,0.506172839506173
2011,06115,299,3402,131,806,58,182,189,988,0.0228038591146194,0.191295546558704
2011,08001,3109,15744,1520,5735,206,1540,1726,7275,0.0269950351399289,0.237250859106529
2011,08003,18,304,42,295,9,16,51,311,0.0336762317271251,0.163987138263666
2011,08005,6271,19528,4074,10494,717,2358,4791,12852,0.0347260312836905,0.372782446311858
2011,08007,48,116,127,432,0,0,127,432,0.0494675369288904,0.293981481481481
2011,08009,6,25,1,52,0,0,1,52,0.0187929165160824,0.0192307692307692
2011,08011,20,466,7,79,7,16,14,95,0.0208379030489142,0.147368421052632
2011,08013,2700,6022,4620,6962,1205,1555,5825,8517,0.0454657072087462,0.683926265116825
2011,08014,1192,3090,781,1330,74,100,855,1430,0.0400123114804555,0.597902097902098
2011,08015,273,849,141,417,4,26,145,443,0.0323499342777859,0.327313769751693
2011,08017,9,40,0,4,0,0,0,4,0.0027359781121751,0
2011,08019,102,297,109,172,0,0,109,172,0.0247624532104809,0.633720930232558
2011,08021,41,115,25,88,15,18,40,106,0.0204712244109695,0.377358490566038
2011,08023,0,66,15,21,0,0,15,21,0.00835987261146497,0.714285714285714
2011,08025,21,653,0,79,10,145,10,224,0.0502242152466368,0.0446428571428571
2011,08027,9,64,43,61,10,10,53,71,0.0236272878535774,0.746478873239437
2011,08029,108,918,168,562,0,104,168,666,0.0302164148632095,0.252252252252252
2011,08031,8095,23763,8533,14106,1365,2726,9898,16832,0.0418014975227546,0.588046577946768
2011,08033,12,54,1,67,0,0,1,67,0.0454237288135593,0.0149253731343284
2011,08035,4084,8247,4096,7471,432,569,4528,8040,0.0446979552353314,0.56318407960199
2011,08037,297,847,405,618,12,188,417,806,0.0237898465171192,0.517369727047146
2011,08039,176,750,89,315,10,30,99,345,0.0220941402497598,0.28695652173913
2011,08041,1566,5198,8036,20902,1458,4323,9494,25225,0.0654977046592302,0.376372646184341
2011,08043,377,1723,189,1542,13,419,202,1961,0.0545601246452618,0.103008669046405
2011,08045,261,1406,470,1366,4,135,474,1501,0.0418233999275544,0.315789473684211
2011,08047,0,149,60,146,0,0,60,146,0.0361386138613861,0.410958904109589
2011,08049,31,115,89,225,13,52,102,277,0.0259825532314042,0.368231046931408
2011,08051,88,278,114,289,12,55,126,344,0.0361116943103086,0.366279069767442
2011,08053,8,57,52,52,0,0,52,52,0.0815047021943574,1
2011,08055,45,439,36,218,4,89,40,307,0.0595191934858472,0.130293159609121
2011,08057,3,11,11,32,0,0,11,32,0.0305927342256214,0.34375
2011,08059,5439,16445,3991,9305,638,1265,4629,10570,0.028779211444161,0.437937559129612
2011,08061,22,34,4,31,0,0,4,31,0.0272168568920105,0.129032258064516
2011,08063,40,274,2,246,0,38,2,284,0.05,0.00704225352112676
2011,08065,78,156,7,61,0,0,7,61,0.0132926563521464,0.114754098360656
2011,08067,147,614,764,1739,30,67,794,1806,0.0527946679139383,0.439645625692137
2011,08069,1832,4709,3747,7250,392,786,4139,8036,0.0424296183657522,0.515057242409159
2011,08071,63,222,45,357,0,3,45,360,0.033210332103321,0.125
2011,08073,21,359,0,65,0,36,0,101,0.0254408060453401,0
2011,08075,78,706,42,315,18,81,60,396,0.0265718311749312,0.151515151515152
2011,08077,990,2787,658,3138,54,170,712,3308,0.0343352985136594,0.215235792019347
2011,08079,3,12,4,8,0,0,4,8,0.0126382306477093,0.5
2011,08081,23,362,27,71,0,24,27,95,0.0107893242475866,0.284210526315789
2011,08083,118,423,210,572,0,3,210,575,0.0325649883898737,0.365217391304348
2011,08085,172,649,392,1321,0,136,392,1457,0.0519707508471553,0.26904598490048
2011,08087,124,949,47,281,2,120,49,401,0.0225306214181369,0.122194513715711
2011,08089,25,496,38,205,0,19,38,224,0.0178870877585243,0.169642857142857
2011,08091,92,131,80,221,0,0,80,221,0.06674720628209,0.361990950226244
2011,08093,115,434,134,613,18,18,152,631,0.0518062397372742,0.240887480190174
2011,08095,7,54,2,32,13,38,15,70,0.0239398084815321,0.214285714285714
2011,08097,131,254,394,739,5,48,399,787,0.0616771159874608,0.506988564167726
2011,08099,172,509,0,134,0,22,0,156,0.0196374622356495,0
2011,08101,400,2874,436,1555,22,234,458,1789,0.0171550765218058,0.256008943543879
2011,08103,8,107,52,239,11,20,63,259,0.0591864716636197,0.243243243243243
2011,08105,15,251,60,289,0,6,60,295,0.0376275510204082,0.203389830508475
2011,08107,274,468,139,481,9,59,148,540,0.0332021642892277,0.274074074074074
2011,08109,31,222,25,75,0,42,25,117,0.0277580071174377,0.213675213675214
2011,08111,0,1,13,53,0,0,13,53,0.0816640986132511,0.245283018867925
2011,08113,31,91,282,458,55,104,337,562,0.102892713291834,0.599644128113879
2011,08115,3,85,7,43,0,0,7,43,0.024035774175517,0.162790697674419
2011,08117,455,759,654,1262,0,103,654,1365,0.0686378035902851,0.479120879120879
2011,08119,111,403,131,422,18,46,149,468,0.027524554490384,0.318376068376068
2011,08121,18,159,2,86,0,40,2,126,0.0373554699080937,0.0158730158730159
2011,08123,1712,5914,931,3822,44,344,975,4166,0.0274196202323362,0.234037445991359
2011,08125,33,413,29,149,0,102,29,251,0.0377841336745446,0.115537848605578
2011,09001,1758,4175,8713,13460,2429,4852,11142,18312,0.029883140471322,0.608453473132372
2011,09003,3324,9716,5332,9417,1032,3129,6364,12546,0.0206660374281606,0.507253307827196
2011,09005,931,2688,524,1159,60,191,584,1350,0.00997487808482341,0.432592592592593
2011,09007,1161,3252,1127,1836,271,492,1398,2328,0.0199274121755804,0.600515463917526
2011,09009,2965,8998,4218,8134,1419,2891,5637,11025,0.0189858049895212,0.511292517006803
2011,09011,972,4190,1896,4724,306,947,2202,5671,0.0304332893282244,0.388291306647858
2011,09013,749,3686,701,1528,439,524,1140,2052,0.0213596477531774,0.555555555555556
2011,09015,479,2215,246,1148,96,164,342,1312,0.0166539730896167,0.260670731707317
2011,10001,238,1582,556,2635,136,586,692,3221,0.0314151955525212,0.214840111766532
2011,10003,331,1787,5413,12362,869,1804,6282,14166,0.0401095182950482,0.443456162642948
2011,10005,274,1183,1918,5143,28,528,1946,5671,0.0404421465501872,0.343149356374537
2011,11001,0,0,18512,27100,3591,4757,22103,31857,0.0781621096433549,0.693819254794865
2011,12001,1472,4957,1981,3114,849,1338,2830,4452,0.0312497806478784,0.635669362084456
2011,12003,51,968,0,153,0,3,0,156,0.0091244077908405,0
2011,12005,364,2496,1009,4526,315,840,1324,5366,0.0468687221591405,0.246738725307492
2011,12007,182,2097,2,103,0,0,2,103,0.00507089405277668,0.0194174757281553
2011,12009,1864,7671,2908,10382,466,1351,3374,11733,0.029996165154033,0.287564987641694
2011,12011,8713,30491,8294,22056,4499,13028,12793,35084,0.0291529491144596,0.364639151750085
2011,12013,61,832,8,174,0,5,8,179,0.0175921375921376,0.0446927374301676
2011,12015,873,4048,1310,5071,211,497,1521,5568,0.0436018511992858,0.273168103448276
2011,12017,277,2610,355,2590,57,224,412,2814,0.0254434980741062,0.146410803127221
2011,12019,989,4682,927,2527,268,715,1195,3242,0.0263884027772125,0.368599629858112
2011,12021,1195,4110,3207,7314,841,2315,4048,9629,0.0409809204002332,0.420396718246962
2011,12023,309,2513,198,1289,16,65,214,1354,0.029979629793641,0.158050221565731
2011,12027,20,1194,27,502,28,342,55,844,0.0367499782286859,0.0651658767772512
2011,12029,30,407,0,91,16,16,16,107,0.00920746923672662,0.149532710280374
2011,12031,3272,11983,4542,14734,1003,2948,5545,17682,0.0312825085451033,0.313595747087434
2011,12033,741,4409,1691,7126,266,788,1957,7914,0.0406600972060954,0.247283295425828
2011,12035,600,2454,630,2488,9,235,639,2723,0.0392504504504504,0.2346676459787
2011,12037,32,987,10,76,2,2,12,78,0.00897893403936917,0.153846153846154
2011,12039,21,1202,96,327,35,53,131,380,0.0122596464059879,0.344736842105263
2011,12041,22,670,21,190,0,16,21,206,0.0183437221727516,0.101941747572816
2011,12043,41,444,44,137,0,0,44,137,0.0149743141326921,0.321167883211679
2011,12045,46,874,41,189,0,8,41,197,0.0166610284167794,0.208121827411168
2011,12047,82,1028,6,227,0,32,6,259,0.0261774813017991,0.0231660231660232
2011,12049,83,762,26,456,10,229,36,685,0.0398417960797999,0.0525547445255474
2011,12051,246,1269,92,419,11,262,103,681,0.028690596562184,0.151248164464024
2011,12053,462,4065,524,3589,208,345,732,3934,0.0310956186320773,0.186070157600407
2011,12055,320,1759,313,1936,46,264,359,2200,0.0296495956873315,0.163181818181818
2011,12057,6148,19427,8204,20202,2572,6401,10776,26603,0.0332651433115842,0.405067097695749
2011,12059,62,738,83,363,0,19,83,382,0.0272060394558792,0.217277486910995
2011,12061,593,2804,826,2826,214,409,1040,3235,0.0317365328205782,0.321483771251932
2011,12063,102,2265,76,657,24,62,100,719,0.0204907520875488,0.139082058414465
2011,12065,47,573,0,141,0,37,0,178,0.0166448475780812,0
2011,12067,4,375,0,94,0,14,0,108,0.0194314501619288,0
2011,12069,1638,7950,1376,6256,341,831,1717,7087,0.0330283866096853,0.242274587272471
2011,12071,1682,10657,5509,16809,591,2776,6100,19585,0.0437799401364924,0.311462854225172
2011,12073,1461,4444,1616,3532,486,720,2102,4252,0.0272999852328396,0.494355597365945
2011,12075,154,1756,10,370,0,110,10,480,0.0166892667153437,0.0208333333333333
2011,12077,104,629,5,177,0,0,5,177,0.0310526315789474,0.0282485875706215
2011,12079,60,949,3,117,0,43,3,160,0.0120818545646757,0.01875
2011,12081,1635,6033,2379,8133,439,1439,2818,9572,0.0412129666705417,0.2944003343084
2011,12083,1433,7213,1652,6745,58,638,1710,7383,0.0305307209435039,0.231613165379927
2011,12085,936,3875,1228,3621,119,458,1347,4079,0.0370245983480076,0.330227997058102
2011,12086,5109,19701,7400,16743,8004,24750,15404,41493,0.0246489457382209,0.3712433422505
2011,12087,455,1379,628,2206,159,417,787,2623,0.0464256004531054,0.30003812428517
2011,12089,207,1363,362,1120,37,107,399,1227,0.024114144213195,0.32518337408313
2011,12091,523,2395,1635,5291,367,941,2002,6232,0.0510171503417789,0.321245186136072
2011,12093,23,912,77,563,9,313,86,876,0.0329893801310537,0.0981735159817352
2011,12095,6286,21336,5303,16498,3068,8930,8371,25428,0.035268515346409,0.329204027056788
2011,12097,1112,6739,781,3912,418,1905,1199,5817,0.0343514155121709,0.206119993123603
2011,12099,5823,17567,10055,23787,2692,7855,12747,31642,0.0337420009106779,0.402850641552367
2011,12101,3227,13230,1797,9598,265,1583,2062,11181,0.0337110157022601,0.184419998211251
2011,12103,4018,12982,5468,17121,1508,4380,6976,21501,0.0313637795826915,0.324450025580206
2011,12105,2435,11236,2465,10869,607,2316,3072,13185,0.0326413095143785,0.232992036405006
2011,12107,95,1456,138,694,6,171,144,865,0.0169275929549902,0.166473988439306
2011,12109,1564,4931,2707,5307,345,1014,3052,6321,0.0492048294061325,0.482834994462901
2011,12111,1055,6769,1225,5718,147,646,1372,6364,0.0331907791801398,0.21558768070396
2011,12113,819,3613,1731,4802,186,699,1917,5501,0.0543276447815438,0.348482094164697
2011,12115,1781,7327,3582,10692,518,1887,4100,12579,0.0425147191034021,0.325940058828206
2011,12117,3124,10411,1993,5275,653,1643,2646,6918,0.0246673227504172,0.382480485689506
2011,12119,279,2744,1308,4011,67,566,1375,4577,0.0583868046076718,0.300415119073629
2011,12121,111,1428,101,425,0,24,101,449,0.0158730158730159,0.224944320712695
2011,12123,59,1261,75,251,0,0,75,251,0.0156747642540436,0.298804780876494
2011,12125,12,1386,19,136,4,5,23,141,0.012901454844908,0.163120567375887
2011,12127,2240,8584,1755,9214,321,1110,2076,10324,0.0289585144876722,0.20108485083301
2011,12129,42,1775,73,290,0,13,73,303,0.0145890509894554,0.240924092409241
2011,12131,279,2200,922,1985,23,57,945,2042,0.0521490410399162,0.462781586679726
2011,12133,107,1174,46,334,0,14,46,348,0.020170405146931,0.132183908045977
2011,13001,125,245,0,55,0,19,0,74,0.00615486983282043,0
2011,13003,0,110,0,102,0,0,0,102,0.0201581027667984,0
2011,13005,2,366,2,151,0,0,2,151,0.02073606152156,0.0132450331125828
2011,13007,0,1,0,1,0,2,0,3,0.00144857556735876,0
2011,13009,65,1025,149,303,0,90,149,393,0.0139282676495605,0.379134860050891
2011,13011,47,496,20,108,0,22,20,130,0.0108959852485123,0.153846153846154
2011,13013,358,2603,68,797,0,60,68,857,0.0198122803772887,0.0793465577596266
2011,13015,338,2373,168,920,76,172,244,1092,0.0171361318163986,0.223443223443223
2011,13017,137,498,42,260,0,49,42,309,0.0276881720430108,0.135922330097087
2011,13019,7,501,17,201,0,71,17,272,0.0218140989654343,0.0625
2011,13021,739,3353,628,1738,184,320,812,2058,0.0207962813257882,0.394557823129252
2011,13023,60,193,0,51,0,17,0,68,0.00843567795558864,0
2011,13025,2,378,1,257,0,0,1,257,0.0222356809136529,0.00389105058365759
2011,13027,112,458,18,183,0,30,18,213,0.0199774901519415,0.0845070422535211
2011,13029,232,883,625,1245,68,129,693,1374,0.0731201106912884,0.504366812227074
2011,13031,373,1418,108,657,20,52,128,709,0.0200594143443203,0.180535966149506
2011,13033,15,435,37,147,14,14,51,161,0.0112974528103291,0.316770186335404
2011,13035,62,1577,18,132,0,23,18,155,0.00977547931382442,0.116129032258065
2011,13037,21,566,7,110,0,0,7,110,0.0253807106598985,0.0636363636363636
2011,13039,124,670,329,1517,48,232,377,1749,0.0583680961121308,0.215551743853631
2011,13043,34,335,30,158,0,2,30,160,0.023333819454572,0.1875
2011,13045,622,2814,232,1030,30,271,262,1301,0.0191551701291244,0.201383551114527
2011,13047,122,942,441,1487,0,31,441,1518,0.0356941309255079,0.290513833992095
2011,13049,10,1026,24,473,0,0,24,473,0.0523056507796085,0.0507399577167019
2011,13051,884,3393,1787,4525,318,962,2105,5487,0.0326926285183155,0.383634044104246
2011,13053,39,252,754,1807,154,528,908,2335,0.418159025787966,0.388865096359743
2011,13055,57,653,61,205,0,3,61,208,0.0115632643984879,0.293269230769231
2011,13057,2215,5885,1333,2857,243,454,1576,3311,0.0241470849924882,0.475989127151918
2011,13059,847,2558,885,1544,252,340,1137,1884,0.0316202880064449,0.603503184713376
2011,13061,0,66,31,57,0,3,31,60,0.02997002997003,0.516666666666667
2011,13063,1495,10150,645,4730,133,646,778,5376,0.0342819974875173,0.144717261904762
2011,13065,0,88,0,22,0,41,0,63,0.0140280561122244,0
2011,13067,8192,20714,6769,14295,1561,2696,8330,16991,0.0381047853564236,0.490259549173092
2011,13069,58,605,69,220,0,134,69,354,0.0133092713737875,0.194915254237288
2011,13071,128,957,10,610,36,169,46,779,0.027706643903827,0.0590500641848524
2011,13073,914,3443,1250,2670,106,411,1356,3081,0.039359215115165,0.440116845180136
2011,13075,49,478,63,154,0,43,63,197,0.0177365625281354,0.319796954314721
2011,13077,716,3193,512,1957,49,252,561,2209,0.0272255567743446,0.253961068356722
2011,13079,17,490,0,9,0,0,0,9,0.00103986135181976,0
2011,13081,13,414,10,129,0,0,10,129,0.00852329038652131,0.0775193798449612
2011,13083,0,178,82,285,53,53,135,338,0.0311779356147957,0.399408284023669
2011,13085,203,696,59,179,0,0,59,179,0.0118136219640971,0.329608938547486
2011,13087,39,651,29,294,7,12,36,306,0.0169491525423729,0.117647058823529
2011,13089,9842,24791,5322,11312,1776,3302,7098,14614,0.0321970865315978,0.485698645134802
2011,13091,11,232,23,97,0,10,23,107,0.00748199426613524,0.214953271028037
2011,13093,2,269,0,6,0,0,0,6,0.000602409638554217,0
2011,13095,265,2255,229,1107,36,182,265,1289,0.0222652134109478,0.205585725368503
2011,13097,1120,5610,715,2649,45,255,760,2904,0.0352119507226695,0.261707988980716
2011,13099,21,157,10,31,0,0,10,31,0.0043205574912892,0.32258064516129
2011,13101,0,186,0,0,0,14,0,14,0.00574005740057401,0
2011,13103,130,1240,126,776,0,31,126,807,0.0249420491423273,0.156133828996283
2011,13105,36,212,6,101,0,7,6,108,0.00797518830305716,0.0555555555555556
2011,13107,25,559,0,343,0,0,0,343,0.0234529914529915,0
2011,13109,17,567,0,32,0,22,0,54,0.0077209036316843,0
2011,13111,73,386,26,425,10,41,36,466,0.0265723898044135,0.0772532188841202
2011,13113,1041,3073,782,1613,115,280,897,1893,0.0269021970838189,0.473851030110935
2011,13115,221,1732,332,914,36,185,368,1099,0.0175153398677185,0.334849863512284
2011,13117,2389,5551,1210,2387,258,488,1468,2875,0.0262765850493086,0.510608695652174
2011,13119,6,434,33,105,12,41,45,146,0.00983164983164983,0.308219178082192
2011,13121,10768,25506,11081,20634,2935,4603,14016,25237,0.0425087882713003,0.555375044577406
2011,13123,204,1108,80,376,0,146,80,522,0.0260570059401987,0.153256704980843
2011,13125,0,66,0,36,0,5,0,41,0.0196078431372549,0
2011,13127,412,1841,501,1202,119,278,620,1480,0.0279387612557341,0.418918918918919
2011,13129,154,790,113,548,0,13,113,561,0.0160175879396985,0.201426024955437
2011,13131,52,704,153,404,16,17,169,421,0.0260761845772685,0.401425178147268
2011,13133,168,352,7,94,0,0,7,94,0.00805208154874079,0.074468085106383
2011,13135,5296,18121,5440,13997,1506,3219,6946,17216,0.0347163967219462,0.403461895910781
2011,13137,113,1176,62,173,0,10,62,183,0.00637297579662197,0.33879781420765
2011,13139,1019,3914,722,1967,87,344,809,2311,0.0206396413292965,0.350064906966681
2011,13141,7,343,0,87,0,0,0,87,0.0129348795718109,0
2011,13143,61,952,23,301,0,0,23,301,0.0159360440491317,0.0764119601328904
2011,13145,223,788,192,496,8,41,200,537,0.0250782235090833,0.37243947858473
2011,13147,116,909,0,229,0,0,0,229,0.0130432306202654,0
2011,13149,0,417,22,172,0,16,22,188,0.0241025641025641,0.117021276595745
2011,13151,1151,6349,912,3107,99,318,1011,3425,0.0274265488993346,0.295182481751825
2011,13153,816,3390,786,2807,164,422,950,3229,0.0369269123886417,0.29420873335398
2011,13155,42,330,0,132,0,12,0,144,0.022940895332165,0
2011,13157,303,1816,91,360,19,78,110,438,0.0111811707043116,0.251141552511416
2011,13159,78,433,33,99,2,36,35,135,0.0147831800262812,0.259259259259259
2011,13161,54,405,0,105,19,19,19,124,0.0131342018853935,0.153225806451613
2011,13163,38,543,53,177,14,14,67,191,0.0173636363636364,0.350785340314136
2011,13165,0,140,0,10,0,0,0,10,0.00185150897981855,0
2011,13167,55,1113,12,51,0,11,12,62,0.00878311375548945,0.193548387096774
2011,13169,146,1076,0,190,23,23,23,213,0.0112052185806723,0.107981220657277
2011,13171,38,519,0,256,0,60,0,316,0.0271012006861063,0
2011,13173,6,386,0,58,0,83,0,141,0.0234569955082349,0
2011,13175,69,535,61,332,6,56,67,388,0.0122792581808975,0.172680412371134
2011,13177,103,1220,20,214,22,64,42,278,0.0154624840091218,0.151079136690647
2011,13179,227,1289,589,3319,271,1255,860,4574,0.129637502479948,0.188019239177962
2011,13181,4,112,0,41,0,0,0,41,0.00733583825371265,0
2011,13183,30,580,0,402,12,56,12,458,0.0578721253474855,0.0262008733624454
2011,13185,316,2012,722,2150,50,253,772,2403,0.0389503031088923,0.321265085310029
2011,13187,134,749,35,328,0,80,35,408,0.0220385674931129,0.0857843137254902
2011,13189,55,428,33,201,0,21,33,222,0.0156569574723182,0.148648648648649
2011,13191,46,361,13,61,0,0,13,61,0.00643052920092768,0.213114754098361
2011,13193,23,527,0,41,0,138,0,179,0.0186458333333333,0
2011,13195,97,570,12,156,0,0,12,156,0.00830494037478705,0.0769230769230769
2011,13197,4,175,10,60,1,33,11,93,0.0163415919873484,0.118279569892473
2011,13199,76,675,11,75,0,7,11,82,0.00546666666666667,0.134146341463415
2011,13201,0,126,7,23,0,6,7,29,0.00696613019457122,0.241379310344828
2011,13205,61,899,30,114,0,9,30,123,0.0079155672823219,0.24390243902439
2011,13207,114,1008,59,217,0,16,59,233,0.0129928065577427,0.253218884120172
2011,13209,13,87,0,21,4,4,4,25,0.00428963623884695,0.16
2011,13211,72,466,31,131,0,0,31,131,0.0106158833063209,0.236641221374046
2011,13213,17,710,0,194,0,21,0,215,0.00841026443436082,0
2011,13215,572,3584,1539,6116,345,831,1884,6947,0.059403993330198,0.271196199798474
2011,13217,394,3845,363,1235,0,92,363,1327,0.0215467549969961,0.273549359457423
2011,13219,348,698,128,280,8,27,136,307,0.0148920688818821,0.44299674267101
2011,13221,6,276,0,11,0,9,0,20,0.00200944438862654,0
2011,13223,537,3876,787,1873,16,57,803,1930,0.0224669398398212,0.416062176165803
2011,13225,71,647,32,329,0,0,32,329,0.0200854700854701,0.0972644376899696
2011,13227,126,819,48,247,20,68,68,315,0.0152188617257706,0.215873015873016
2011,13229,99,516,7,205,0,0,7,205,0.0169016406958529,0.0341463414634146
2011,13231,53,836,29,93,3,6,32,99,0.00860271115745568,0.323232323232323
2011,13233,129,1233,13,106,0,57,13,163,0.00617307328157546,0.0797546012269939
2011,13235,5,398,0,104,0,10,0,114,0.0131990274400834,0
2011,13237,138,646,92,180,0,0,92,180,0.011968085106383,0.511111111111111
2011,13239,0,20,0,61,0,0,0,61,0.0388535031847134,0
2011,13241,48,265,105,285,0,0,105,285,0.0239596469104666,0.368421052631579
2011,13243,57,123,0,6,0,0,0,6,0.00115495668912416,0
2011,13245,676,3763,1311,4617,322,1023,1633,5640,0.0452390692302139,0.289539007092199
2011,13247,592,3912,309,1440,68,202,377,1642,0.0304248735385129,0.229598051157125
2011,13249,4,94,0,21,0,0,0,21,0.00675458346735285,0
2011,13251,11,215,0,27,10,11,10,38,0.00400379306711622,0.263157894736842
2011,13253,3,94,0,52,0,56,0,108,0.0181512605042017,0
2011,13255,128,1897,93,709,15,60,108,769,0.0184651587187245,0.140442132639792
2011,13257,40,392,0,196,0,2,0,198,0.0114384748700173,0
2011,13259,0,180,4,190,0,4,4,194,0.0473401659346022,0.0206185567010309
2011,13261,117,681,39,130,31,78,70,208,0.010371995611848,0.336538461538462
2011,13263,0,171,0,64,0,18,0,82,0.016632860040568,0
2011,13265,1,40,0,1,0,0,0,1,0.00081366965012205,0
2011,13267,82,1919,78,420,0,0,78,420,0.0249272953884504,0.185714285714286
2011,13269,15,346,0,107,0,0,0,107,0.0181849082256968,0
2011,13271,0,107,0,60,0,30,0,90,0.00792253521126761,0
2011,13273,0,222,0,54,0,0,0,54,0.00872797801842573,0
2011,13275,165,919,104,617,82,162,186,779,0.0262289562289562,0.238767650834403
2011,13277,103,926,287,542,75,127,362,669,0.026885825664108,0.541106128550075
2011,13279,32,375,47,107,4,79,51,186,0.0107564191533657,0.274193548387097
2011,13281,16,168,58,181,0,0,58,181,0.0232408834103749,0.320441988950276
2011,13283,6,149,0,113,0,7,0,120,0.0257510729613734,0
2011,13285,50,1313,65,813,174,254,239,1067,0.0253041477932981,0.223992502343018
2011,13287,4,140,0,89,0,0,0,89,0.0153395380903137,0
2011,13289,14,157,0,63,1,3,1,66,0.0105532459226095,0.0151515151515152
2011,13291,53,341,86,703,38,38,124,741,0.0456730769230769,0.167341430499325
2011,13293,75,604,43,173,0,0,43,173,0.00949141383661601,0.248554913294798
2011,13295,142,1648,389,1305,3,38,392,1343,0.0287027142551827,0.291883842144453
2011,13297,518,2656,82,727,0,22,82,749,0.013843708413426,0.109479305740988
2011,13299,150,1072,93,660,38,144,131,804,0.0333540759178594,0.162935323383085
2011,13301,9,93,7,30,0,0,7,30,0.00734394124847001,0.233333333333333
2011,13303,48,658,56,91,0,11,56,102,0.00720644340822382,0.549019607843137
2011,13305,153,907,72,730,0,56,72,786,0.0393511565034545,0.0916030534351145
2011,13307,19,69,0,52,0,10,0,62,0.0286506469500924,0
2011,13309,9,150,0,19,0,9,0,28,0.00534453139912197,0
2011,13311,28,384,49,144,0,0,49,144,0.00774360077436008,0.340277777777778
2011,13313,242,1737,334,1078,23,71,357,1149,0.018382823499296,0.310704960835509
2011,13315,28,647,14,119,0,20,14,139,0.0215303593556382,0.100719424460432
2011,13317,62,344,9,53,0,0,9,53,0.00713804713804714,0.169811320754717
2011,13319,11,156,1,23,0,0,1,23,0.00361067503924647,0.0434782608695652
2011,13321,13,349,48,427,0,0,48,427,0.0298998669560955,0.112412177985948
2011,15001,208,1063,1108,3092,180,655,1288,3747,0.0298244915827596,0.343741659994662
2011,15003,559,2450,7640,19736,3293,8331,10933,28067,0.0440040951543287,0.389532190829088
2011,15005,0,3,0,0,0,0,0,0,0,NA
2011,15007,82,214,597,1389,57,382,654,1771,0.0383657199800698,0.369282891022021
2011,15009,265,1440,1361,3470,248,688,1609,4158,0.0393195207519693,0.386964886964887
2011,16001,1228,5725,3789,8557,523,1174,4312,9731,0.0389595310923562,0.44311992600966
2011,16003,54,154,13,60,3,3,16,63,0.0206219312602291,0.253968253968254
2011,16005,311,1745,459,1616,8,42,467,1658,0.0341089098726573,0.281664656212304
2011,16007,15,66,3,130,6,10,9,140,0.0354520131678906,0.0642857142857143
2011,16009,17,126,20,180,0,0,20,180,0.0280942718901202,0.111111111111111
2011,16011,95,598,112,645,0,28,112,673,0.025607853582436,0.166419019316493
2011,16013,62,218,310,420,140,244,450,664,0.0449468625194612,0.677710843373494
2011,16015,34,172,0,160,0,0,0,160,0.031055900621118,0
2011,16017,109,283,292,711,19,64,311,775,0.0263131090211523,0.401290322580645
2011,16019,359,1744,533,1756,89,208,622,1964,0.0320166930212086,0.316700610997963
2011,16021,12,72,0,74,3,11,3,85,0.0114431879375337,0.0352941176470588
2011,16023,5,44,0,61,0,0,0,61,0.0318039624608968,0
2011,16025,7,55,0,7,0,0,0,7,0.00839328537170264,0
2011,16027,635,3764,696,3172,63,529,759,3701,0.0336222246447909,0.205079708186976
2011,16029,13,103,43,110,0,22,43,132,0.0291841697988061,0.325757575757576
2011,16031,83,536,53,377,0,49,53,426,0.0323045423523167,0.124413145539906
2011,16033,0,5,0,6,0,0,0,6,0.0111731843575419,0
2011,16035,9,312,34,173,0,0,34,173,0.025851763299462,0.196531791907514
2011,16037,9,88,94,142,0,4,94,146,0.0465561224489796,0.643835616438356
2011,16039,57,122,93,713,81,359,174,1072,0.0683717073792972,0.162313432835821
2011,16041,4,37,65,419,24,76,89,495,0.0680599477519593,0.17979797979798
2011,16043,58,229,54,166,0,43,54,209,0.0259691848906561,0.258373205741627
2011,16045,80,649,32,222,0,0,32,222,0.0194089875852422,0.144144144144144
2011,16047,15,128,11,89,8,24,19,113,0.0119022540551928,0.168141592920354
2011,16049,56,380,16,267,7,9,23,276,0.0235153787168782,0.0833333333333333
2011,16051,126,689,50,239,17,51,67,290,0.0201584874183234,0.231034482758621
2011,16053,49,508,27,214,0,0,27,214,0.0165314793356508,0.126168224299065
2011,16055,161,1036,1251,3652,28,149,1279,3801,0.0416233204480995,0.336490397263878
2011,16057,291,740,462,1324,34,45,496,1369,0.0671473415734746,0.362308254200146
2011,16059,81,132,13,106,0,10,13,116,0.0197547683923706,0.112068965517241
2011,16061,17,152,5,55,0,0,5,55,0.0203779177473138,0.0909090909090909
2011,16063,15,133,6,91,0,9,6,100,0.0336360578540195,0.06
2011,16065,75,458,199,611,14,48,213,659,0.0484665735088622,0.323216995447648
2011,16067,0,341,24,210,0,27,24,237,0.0192729934130276,0.10126582278481
2011,16069,141,633,242,1023,10,20,252,1043,0.0389804537130471,0.241610738255034
2011,16071,40,78,26,174,0,0,26,174,0.0639470782800441,0.149425287356322
2011,16073,50,396,8,86,0,11,8,97,0.0137823245240125,0.0824742268041237
2011,16075,30,188,160,751,0,93,160,844,0.0588235294117647,0.18957345971564
2011,16077,1,87,35,65,0,0,35,65,0.0141952391351824,0.538461538461538
2011,16079,19,205,8,193,0,0,8,193,0.0206064488575699,0.0414507772020725
2011,16081,81,138,315,503,0,7,315,510,0.0803782505910166,0.617647058823529
2011,16083,190,1086,240,1360,20,376,260,1736,0.036284591589332,0.149769585253456
2011,16085,67,236,95,226,11,11,106,237,0.0324124726477024,0.447257383966245
2011,16087,21,117,43,192,0,0,43,192,0.0268644186371904,0.223958333333333
2011,17001,95,440,166,626,33,60,199,686,0.0150620265671314,0.290087463556851
2011,17003,12,166,0,135,0,0,0,135,0.0243243243243243,0
2011,17005,38,270,115,193,0,0,115,193,0.016519729521527,0.595854922279793
2011,17007,156,1091,203,361,18,45,221,406,0.0119587628865979,0.544334975369458
2011,17009,10,842,30,49,19,19,49,68,0.01328125,0.720588235294118
2011,17011,114,628,54,247,26,67,80,314,0.0128899835796388,0.254777070063694
2011,17013,33,114,15,22,0,13,15,35,0.0096551724137931,0.428571428571429
2011,17015,33,354,9,80,2,22,11,102,0.00907392580731252,0.107843137254902
2011,17017,56,423,32,98,71,321,103,419,0.0460540778193009,0.24582338902148
2011,17019,843,2339,1980,3204,1289,1605,3269,4809,0.0430324018147164,0.679767103347889
2011,17021,161,925,62,303,22,29,84,332,0.013723544973545,0.253012048192771
2011,17023,26,167,27,191,0,0,27,191,0.0167411692523446,0.141361256544503
2011,17025,34,260,13,57,0,0,13,57,0.00592885375494071,0.228070175438596
2011,17027,107,1107,109,361,12,49,121,410,0.0158625759275738,0.295121951219512
2011,17029,182,930,50,306,0,0,50,306,0.009925397340253,0.163398692810458
2011,17031,11216,26606,29250,49535,12159,23205,41409,72740,0.0211815421816697,0.56927412702777
2011,17033,49,414,0,377,28,31,28,408,0.0294202480530718,0.0686274509803922
2011,17035,72,454,3,42,0,0,3,42,0.00556660039761431,0.0714285714285714
2011,17037,577,2079,359,780,103,273,462,1053,0.0179191341637737,0.438746438746439
2011,17039,77,375,22,89,0,6,22,95,0.00811757668973767,0.231578947368421
2011,17041,30,448,15,146,0,32,15,178,0.0135165919963551,0.0842696629213483
2011,17043,9404,20801,5703,9545,1711,3685,7414,13230,0.0217688910535288,0.560393046107332
2011,17045,29,310,35,152,7,19,42,171,0.0130544316360027,0.245614035087719
2011,17047,20,151,3,25,0,2,3,27,0.00581145071028842,0.111111111111111
2011,17049,106,385,24,174,2,14,26,188,0.00827610494805424,0.138297872340426
2011,17051,13,475,72,243,0,2,72,245,0.0162380699893955,0.293877551020408
2011,17053,95,456,3,82,15,17,18,99,0.0101061657819518,0.181818181818182
2011,17055,34,592,43,313,6,75,49,388,0.0141776592246136,0.126288659793814
2011,17057,83,1121,9,236,13,50,22,286,0.0108153078202995,0.0769230769230769
2011,17059,14,52,25,80,0,0,25,80,0.0197044334975369,0.3125
2011,17061,10,205,8,84,0,0,8,84,0.00871278912975832,0.0952380952380952
2011,17063,150,1470,44,279,43,74,87,353,0.0109651166402634,0.246458923512748
2011,17065,15,153,8,19,0,0,8,19,0.00321597833446175,0.421052631578947
2011,17067,58,170,59,369,0,14,59,383,0.0280175566934894,0.154046997389034
2011,17069,11,83,0,26,0,0,0,26,0.00818639798488665,0
2011,17071,26,147,48,137,0,2,48,139,0.025617397714707,0.345323741007194
2011,17073,208,944,92,499,2,40,94,539,0.0155861430802151,0.174397031539889
2011,17075,56,524,39,181,37,50,76,231,0.0111405835543767,0.329004329004329
2011,17077,274,1356,478,848,99,229,577,1077,0.0318544809228039,0.535747446610956
2011,17079,18,247,28,127,0,10,28,137,0.0201678198145149,0.204379562043796
2011,17081,95,801,50,352,7,71,57,423,0.0156140415636189,0.134751773049645
2011,17083,100,342,113,157,4,21,117,178,0.0115180535783616,0.657303370786517
2011,17085,104,269,64,351,0,11,64,362,0.0218295845142616,0.176795580110497
2011,17087,26,964,8,138,0,0,8,138,0.0151731720725673,0.0579710144927536
2011,17089,3631,12274,1534,3834,364,1560,1898,5394,0.0169375502411576,0.351872450871339
2011,17091,628,2568,92,768,44,103,136,871,0.0119964189794091,0.156142365097589
2011,17093,1668,3960,241,996,97,274,338,1270,0.0185721388669533,0.266141732283465
2011,17095,197,1318,40,258,36,123,76,381,0.0103979040445391,0.199475065616798
2011,17097,4698,9326,3714,8900,1183,2467,4897,11367,0.025596566407631,0.430808480689716
2011,17099,454,1725,168,819,14,91,182,910,0.0116921495567262,0.2
2011,17101,44,954,0,96,0,36,0,132,0.0112016293279022,0
2011,17103,158,1049,61,306,4,9,65,315,0.0126719768283852,0.206349206349206
2011,17105,193,1792,17,200,0,68,17,268,0.00987727121954815,0.0634328358208955
2011,17107,27,1975,27,125,0,24,27,149,0.00709828021533038,0.181208053691275
2011,17109,253,632,157,247,47,87,204,334,0.0187672079563971,0.610778443113772
2011,17111,1609,4986,996,2517,121,385,1117,2902,0.0145406808365652,0.384906960716747
2011,17113,858,2242,1015,1617,320,395,1335,2012,0.0200516239622886,0.66351888667992
2011,17115,418,1680,268,920,63,133,331,1053,0.0140241060131851,0.314339981006648
2011,17117,109,837,146,318,11,70,157,388,0.0117854322337647,0.404639175257732
2011,17119,567,3115,1161,3007,102,235,1263,3242,0.0180586655971837,0.389574336829118
2011,17121,113,645,55,255,0,35,55,290,0.0107260420904686,0.189655172413793
2011,17123,71,246,33,65,1,12,34,77,0.00852524357838795,0.441558441558442
2011,17125,14,326,0,88,0,30,0,118,0.0113005171423099,0
2011,17127,0,132,36,274,3,15,39,289,0.0268387815750371,0.134948096885813
2011,17129,94,458,8,66,0,31,8,97,0.0109803033733303,0.0824742268041237
2011,17131,66,238,26,92,1,1,27,93,0.00801516849090752,0.290322580645161
2011,17133,132,490,93,353,0,0,93,353,0.0157948901516846,0.263456090651558
2011,17135,55,1827,77,307,2,11,79,318,0.0149492290334712,0.248427672955975
2011,17137,231,999,7,301,36,89,43,390,0.0160302519626783,0.11025641025641
2011,17139,142,327,13,41,0,0,13,41,0.00410287201040728,0.317073170731707
2011,17141,170,951,77,355,1,2,78,357,0.00995371661183293,0.218487394957983
2011,17143,717,2912,1048,2380,525,690,1573,3070,0.0252415210688592,0.512377850162866
2011,17145,103,1139,25,47,0,18,25,65,0.00421585160202361,0.384615384615385
2011,17147,93,326,54,82,0,15,54,97,0.00834121592570298,0.556701030927835
2011,17149,7,301,13,189,0,34,13,223,0.01954425942156,0.0582959641255605
2011,17151,8,43,0,53,0,0,0,53,0.0163681284743669,0
2011,17153,24,103,0,28,0,0,0,28,0.00674373795761079,0
2011,17155,12,144,3,7,10,29,13,36,0.00850460666194188,0.361111111111111
2011,17157,41,1167,8,204,3,34,11,238,0.00984773253889441,0.046218487394958
2011,17159,47,143,51,159,63,63,114,222,0.0196147729280792,0.513513513513513
2011,17161,329,1798,547,2081,178,513,725,2594,0.0257676146579384,0.279491133384734
2011,17163,533,2674,1236,3861,182,486,1418,4347,0.024850366152738,0.326201978375891
2011,17165,44,503,13,87,5,27,18,114,0.00666082383873795,0.157894736842105
2011,17167,968,3451,853,2076,103,733,956,2809,0.021083048748452,0.340334638661445
2011,17169,33,223,0,30,0,0,0,30,0.00564227948091029,0
2011,17171,32,98,2,4,0,4,2,8,0.00216743429964779,0.25
2011,17173,31,357,27,75,0,29,27,104,0.00664239637222967,0.259615384615385
2011,17175,7,150,0,48,6,6,6,54,0.0130782271736498,0.111111111111111
2011,17177,209,812,133,560,0,12,133,572,0.0172050773025326,0.232517482517483
2011,17179,748,2715,269,1120,13,95,282,1215,0.0130970475050933,0.232098765432099
2011,17181,87,323,20,187,0,31,20,218,0.0175934145750948,0.0917431192660551
2011,17183,101,848,119,690,39,166,158,856,0.0156974931690231,0.184579439252336
2011,17185,0,153,33,84,0,12,33,96,0.0115384615384615,0.34375
2011,17187,68,326,56,143,0,2,56,145,0.0125715276573608,0.386206896551724
2011,17189,40,345,13,81,0,2,13,83,0.0080488750969744,0.156626506024096
2011,17191,0,255,8,57,0,11,8,68,0.00577004666949512,0.117647058823529
2011,17193,29,207,40,222,23,23,63,245,0.0231810010407796,0.257142857142857
2011,17195,67,623,29,374,0,4,29,378,0.00938430983118173,0.0767195767195767
2011,17197,4315,13009,2092,4101,652,1600,2744,5701,0.0134744514851204,0.481319066830381
2011,17199,443,1569,414,1075,6,50,420,1125,0.024614913355505,0.373333333333333
2011,17201,899,3076,702,2629,152,332,854,2961,0.0151249687131262,0.288416075650118
2011,17203,296,1178,110,186,101,111,211,297,0.0117349559445257,0.71043771043771
2011,18001,92,415,23,168,0,13,23,181,0.00871910978370827,0.12707182320442
2011,18003,750,2664,1069,3451,136,588,1205,4039,0.0179600512254989,0.298341173557811
2011,18005,216,1404,492,1022,292,383,784,1405,0.0274242660836977,0.558007117437722
2011,18007,62,321,0,90,0,11,0,101,0.0170550489699426,0
2011,18009,30,319,31,127,12,12,43,139,0.0156092083099382,0.309352517985612
2011,18011,485,1281,299,496,2,15,301,511,0.0140829543888659,0.589041095890411
2011,18013,189,535,9,156,13,13,22,169,0.0152197406340058,0.130177514792899
2011,18015,30,467,63,144,7,26,70,170,0.0123843520069935,0.411764705882353
2011,18017,81,597,15,92,21,94,36,186,0.0072123773701966,0.193548387096774
2011,18019,232,1546,423,1933,33,98,456,2031,0.0274377887655021,0.224519940915805
2011,18021,93,342,10,155,0,10,10,165,0.00909391534391534,0.0606060606060606
2011,18023,101,616,6,182,4,49,10,231,0.0107476852928861,0.0432900432900433
2011,18025,19,159,22,112,0,0,22,112,0.0151946818613485,0.196428571428571
2011,18027,68,336,7,183,0,0,7,183,0.00934627170582227,0.0382513661202186
2011,18029,42,535,81,1094,15,32,96,1126,0.0334591269723353,0.0852575488454707
2011,18031,79,490,82,274,12,22,94,296,0.0172353557703505,0.317567567567568
2011,18033,160,867,52,274,0,0,52,274,0.0099289752137991,0.18978102189781
2011,18035,331,1993,422,1233,81,197,503,1430,0.0201817771254375,0.351748251748252
2011,18037,73,271,198,436,0,19,198,455,0.0160471185723355,0.435164835164835
2011,18039,345,2209,573,2422,100,278,673,2700,0.0218836116064192,0.249259259259259
2011,18041,39,572,26,152,22,42,48,194,0.011618853686291,0.247422680412371
2011,18043,321,1326,293,1296,19,119,312,1415,0.0284736895059865,0.220494699646643
2011,18045,17,310,0,193,0,0,0,193,0.0162965464831546,0
2011,18047,104,409,64,267,12,66,76,333,0.0214065312419645,0.228228228228228
2011,18049,40,504,15,175,0,8,15,183,0.0130147215703008,0.0819672131147541
2011,18051,97,489,176,401,0,5,176,406,0.0179526862701747,0.433497536945813
2011,18053,156,932,163,580,65,87,228,667,0.0146471079098775,0.341829085457271
2011,18055,127,911,17,215,34,34,51,249,0.0109977474493176,0.204819277108434
2011,18057,4322,8252,2169,3720,448,726,2617,4446,0.0258413251961639,0.588618983355825
2011,18059,583,1927,197,576,31,71,228,647,0.0140691934677191,0.352395672333849
2011,18061,51,332,68,354,0,40,68,394,0.0147449571498073,0.17258883248731
2011,18063,844,4525,667,1615,296,357,963,1972,0.0210845949875973,0.488336713995943
2011,18065,130,1835,52,476,0,6,52,482,0.0140161098025531,0.107883817427386
2011,18067,224,1199,152,588,17,102,169,690,0.0121886592474828,0.244927536231884
2011,18069,25,419,106,316,0,39,106,355,0.0144232722544997,0.298591549295775
2011,18071,49,582,115,260,104,211,219,471,0.0166049709148599,0.464968152866242
2011,18073,187,775,22,252,0,32,22,284,0.0131238447319778,0.0774647887323944
2011,18075,9,237,10,125,0,0,10,125,0.00899733678831066,0.08
2011,18077,105,804,112,393,8,27,120,420,0.0193753748212391,0.285714285714286
2011,18079,38,687,12,257,0,31,12,288,0.0154605969508267,0.0416666666666667
2011,18081,855,4247,489,1606,64,252,553,1858,0.0206449032200716,0.297631862217438
2011,18083,73,457,101,407,5,53,106,460,0.0184339184098742,0.230434782608696
2011,18085,286,1276,335,705,82,130,417,835,0.0166050192896631,0.49940119760479
2011,18087,106,679,116,335,10,58,126,393,0.0187876470025815,0.320610687022901
2011,18089,565,3047,1286,8540,237,717,1523,9257,0.028528986646203,0.164524143891109
2011,18091,314,3235,330,1209,70,119,400,1328,0.0173742395499444,0.301204819277108
2011,18093,159,718,64,297,0,26,64,323,0.0101032217704098,0.198142414860681
2011,18095,574,2850,129,970,28,160,157,1130,0.0126772572249147,0.138938053097345
2011,18097,4176,14023,3897,10158,1388,3146,5285,13304,0.0229641021923261,0.397248947684907
2011,18099,95,1107,115,217,26,77,141,294,0.00958216543901962,0.479591836734694
2011,18101,20,156,11,153,25,30,36,183,0.0258584145824502,0.19672131147541
2011,18103,47,1499,40,358,0,0,40,358,0.0142289348171701,0.111731843575419
2011,18105,841,2693,2082,2814,755,978,2837,3792,0.051153379198705,0.748154008438819
2011,18107,98,592,91,270,0,42,91,312,0.012315951525678,0.291666666666667
2011,18109,261,2195,51,395,0,0,51,395,0.0085575631526496,0.129113924050633
2011,18111,10,280,29,181,0,0,29,181,0.0183588599249417,0.160220994475138
2011,18113,28,1007,34,313,15,29,49,342,0.0111647949856359,0.14327485380117
2011,18115,7,110,9,53,0,7,9,60,0.0138728323699422,0.15
2011,18117,46,554,35,163,0,3,35,166,0.0124223602484472,0.210843373493976
2011,18119,43,577,23,109,0,13,23,122,0.00818846902476676,0.188524590163934
2011,18121,47,984,11,96,19,19,30,115,0.00941465411379452,0.260869565217391
2011,18123,15,489,22,92,0,0,22,92,0.00674635183691428,0.239130434782609
2011,18125,19,220,0,67,0,0,0,67,0.00737804206585178,0
2011,18127,574,2842,704,2171,154,334,858,2505,0.0230877703941972,0.34251497005988
2011,18129,69,322,66,202,1,23,67,225,0.0128044616435238,0.297777777777778
2011,18131,27,338,46,99,0,26,46,125,0.0136597093213856,0.368
2011,18133,144,1652,24,308,8,23,32,331,0.0133489272463301,0.0966767371601208
2011,18135,6,400,13,203,0,31,13,234,0.0130697050938338,0.0555555555555556
2011,18137,46,403,106,395,17,17,123,412,0.0218047102408044,0.298543689320388
2011,18139,41,324,54,126,0,0,54,126,0.0107334525939177,0.428571428571429
2011,18141,551,2427,1568,3835,185,583,1753,4418,0.0259564767813499,0.396785875961974
2011,18143,17,398,29,245,0,0,29,245,0.0150352868978214,0.118367346938776
2011,18145,191,1075,55,424,10,66,65,490,0.016381933068102,0.13265306122449
2011,18147,72,319,25,151,0,1,25,152,0.0104546392461655,0.164473684210526
2011,18149,61,689,0,319,0,6,0,325,0.0206296813507681,0
2011,18151,98,393,53,378,0,32,53,410,0.0181375801813758,0.129268292682927
2011,18153,213,861,2,79,0,5,2,84,0.00558659217877095,0.0238095238095238
2011,18155,44,341,13,93,0,0,13,93,0.0132743362831858,0.139784946236559
2011,18157,587,2597,1462,2518,642,990,2104,3508,0.0379312954813317,0.599771949828962
2011,18159,31,371,35,97,0,0,35,97,0.00868864206377643,0.360824742268041
2011,18161,12,106,7,46,0,3,7,49,0.00969529085872576,0.142857142857143
2011,18163,843,2509,730,2437,31,137,761,2574,0.0217507034755495,0.295648795648796
2011,18165,49,294,9,98,7,25,16,123,0.0107932607932608,0.130081300813008
2011,18167,196,1186,181,1354,76,161,257,1515,0.0220101115760112,0.16963696369637
2011,18169,63,608,54,202,46,63,100,265,0.0119909502262443,0.377358490566038
2011,18171,17,251,0,45,0,0,0,45,0.00763488293179505,0
2011,18173,253,1344,179,621,22,114,201,735,0.0184520372555419,0.273469387755102
2011,18175,69,659,40,222,0,0,40,222,0.0117821887273113,0.18018018018018
2011,18177,123,908,314,1024,19,113,333,1137,0.0243923369017227,0.29287598944591
2011,18179,105,555,44,166,0,0,44,166,0.00891658161895042,0.265060240963855
2011,18181,140,629,49,132,0,21,49,153,0.00901963096150445,0.320261437908497
2011,18183,104,701,12,194,16,48,28,242,0.0108064660176833,0.115702479338843
2011,19001,40,113,17,45,0,2,17,47,0.00855946093607722,0.361702127659574
2011,19003,43,97,21,57,7,7,28,64,0.0220309810671256,0.4375
2011,19005,29,263,26,217,34,88,60,305,0.0304360842231314,0.19672131147541
2011,19007,31,248,10,185,0,0,10,185,0.0204126668873441,0.0540540540540541
2011,19009,6,59,7,29,0,7,7,36,0.00817253121452895,0.194444444444444
2011,19011,138,623,10,77,17,22,27,99,0.00558753809685066,0.272727272727273
2011,19013,377,1708,287,1129,203,299,490,1428,0.0176081086079976,0.343137254901961
2011,19015,182,607,89,236,0,17,89,253,0.0140220584160062,0.351778656126482
2011,19017,140,498,22,128,0,0,22,128,0.00812801625603251,0.171875
2011,19019,95,353,85,153,0,34,85,187,0.0135802469135802,0.454545454545455
2011,19021,43,171,117,320,46,152,163,472,0.0374128091312619,0.345338983050847
2011,19023,41,282,54,92,0,0,54,92,0.00875523410734678,0.58695652173913
2011,19025,72,458,11,54,0,22,11,76,0.0106741573033708,0.144736842105263
2011,19027,67,414,37,165,3,3,40,168,0.0118234921528609,0.238095238095238
2011,19029,37,221,29,134,4,13,33,147,0.015,0.224489795918367
2011,19031,98,388,41,128,11,18,52,146,0.0114000156164597,0.356164383561644
2011,19033,326,895,136,387,0,5,136,392,0.0126085558057253,0.346938775510204
2011,19035,72,344,54,147,14,14,68,161,0.0186277912761773,0.422360248447205
2011,19037,6,145,20,49,3,21,23,70,0.00807847663012118,0.328571428571429
2011,19039,17,107,0,28,0,17,0,45,0.0072,0
2011,19041,52,233,22,175,0,12,22,187,0.016079105760963,0.117647058823529
2011,19043,52,361,31,230,0,9,31,239,0.018776023253987,0.129707112970711
2011,19045,211,608,164,635,0,8,164,643,0.0192273189402548,0.255054432348367
2011,19047,63,268,22,72,0,31,22,103,0.00933309169989126,0.213592233009709
2011,19049,1309,2779,595,1058,19,37,614,1095,0.0262382287398462,0.560730593607306
2011,19051,30,207,0,40,0,4,0,44,0.00792507204610951,0
2011,19053,32,94,21,87,0,6,21,93,0.0177041690462593,0.225806451612903
2011,19055,41,359,15,38,0,0,15,38,0.0031496062992126,0.394736842105263
2011,19057,144,549,107,539,0,15,107,554,0.0199416867643353,0.193140794223827
2011,19059,65,252,64,215,0,0,64,215,0.0172663026019916,0.297674418604651
2011,19061,194,711,550,1625,82,86,632,1711,0.0279799185622476,0.36937463471654
2011,19063,59,200,20,86,7,9,27,95,0.01363571120999,0.284210526315789
2011,19065,66,494,73,222,0,11,73,233,0.0164478328391924,0.313304721030043
2011,19067,2,209,44,135,3,17,47,152,0.0135255383520199,0.309210526315789
2011,19069,6,119,25,67,36,57,61,124,0.0165179166111629,0.491935483870968
2011,19071,32,112,24,80,0,12,24,92,0.0175304878048781,0.260869565217391
2011,19073,15,267,12,49,4,16,16,65,0.00983805055244438,0.246153846153846
2011,19075,68,294,0,28,0,8,0,36,0.00417681865645667,0
2011,19077,22,183,20,75,0,3,20,78,0.00996423096576392,0.256410256410256
2011,19079,55,358,5,182,0,9,5,191,0.0176101788677854,0.0261780104712042
2011,19081,0,295,23,67,9,14,32,81,0.0100608620047199,0.395061728395062
2011,19083,82,233,25,97,1,4,26,101,0.00837618178802455,0.257425742574257
2011,19085,11,111,28,102,0,8,28,110,0.0106516897453278,0.254545454545455
2011,19087,79,483,57,149,0,42,57,191,0.0140060130527242,0.298429319371728
2011,19089,25,128,34,84,0,0,34,84,0.0128283445326817,0.404761904761905
2011,19091,36,215,9,144,0,2,9,146,0.0212827988338192,0.0616438356164384
2011,19093,12,119,23,55,3,7,26,62,0.012459807073955,0.419354838709677
2011,19095,124,403,21,215,13,13,34,228,0.0200774920746742,0.149122807017544
2011,19097,34,166,24,96,4,15,28,111,0.0079971181556196,0.252252252252252
2011,19099,102,1102,125,453,22,27,147,480,0.0185550272526963,0.30625
2011,19101,46,259,144,398,47,91,191,489,0.0416347381864623,0.390593047034765
2011,19103,921,2356,1880,2949,568,759,2448,3708,0.0496891080617496,0.660194174757282
2011,19105,103,652,121,186,0,5,121,191,0.0130893640350877,0.633507853403141
2011,19107,19,265,26,65,0,9,26,74,0.0101037684325505,0.351351351351351
2011,19109,48,241,18,72,0,0,18,72,0.00644064764290187,0.25
2011,19111,86,513,155,557,76,76,231,633,0.0252372219121282,0.364928909952607
2011,19113,632,2526,1025,2455,213,437,1238,2892,0.020974456419257,0.428077455048409
2011,19115,18,178,11,92,0,22,11,114,0.014832162373146,0.0964912280701754
2011,19117,0,149,5,127,8,17,13,144,0.0230658337337818,0.0902777777777778
2011,19119,26,130,26,90,3,6,29,96,0.0126216145148567,0.302083333333333
2011,19121,46,351,3,24,0,61,3,85,0.00818567026194145,0.0352941176470588
2011,19123,33,293,16,102,0,14,16,116,0.00792079207920792,0.137931034482759
2011,19125,203,589,155,326,3,3,158,329,0.0152427724240178,0.480243161094225
2011,19127,221,657,202,432,8,57,210,489,0.0182177185008569,0.429447852760736
2011,19129,54,146,65,203,0,0,65,203,0.0197259741521718,0.320197044334975
2011,19131,23,139,0,51,0,0,0,51,0.00689841742188557,0
2011,19133,18,191,15,116,0,2,15,118,0.0177017701770177,0.127118644067797
2011,19135,0,134,26,71,0,0,26,71,0.012730858884705,0.366197183098592
2011,19137,13,172,21,130,0,12,21,142,0.0187533016376123,0.147887323943662
2011,19139,151,731,29,534,47,50,76,584,0.0209041772559688,0.13013698630137
2011,19141,90,349,51,194,0,24,51,218,0.0217891054472764,0.23394495412844
2011,19143,8,123,5,67,0,0,5,67,0.0149087672452158,0.0746268656716418
2011,19145,54,467,27,249,4,6,31,255,0.0223723460256185,0.12156862745098
2011,19147,33,213,0,36,0,1,0,37,0.00570987654320988,0
2011,19149,68,325,22,194,12,26,34,220,0.0130991366478118,0.154545454545455
2011,19151,16,130,20,129,15,22,35,151,0.0284369114877589,0.231788079470199
2011,19153,2370,6766,2325,6027,393,1337,2718,7364,0.026487112530663,0.36909288430201
2011,19155,173,858,396,1769,9,97,405,1866,0.0303508400969405,0.217041800643087
2011,19157,54,338,77,151,12,14,89,165,0.0133365664403492,0.539393939393939
2011,19159,27,114,23,42,0,6,23,48,0.0133407448582546,0.479166666666667
2011,19161,24,206,9,32,0,8,9,40,0.00536121163382925,0.225
2011,19163,457,1393,1498,3438,173,462,1671,3900,0.0358861580647239,0.428461538461538
2011,19165,31,202,31,126,7,10,38,136,0.0158176320074436,0.279411764705882
2011,19167,11,229,41,304,0,15,41,319,0.0159468106378724,0.128526645768025
2011,19169,456,1419,869,1406,324,391,1193,1797,0.0385209003215434,0.663884251530328
2011,19171,71,306,19,83,2,11,21,94,0.00779500787793349,0.223404255319149
2011,19173,4,114,4,95,3,3,7,98,0.021850613154961,0.0714285714285714
2011,19175,38,175,9,213,0,0,9,213,0.0253089353612167,0.0422535211267606
2011,19177,11,91,24,116,4,5,28,121,0.0226041472071735,0.231404958677686
2011,19179,26,545,62,269,44,56,106,325,0.0135858205835632,0.326153846153846
2011,19181,335,1403,192,391,41,74,233,465,0.0157057452629446,0.501075268817204
2011,19183,95,461,26,292,0,3,26,295,0.0197946722136483,0.088135593220339
2011,19185,23,142,3,38,0,0,3,38,0.00853357287222097,0.0789473684210526
2011,19187,128,884,140,592,0,48,140,640,0.0250823013011444,0.21875
2011,19189,8,91,35,185,4,4,39,189,0.0250663129973475,0.206349206349206
2011,19191,46,188,70,167,9,39,79,206,0.0155132163566534,0.383495145631068
2011,19193,288,1202,441,1665,44,114,485,1779,0.0277673721670725,0.272625070264193
2011,19195,15,137,10,30,0,2,10,32,0.00594353640416048,0.3125
2011,19197,10,174,8,69,0,49,8,118,0.0127526207716416,0.0677966101694915
2011,20001,100,300,18,98,0,0,18,98,0.0109448291266473,0.183673469387755
2011,20003,48,300,5,49,1,1,6,50,0.00907770515613653,0.12
2011,20005,18,124,21,143,0,0,21,143,0.0138673390224981,0.146853146853147
2011,20007,23,96,20,87,0,3,20,90,0.0259216589861751,0.222222222222222
2011,20009,194,591,112,365,20,22,132,387,0.0211175379242606,0.341085271317829
2011,20011,55,198,45,129,0,8,45,137,0.0139454397394137,0.328467153284672
2011,20013,37,221,13,140,0,9,13,149,0.02201536643026,0.087248322147651
2011,20015,504,1944,177,886,31,54,208,940,0.0224504418438022,0.221276595744681
2011,20017,17,145,0,23,0,0,0,23,0.0116161616161616,0
2011,20019,16,85,17,98,0,7,17,105,0.0389321468298109,0.161904761904762
2011,20021,20,138,122,593,0,4,122,597,0.0408848102999589,0.204355108877722
2011,20023,4,26,10,72,0,0,10,72,0.0351906158357771,0.138888888888889
2011,20025,7,47,7,50,0,0,7,50,0.0325097529258778,0.14
2011,20027,10,115,0,97,0,65,0,162,0.0270541082164329,0
2011,20029,19,195,11,78,0,16,11,94,0.0146783260462211,0.117021276595745
2011,20031,52,307,29,142,0,0,29,142,0.0238695579088922,0.204225352112676
2011,20033,8,17,0,6,0,6,0,12,0.00881057268722467,0
2011,20035,99,1166,119,610,1,22,120,632,0.0269279931827865,0.189873417721519
2011,20037,44,319,186,484,36,55,222,539,0.0227810650887574,0.411873840445269
2011,20039,2,56,38,84,0,0,38,84,0.0356536502546689,0.452380952380952
2011,20041,85,374,48,339,0,39,48,378,0.0281375614113443,0.126984126984127
2011,20043,23,66,36,210,0,14,36,224,0.0433352679435094,0.160714285714286
2011,20045,681,1991,949,1655,370,504,1319,2159,0.0354067927251259,0.610930986567855
2011,20047,22,53,0,20,2,5,2,25,0.0115580212667591,0.08
2011,20049,53,192,6,28,0,0,6,28,0.0130780009341429,0.214285714285714
2011,20051,130,611,87,362,3,3,90,365,0.0215976331360947,0.246575342465753
2011,20053,109,397,5,27,0,2,5,29,0.00612331081081081,0.172413793103448
2011,20055,114,595,159,541,17,27,176,568,0.0274688074281845,0.309859154929577
2011,20057,105,477,126,644,14,49,140,693,0.0354602671033106,0.202020202020202
2011,20059,157,521,129,478,17,58,146,536,0.0317122234055141,0.272388059701493
2011,20061,119,428,351,1534,155,505,506,2039,0.11273290208437,0.24816086316822
2011,20063,4,63,4,35,0,0,4,35,0.0176589303733602,0.114285714285714
2011,20065,0,26,17,69,0,2,17,71,0.0355355355355355,0.23943661971831
2011,20067,29,108,0,22,0,0,0,22,0.00474751834268451,0
2011,20069,44,158,44,119,0,5,44,124,0.033879781420765,0.354838709677419
2011,20071,0,11,0,16,0,0,0,16,0.0174482006543075,0
2011,20073,2,131,7,31,0,2,7,33,0.0068649885583524,0.212121212121212
2011,20075,10,54,4,42,0,20,4,62,0.0360884749708964,0.0645161290322581
2011,20077,8,90,1,66,0,2,1,68,0.0162252445717013,0.0147058823529412
2011,20079,227,953,79,344,8,26,87,370,0.0164671324936579,0.235135135135135
2011,20081,14,88,0,56,4,18,4,74,0.0281797410510282,0.0540540540540541
2011,20083,11,43,7,44,0,0,7,44,0.0337164750957854,0.159090909090909
2011,20085,60,286,0,90,0,0,0,90,0.010130571814498,0
2011,20087,221,441,40,155,0,21,40,176,0.0134865900383142,0.227272727272727
2011,20089,11,28,0,36,0,3,0,39,0.0162432319866722,0
2011,20091,2368,5659,7273,13971,963,1936,8236,15907,0.0444621469400305,0.517759476959829
2011,20093,21,102,0,36,0,17,0,53,0.0222222222222222,0
2011,20095,5,49,15,51,0,0,15,51,0.00932699341623994,0.294117647058824
2011,20097,5,49,11,37,0,0,11,37,0.0206703910614525,0.297297297297297
2011,20099,36,395,39,297,0,20,39,317,0.0219255775349288,0.123028391167192
2011,20101,0,3,2,20,0,0,2,20,0.0175901495162709,0.1
2011,20103,507,2158,1397,3724,538,776,1935,4500,0.0889890840056953,0.43
2011,20105,4,60,0,35,0,3,0,38,0.0163581575548859,0
2011,20107,14,72,45,157,0,0,45,157,0.0229733684518584,0.286624203821656
2011,20109,13,40,1,66,0,0,1,66,0.0326086956521739,0.0151515151515152
2011,20111,99,513,86,555,28,62,114,617,0.0302851813674962,0.184764991896272
2011,20113,24,208,51,388,22,41,73,429,0.0217490494296578,0.17016317016317
2011,20115,8,357,64,112,0,0,64,112,0.0130551346310759,0.571428571428571
2011,20117,32,159,10,57,0,10,10,67,0.00937062937062937,0.149253731343284
2011,20119,54,143,3,43,3,4,6,47,0.0162068965517241,0.127659574468085
2011,20121,171,902,63,349,7,7,70,356,0.0166604268064395,0.196629213483146
2011,20123,48,90,19,64,0,1,19,65,0.0145121678946193,0.292307692307692
2011,20125,70,580,155,880,0,15,155,895,0.0381029418025459,0.173184357541899
2011,20127,21,164,12,96,7,10,19,106,0.025,0.179245283018868
2011,20129,5,63,15,135,0,0,15,135,0.0642551166111376,0.111111111111111
2011,20131,45,155,57,107,0,0,57,107,0.0153603215618719,0.532710280373832
2011,20133,69,353,0,105,0,5,0,110,0.0100282614641262,0
2011,20135,15,80,0,20,0,0,0,20,0.00863557858376511,0
2011,20137,12,345,3,129,5,6,8,135,0.0327272727272727,0.0592592592592593
2011,20139,18,470,11,75,44,55,55,130,0.0116310280039367,0.423076923076923
2011,20141,46,84,4,67,0,0,4,67,0.023716814159292,0.0597014925373134
2011,20143,26,182,12,66,0,0,12,66,0.0155184575593699,0.181818181818182
2011,20145,27,301,0,63,0,15,0,78,0.0158988993069711,0
2011,20147,20,49,3,56,0,0,3,56,0.0142566191446029,0.0535714285714286
2011,20149,201,625,98,157,0,20,98,177,0.0131598513011152,0.553672316384181
2011,20151,47,344,36,60,8,14,44,74,0.0115031866936111,0.594594594594595
2011,20153,13,34,10,29,0,0,10,29,0.0149638802889577,0.344827586206897
2011,20155,294,1556,141,688,85,131,226,819,0.0190054069106351,0.275946275946276
2011,20157,7,55,13,88,0,0,13,88,0.0233236151603499,0.147727272727273
2011,20159,28,297,53,200,0,1,53,201,0.0303258901629451,0.263681592039801
2011,20161,472,866,719,1887,517,858,1236,2745,0.0817402179739146,0.450273224043716
2011,20163,23,138,22,43,0,5,22,48,0.0130363932645301,0.458333333333333
2011,20165,35,104,3,35,0,0,3,35,0.0141643059490085,0.0857142857142857
2011,20167,50,171,2,75,0,0,2,75,0.01470299941188,0.0266666666666667
2011,20169,171,894,365,804,0,21,365,825,0.0226966353957468,0.442424242424242
2011,20171,0,2,0,44,0,0,0,44,0.0125570776255708,0
2011,20173,1449,4942,2322,6566,420,1091,2742,7657,0.0246119527239649,0.358103695964477
2011,20175,63,219,136,776,15,28,151,804,0.0629157211049378,0.187810945273632
2011,20177,588,2473,845,2572,169,374,1014,2946,0.0250446314715634,0.344195519348269
2011,20179,3,36,0,38,0,0,0,38,0.0213963963963964,0
2011,20181,0,48,0,123,0,0,0,123,0.0288393903868699,0
2011,20183,24,74,0,21,0,0,0,21,0.00690562315027951,0
2011,20185,35,100,3,13,0,0,3,13,0.00423039375203384,0.230769230769231
2011,20187,0,90,0,14,5,5,5,19,0.0139296187683284,0.263157894736842
2011,20189,15,180,5,158,0,12,5,170,0.0476858345021038,0.0294117647058824
2011,20191,34,663,56,193,4,15,60,208,0.0130309485026939,0.288461538461538
2011,20193,45,288,7,85,15,15,22,100,0.0205676676264912,0.22
2011,20195,18,56,16,16,0,0,16,16,0.00751526538280883,1
2011,20197,40,117,9,24,0,2,9,26,0.00538748445917945,0.346153846153846
2011,20199,4,20,3,11,0,0,3,11,0.0102611940298507,0.272727272727273
2011,20201,6,60,2,38,0,6,2,44,0.0104936799427617,0.0454545454545455
2011,20203,2,21,30,80,0,0,30,80,0.0544588155207624,0.375
2011,20205,17,168,4,66,0,0,4,66,0.010136691752419,0.0606060606060606
2011,20207,0,74,7,32,0,3,7,35,0.0142624286878566,0.2
2011,20209,547,2518,480,3366,136,517,616,3883,0.039933358700906,0.158640226628895
2011,21001,19,390,18,275,0,0,18,275,0.0222906703412499,0.0654545454545455
2011,21003,29,380,21,284,0,0,21,284,0.0213517780617999,0.073943661971831
2011,21005,119,894,17,31,0,6,17,37,0.00259503436667134,0.459459459459459
2011,21007,3,179,28,101,0,2,28,103,0.0177372137075943,0.271844660194175
2011,21009,84,605,78,290,0,74,78,364,0.0127063915942333,0.214285714285714
2011,21011,38,319,0,30,0,28,0,58,0.00736788617886179,0
2011,21013,23,306,70,343,0,0,70,343,0.017364450969473,0.204081632653061
2011,21015,821,3104,768,2074,263,457,1031,2531,0.0336354454603445,0.407348873962861
2011,21017,41,534,27,160,0,73,27,233,0.0169454545454545,0.11587982832618
2011,21019,86,667,117,1142,8,70,125,1212,0.0345289307996923,0.103135313531353
2011,21021,134,1155,137,536,11,15,148,551,0.0289314780782358,0.268602540834846
2011,21023,10,163,14,42,0,32,14,74,0.0131625755958734,0.189189189189189
2011,21025,0,293,0,29,5,11,5,40,0.00416796915702824,0.125
2011,21027,16,392,38,162,0,16,38,178,0.0130345635618043,0.213483146067416
2011,21029,158,1705,198,888,31,47,229,935,0.0190843589900598,0.244919786096257
2011,21031,16,210,7,94,0,0,7,94,0.0107416295280539,0.074468085106383
2011,21033,0,166,0,103,0,21,0,124,0.0136308673188963,0
2011,21035,112,333,304,550,40,87,344,637,0.0285253683220635,0.540031397174254
2011,21037,459,1487,512,1443,19,58,531,1501,0.0254281793694625,0.353764157228514
2011,21039,0,44,2,12,0,0,2,12,0.00338887319966111,0.166666666666667
2011,21041,0,355,32,272,0,1,32,273,0.0382620882971268,0.117216117216117
2011,21043,0,209,7,227,0,0,7,227,0.0121604971339798,0.0308370044052863
2011,21045,56,346,29,85,0,0,29,85,0.00785509657148138,0.341176470588235
2011,21047,113,648,516,2940,120,1112,636,4052,0.0962927756653992,0.156959526159921
2011,21049,231,1213,180,419,0,0,180,419,0.0170978535868767,0.429594272076372
2011,21051,0,161,0,271,0,0,0,271,0.0179398914338673,0
2011,21053,0,119,0,74,0,5,0,79,0.0113997113997114,0
2011,21055,0,107,0,52,6,6,6,58,0.00890663390663391,0.103448275862069
2011,21057,4,32,9,51,0,0,9,51,0.0106605351170569,0.176470588235294
2011,21059,191,1427,143,730,0,12,143,742,0.011566460382535,0.192722371967655
2011,21061,29,327,0,72,0,18,0,90,0.0107823170001198,0
2011,21063,24,458,0,0,0,0,0,0,0,NA
2011,21065,23,263,3,9,0,0,3,9,0.000872262066291917,0.333333333333333
2011,21067,1369,6238,2921,5551,736,1751,3657,7302,0.0387596076266508,0.500821692686935
2011,21069,25,59,10,265,0,44,10,309,0.0319214876033058,0.0323624595469256
2011,21071,98,960,1,256,20,23,21,279,0.0101806239737274,0.0752688172043011
2011,21073,395,1406,122,448,81,128,203,576,0.0171469397475589,0.352430555555556
2011,21075,23,120,34,181,0,5,34,186,0.0386935718743499,0.182795698924731
2011,21077,28,257,57,144,0,13,57,157,0.0287335285505124,0.363057324840764
2011,21079,71,477,0,91,0,35,0,126,0.0106960950764007,0
2011,21081,176,805,66,137,0,4,66,141,0.00898260814168312,0.468085106382979
2011,21083,46,420,16,228,0,80,16,308,0.0122552920579341,0.051948051948052
2011,21085,46,368,2,406,5,28,7,434,0.0249540018399264,0.0161290322580645
2011,21087,1,202,0,98,0,7,0,105,0.0130792227204783,0
2011,21089,37,479,77,468,0,23,77,491,0.0189546016059296,0.156822810590631
2011,21091,6,180,0,60,0,7,0,67,0.0117132867132867,0
2011,21093,286,1570,1075,3795,286,849,1361,4644,0.0702083270341366,0.29306632213609
2011,21095,14,325,22,130,0,10,22,140,0.00694203401596668,0.157142857142857
2011,21097,76,532,36,137,0,4,36,141,0.0108939194931623,0.25531914893617
2011,21099,19,340,4,78,0,6,4,84,0.00688976377952756,0.0476190476190476
2011,21101,58,618,157,612,0,5,157,617,0.0196109592524315,0.254457050243112
2011,21103,75,480,0,46,12,35,12,81,0.00772016774685475,0.148148148148148
2011,21105,63,271,0,70,0,0,0,70,0.0194986072423398,0
2011,21107,40,772,53,510,0,31,53,541,0.0166369395411772,0.0979667282809612
2011,21109,22,264,2,178,0,0,2,178,0.0191913746630728,0.0112359550561798
2011,21111,1805,6685,5014,12223,739,2275,5753,14498,0.0291123328821973,0.396813353566009
2011,21113,467,1798,419,663,28,42,447,705,0.0230053842388644,0.634042553191489
2011,21115,11,241,29,166,0,0,29,166,0.0102971279697289,0.174698795180723
2011,21117,856,3455,1102,3197,75,250,1177,3447,0.0328063880614061,0.341456338845373
2011,21119,0,290,31,104,0,7,31,111,0.00985003105865649,0.279279279279279
2011,21121,106,592,19,217,31,50,50,267,0.0126997716894977,0.187265917602996
2011,21123,10,215,8,166,0,39,8,205,0.0212765957446809,0.0390243902439024
2011,21125,302,961,90,675,0,12,90,687,0.017410035478966,0.131004366812227
2011,21127,42,363,7,235,10,10,17,245,0.0226265238271149,0.0693877551020408
2011,21129,10,194,0,128,0,0,0,128,0.0226910122318738,0
2011,21131,68,187,0,102,0,0,0,102,0.0129212059792247,0
2011,21133,22,311,17,95,0,16,17,111,0.00650644783118406,0.153153153153153
2011,21135,42,272,47,247,0,37,47,284,0.0298476090383605,0.165492957746479
2011,21137,156,579,21,83,0,0,21,83,0.00501419682232828,0.253012048192771
2011,21139,84,268,22,133,0,0,22,133,0.0195732155997057,0.165413533834586
2011,21141,29,442,28,455,0,25,28,480,0.0263273365511189,0.0583333333333333
2011,21143,32,494,8,68,0,0,8,68,0.0102286401925391,0.117647058823529
2011,21145,170,1423,375,1531,0,49,375,1580,0.0344774914351801,0.237341772151899
2011,21147,58,432,18,496,0,24,18,520,0.0421735604217356,0.0346153846153846
2011,21149,0,115,35,112,0,0,35,112,0.0170497792662506,0.3125
2011,21151,433,1624,272,1000,28,157,300,1157,0.0229127059569075,0.259291270527226
2011,21153,19,120,26,102,0,0,26,102,0.0114055686011406,0.254901960784314
2011,21155,28,434,14,53,0,7,14,60,0.00451773209848656,0.233333333333333
2011,21157,151,437,98,403,0,16,98,419,0.0185603543743079,0.233890214797136
2011,21159,0,321,45,364,10,20,55,384,0.0429770565193061,0.143229166666667
2011,21161,40,397,10,330,16,24,26,354,0.0298961236382062,0.0734463276836158
2011,21163,123,892,53,770,104,213,157,983,0.0532531556422341,0.15971515768057
2011,21165,16,140,0,28,0,0,0,28,0.00640146319158665,0
2011,21167,153,871,51,282,0,4,51,286,0.0194135215856639,0.178321678321678
2011,21169,39,316,5,16,0,16,5,32,0.00463768115942029,0.15625
2011,21171,60,214,7,78,0,0,7,78,0.0102834541858932,0.0897435897435897
2011,21173,33,501,14,474,10,22,24,496,0.027896512935883,0.0483870967741935
2011,21175,23,561,86,226,0,0,86,226,0.0227616074126297,0.380530973451327
2011,21177,7,662,28,182,0,35,28,217,0.00983680870353581,0.129032258064516
2011,21179,143,1111,45,370,27,27,72,397,0.013921032330458,0.181360201511335
2011,21181,38,147,38,77,0,0,38,77,0.0155902004454343,0.493506493506494
2011,21183,3,331,8,127,9,9,17,136,0.00842209561555611,0.125
2011,21185,543,1855,354,825,81,177,435,1002,0.0254903457223537,0.434131736526946
2011,21187,4,187,31,114,31,51,62,165,0.022207267833109,0.375757575757576
2011,21189,0,64,0,1,0,0,0,1,0.000285551113649343,0
2011,21191,20,331,3,151,0,10,3,161,0.0164959016393443,0.0186335403726708
2011,21193,11,333,0,141,0,0,0,141,0.00712049287950712,0
2011,21195,45,592,220,788,0,31,220,819,0.0180098955470038,0.268620268620269
2011,21197,44,160,0,182,0,0,0,182,0.0213615023474178,0
2011,21199,154,628,141,652,0,76,141,728,0.0166792677618164,0.193681318681319
2011,21201,0,52,0,4,0,0,0,4,0.00302800908402725,0
2011,21203,28,217,15,144,0,26,15,170,0.014468085106383,0.0882352941176471
2011,21205,136,761,38,283,0,0,38,283,0.0210252600297177,0.134275618374558
2011,21207,3,189,0,124,0,13,0,137,0.0111490885416667,0
2011,21209,525,2314,207,547,10,11,217,558,0.0188513513513513,0.388888888888889
2011,21211,259,1113,151,463,0,77,151,540,0.0193673337637185,0.27962962962963
2011,21213,12,279,185,808,0,12,185,820,0.071143501648447,0.225609756097561
2011,21215,79,393,54,138,0,0,54,138,0.0121329347634957,0.391304347826087
2011,21217,61,417,7,246,16,38,23,284,0.0176551038169837,0.0809859154929577
2011,21219,13,225,30,156,0,83,30,239,0.0302646574648601,0.125523012552301
2011,21221,63,351,96,243,0,0,96,243,0.0241238955623945,0.395061728395062
2011,21223,2,124,17,294,0,0,17,294,0.0490818030050083,0.0578231292517007
2011,21225,0,199,6,110,0,9,6,119,0.0127518216888127,0.0504201680672269
2011,21227,283,1626,619,1950,117,246,736,2196,0.0323059948510482,0.335154826958106
2011,21229,33,265,35,97,0,10,35,107,0.0137320328542094,0.327102803738318
2011,21231,84,288,0,247,0,1,0,248,0.0171852262490472,0
2011,21233,0,289,0,153,12,12,12,165,0.0176169122357463,0.0727272727272727
2011,21235,36,578,124,506,0,32,124,538,0.0231936540782894,0.230483271375465
2011,21237,42,69,0,26,0,0,0,26,0.00528455284552846,0
2011,21239,189,639,127,247,9,30,136,277,0.0163585897360184,0.490974729241877
2011,22001,39,892,113,539,35,51,148,590,0.0151819257886882,0.250847457627119
2011,22003,22,899,33,421,3,54,36,475,0.0265229772739963,0.0757894736842105
2011,22005,519,1801,400,1394,39,273,439,1667,0.0251740437034688,0.263347330533893
2011,22007,34,439,0,34,0,6,0,40,0.00257499678125402,0
2011,22009,63,944,84,340,1,92,85,432,0.0154186594332215,0.196759259259259
2011,22011,32,999,97,757,46,110,143,867,0.0375324675324675,0.164936562860438
2011,22013,24,390,0,189,0,0,0,189,0.0193746796514608,0
2011,22015,618,2408,883,2861,42,251,925,3112,0.0419017355828138,0.297236503856041
2011,22017,1148,4132,1246,3663,51,396,1297,4059,0.0244999215326485,0.319536831731954
2011,22019,437,2397,541,2752,202,388,743,3140,0.0255417452983666,0.236624203821656
2011,22021,72,305,2,78,0,0,2,78,0.0114285714285714,0.0256410256410256
2011,22023,41,126,24,159,0,22,24,181,0.0385188337944243,0.132596685082873
2011,22025,16,616,15,147,0,10,15,157,0.0223774230330673,0.0955414012738854
2011,22027,44,451,10,154,16,16,26,170,0.0143945808636749,0.152941176470588
2011,22029,39,563,117,543,0,14,117,557,0.0409468499595677,0.210053859964093
2011,22031,27,404,28,202,0,49,28,251,0.0141960296363328,0.111553784860558
2011,22033,1747,5438,2185,5133,604,833,2789,5966,0.0221636903324554,0.467482400268186
2011,22035,7,334,0,48,0,22,0,70,0.0141815235008104,0
2011,22037,113,993,7,63,0,0,7,63,0.00446302068574667,0.111111111111111
2011,22039,136,745,7,320,6,123,13,443,0.0204571692449781,0.0293453724604966
2011,22041,48,744,19,259,0,11,19,270,0.0196563774024461,0.0703703703703704
2011,22043,40,742,20,502,17,69,37,571,0.0384744963277407,0.0647985989492119
2011,22045,103,695,90,351,14,87,104,438,0.00946167804372246,0.237442922374429
2011,22047,105,2223,28,423,0,15,28,438,0.0194761883587532,0.0639269406392694
2011,22049,56,283,0,233,1,18,1,251,0.0229077302181254,0.00398406374501992
2011,22051,1864,7662,1835,6593,455,1298,2290,7891,0.0267667550863958,0.29020402990749
2011,22053,99,681,56,315,10,49,66,364,0.017818680242804,0.181318681318681
2011,22055,1151,3737,755,2567,270,654,1025,3221,0.0233436245307359,0.318224153989444
2011,22057,237,1643,23,303,0,179,23,482,0.0077630498155873,0.0477178423236514
2011,22059,32,371,9,245,0,27,9,272,0.0273394310986029,0.0330882352941176
2011,22061,308,795,235,770,103,133,338,903,0.036450974851653,0.374307862679956
2011,22063,608,3127,197,897,29,43,226,940,0.0117520566099067,0.240425531914894
2011,22065,6,457,84,209,0,12,84,221,0.0281492803464527,0.380090497737557
2011,22067,90,373,17,165,0,0,17,165,0.00883203083181672,0.103030303030303
2011,22069,154,807,62,280,37,51,99,331,0.0141001064962726,0.299093655589124
2011,22071,2890,8641,4120,11255,638,1119,4758,12374,0.0583285802501143,0.384515920478422
2011,22073,354,2218,395,1306,52,102,447,1408,0.0146788990825688,0.317471590909091
2011,22075,91,701,53,538,38,38,91,576,0.0396339365581779,0.157986111111111
2011,22077,54,177,18,102,0,80,18,182,0.0117290713411098,0.0989010989010989
2011,22079,525,2305,360,1179,60,215,420,1394,0.0163239495995129,0.3012912482066
2011,22081,9,97,13,49,0,0,13,49,0.0083079009833842,0.26530612244898
2011,22083,122,895,12,94,25,60,37,154,0.0112911503775937,0.24025974025974
2011,22085,45,205,32,171,3,20,35,191,0.0117676051999261,0.183246073298429
2011,22087,157,1318,62,516,0,109,62,625,0.0302648782141301,0.0992
2011,22089,87,731,55,319,37,74,92,393,0.0117299426934097,0.234096692111959
2011,22091,8,179,20,105,0,0,20,105,0.0145308607805148,0.19047619047619
2011,22093,61,253,61,147,14,14,75,161,0.0112784588441331,0.46583850931677
2011,22095,258,1171,62,305,0,21,62,326,0.0112309229338202,0.190184049079755
2011,22097,71,1041,53,303,13,65,66,368,0.00687619118801151,0.179347826086957
2011,22099,6,1130,22,232,1,73,23,305,0.00912245020039481,0.0754098360655738
2011,22101,124,843,97,566,0,260,97,826,0.0233881700031146,0.117433414043584
2011,22103,1259,4057,1243,4140,195,354,1438,4494,0.0290238830261305,0.319982198486871
2011,22105,166,1543,288,1241,86,151,374,1392,0.0187315812845666,0.26867816091954
2011,22107,0,171,5,33,0,0,5,33,0.00903367095537914,0.151515151515152
2011,22109,205,1393,226,1031,0,20,226,1051,0.0148295518681567,0.215033301617507
2011,22111,9,254,28,107,0,13,28,120,0.00775093657150239,0.233333333333333
2011,22113,161,896,26,357,13,25,39,382,0.0102558595323113,0.102094240837696
2011,22115,135,624,691,2247,121,446,812,2693,0.0900397873549768,0.30152246565169
2011,22117,46,781,59,642,0,9,59,651,0.0207549575973985,0.0906298003072197
2011,22119,33,751,24,519,0,8,24,527,0.0189146507788386,0.0455407969639469
2011,22121,125,1141,21,199,0,14,21,213,0.013997502792929,0.0985915492957746
2011,22123,0,210,5,224,0,4,5,228,0.0292232760830556,0.0219298245614035
2011,22125,46,300,9,137,0,22,9,159,0.0135503664564513,0.0566037735849057
2011,22127,43,654,24,296,0,0,24,296,0.0279113625648279,0.0810810810810811
2011,23001,319,2083,260,859,38,126,298,985,0.0134298647469459,0.30253807106599
2011,23003,130,528,138,579,10,52,148,631,0.0121889970638232,0.234548335974643
2011,23005,1614,4975,2968,5390,208,642,3176,6032,0.0307610713338637,0.526525198938992
2011,23007,91,433,80,227,0,9,80,236,0.0112676056338028,0.338983050847458
2011,23009,202,731,354,760,28,89,382,849,0.0212664696157507,0.449941107184923
2011,23011,440,2015,386,1132,151,251,537,1383,0.0161847140466466,0.388286334056399
2011,23013,99,796,340,626,0,9,340,635,0.0214911835380919,0.535433070866142
2011,23015,163,548,205,331,31,60,236,391,0.0151041063081856,0.603580562659846
2011,23017,214,1122,101,669,0,22,101,691,0.0167519212586972,0.14616497829233
2011,23019,399,1994,691,1588,76,172,767,1760,0.0171066443761907,0.435795454545455
2011,23021,86,341,43,214,28,42,71,256,0.0194958495164115,0.27734375
2011,23023,306,1341,294,589,0,26,294,615,0.0240883631663468,0.478048780487805
2011,23025,132,880,117,546,5,5,122,551,0.0147389257436336,0.221415607985481
2011,23027,160,753,261,491,7,17,268,508,0.0184593023255814,0.52755905511811
2011,23029,54,427,144,402,6,19,150,421,0.017623173845703,0.356294536817102
2011,23031,614,2398,1116,3651,133,203,1249,3854,0.0276074498567335,0.324078879086663
2011,24001,37,734,153,1118,2,23,155,1141,0.0221252666278844,0.135845749342682
2011,24003,4081,11706,4362,9057,1091,2144,5453,11201,0.0311321357795819,0.486831532898848
2011,24005,5218,16907,4507,8041,1304,2601,5811,10642,0.019547910934119,0.54604397669611
2011,24009,409,1169,507,1150,77,155,584,1305,0.0225567808621703,0.447509578544061
2011,24011,53,707,53,298,5,48,58,346,0.0158570119156737,0.167630057803468
2011,24013,1017,2652,471,1162,79,189,550,1351,0.012148515830838,0.407105847520355
2011,24015,242,1400,631,2158,3,112,634,2270,0.0342729455105461,0.279295154185022
2011,24017,712,2908,946,2767,138,271,1084,3038,0.0323177737117569,0.356813693219223
2011,24019,105,553,108,298,22,45,130,343,0.0150089703758806,0.379008746355685
2011,24021,1249,3598,1641,3353,262,740,1903,4093,0.0267219429392179,0.464940141705351
2011,24023,63,275,151,533,0,8,151,541,0.0256775357159808,0.279112754158965
2011,24025,1435,3410,1150,2358,159,437,1309,2795,0.0171335744498253,0.468336314847943
2011,24027,3747,7080,3154,4538,853,1355,4007,5893,0.031212758407,0.679959273714577
2011,24029,45,389,184,296,9,51,193,347,0.024824724567177,0.556195965417867
2011,24031,4073,9553,16038,22853,5434,9248,21472,32101,0.0489835093988949,0.668888819662939
2011,24033,3327,9119,5361,17118,1853,4193,7214,21311,0.0386003807329562,0.338510628314016
2011,24035,274,1068,94,425,21,50,115,475,0.0145938306501168,0.242105263157895
2011,24037,198,1085,909,2343,185,605,1094,2948,0.0446085403867688,0.371099050203528
2011,24039,30,1490,93,205,15,26,108,231,0.0136323399232812,0.467532467532468
2011,24041,175,670,258,459,94,116,352,575,0.0207326746953198,0.612173913043478
2011,24043,204,2531,741,2190,69,279,810,2469,0.0245215370405315,0.328068043742406
2011,24045,189,1203,484,1710,319,490,803,2200,0.0356188780053428,0.365
2011,24047,190,1152,168,598,1,15,169,613,0.0159456858205655,0.275693311582382
2011,24510,3783,11525,4946,7841,1424,2426,6370,10267,0.0252246807297886,0.620434401480471
2011,25001,1196,2493,1151,2499,141,526,1292,3025,0.0184435475020425,0.427107438016529
2011,25003,310,772,820,1741,63,256,883,1997,0.0214176167136775,0.442163244867301
2011,25005,1323,5824,1988,5366,399,1231,2387,6597,0.017727247077033,0.36183113536456
2011,25007,198,393,142,172,10,69,152,241,0.020315265952963,0.630705394190871
2011,25009,3644,8398,3709,7522,702,2238,4411,9760,0.0194211850106657,0.451946721311475
2011,25011,454,1298,414,906,52,233,466,1139,0.0222018634751082,0.409130816505707
2011,25013,956,2998,1182,4183,429,1909,1611,6092,0.0200599955875913,0.264445173998687
2011,25015,1135,2911,967,1668,448,586,1415,2254,0.0233950905599668,0.627772848269743
2011,25017,13448,24576,15472,21254,7344,11227,22816,32481,0.0315280948609235,0.702441427295958
2011,25019,35,35,55,123,0,21,55,144,0.0196936542669584,0.381944444444444
2011,25021,9070,16323,5129,7182,2299,3592,7428,10774,0.0234003227480936,0.689437534806014
2011,25023,2785,9887,1461,2896,359,993,1820,3889,0.0116721941263862,0.467986628953458
2011,25025,9326,17915,9035,12615,3514,6462,12549,19077,0.0413322875862308,0.657807831420035
2011,25027,3830,9114,3055,6647,1348,2598,4403,9245,0.0173954766115982,0.476257436452136
2011,26001,28,325,21,60,0,12,21,72,0.00810628236883585,0.291666666666667
2011,26003,67,534,17,112,0,0,17,112,0.0152588555858311,0.151785714285714
2011,26005,455,2459,173,600,19,94,192,694,0.00945426804348418,0.276657060518732
2011,26007,89,475,52,231,10,67,62,298,0.0139722430607652,0.208053691275168
2011,26009,76,624,32,129,24,75,56,204,0.0117640274493974,0.274509803921569
2011,26011,63,568,22,100,0,21,22,121,0.0102690316557753,0.181818181818182
2011,26013,20,571,0,24,0,5,0,29,0.00439327374640206,0
2011,26015,182,887,32,258,23,86,55,344,0.00853068815871048,0.159883720930233
2011,26017,352,1925,34,504,114,139,148,643,0.00861745470140452,0.230171073094868
2011,26019,128,405,56,99,3,11,59,110,0.00860383261634728,0.536363636363636
2011,26021,285,1170,827,1954,72,236,899,2190,0.0205175289025464,0.410502283105023
2011,26023,133,1234,33,295,9,41,42,336,0.010793793568698,0.125
2011,26025,493,2697,344,1078,93,354,437,1432,0.0157822229569626,0.305167597765363
2011,26027,140,655,125,732,7,35,132,767,0.0213073311664861,0.172099087353325
2011,26029,125,485,38,145,7,27,45,172,0.0092468146873824,0.261627906976744
2011,26031,124,733,25,149,6,16,31,165,0.0085807894326278,0.187878787878788
2011,26033,124,1309,34,325,0,73,34,398,0.0147385572507777,0.085427135678392
2011,26035,112,950,15,138,4,29,19,167,0.0075531433740389,0.11377245508982
2011,26037,611,1723,169,525,7,58,176,583,0.0120586592756531,0.30188679245283
2011,26039,86,605,0,50,0,3,0,53,0.00509615384615385,0
2011,26041,69,482,49,414,26,57,75,471,0.0176549966264338,0.159235668789809
2011,26043,115,438,88,381,0,15,88,396,0.0210113015334005,0.222222222222222
2011,26045,733,3226,376,854,123,199,499,1053,0.0144601145274028,0.473884140550807
2011,26047,286,775,114,268,6,48,120,316,0.0138675560626673,0.379746835443038
2011,26049,1119,5733,506,2151,214,513,720,2664,0.00942635132266146,0.27027027027027
2011,26051,104,769,33,119,5,35,38,154,0.00815591568689757,0.246753246753247
2011,26053,24,450,52,372,34,34,86,406,0.0330565054551376,0.211822660098522
2011,26055,734,2935,279,813,52,152,331,965,0.0159720613062332,0.34300518134715
2011,26057,124,1652,24,145,9,26,33,171,0.00599873710797727,0.192982456140351
2011,26059,43,614,100,391,2,94,102,485,0.0156502097450791,0.210309278350515
2011,26061,167,476,137,386,159,201,296,587,0.0276365348399247,0.504258943781942
2011,26063,126,630,22,88,12,36,34,124,0.00511340206185567,0.274193548387097
2011,26065,1602,5350,1628,2538,1058,1816,2686,4354,0.0262596045981448,0.616903996325218
2011,26067,242,2531,39,308,35,84,74,392,0.00925117409671253,0.188775510204082
2011,26069,49,805,10,107,33,35,43,142,0.00719971606753536,0.302816901408451
2011,26071,12,113,17,162,0,6,17,168,0.0181543116490166,0.101190476190476
2011,26073,279,1386,186,439,100,119,286,558,0.0159629248197734,0.512544802867383
2011,26075,526,4627,195,803,44,210,239,1013,0.00933502893582513,0.235932872655479
2011,26077,1371,4174,791,1942,212,554,1003,2496,0.0162763855468826,0.401842948717949
2011,26079,98,447,5,129,0,10,5,139,0.0114610817941953,0.0359712230215827
2011,26081,2255,7985,1951,4778,556,1390,2507,6168,0.0162422218769668,0.406452658884565
2011,26083,4,68,8,26,0,0,8,26,0.0174146014735432,0.307692307692308
2011,26085,19,445,3,96,0,3,3,99,0.0113806184618922,0.0303030303030303
2011,26087,336,2211,100,398,0,105,100,503,0.00835104263514411,0.198807157057654
2011,26089,229,524,83,187,4,12,87,199,0.0123541097591259,0.437185929648241
2011,26091,258,1951,349,848,11,191,360,1039,0.0154287071961035,0.346487006737247
2011,26093,1291,4200,249,987,60,232,309,1219,0.0100146234863049,0.253486464315012
2011,26095,13,278,26,45,0,3,26,48,0.00965600482800241,0.541666666666667
2011,26097,48,222,56,173,7,15,63,188,0.0221959858323495,0.335106382978723
2011,26099,3114,16052,887,3470,722,2575,1609,6045,0.0105010084094924,0.266170388751034
2011,26101,90,792,67,162,12,59,79,221,0.012163575320601,0.357466063348416
2011,26103,121,1000,209,550,45,176,254,726,0.0164510208243638,0.349862258953168
2011,26105,122,559,123,305,8,13,131,318,0.0156419085095917,0.411949685534591
2011,26107,216,917,55,145,17,98,72,243,0.00967780477119758,0.296296296296296
2011,26109,35,111,61,290,3,5,64,295,0.016888990668117,0.216949152542373
2011,26111,156,1176,400,1145,38,147,438,1292,0.0230656621558896,0.339009287925697
2011,26113,44,421,22,104,0,14,22,118,0.0116198916789759,0.186440677966102
2011,26115,479,2236,245,1526,52,186,297,1712,0.01672871534801,0.173481308411215
2011,26117,232,1689,56,330,59,89,115,419,0.0099131710317742,0.274463007159905
2011,26119,43,288,7,132,0,22,7,154,0.020128087831656,0.0454545454545455
2011,26121,464,3289,220,1313,26,95,246,1408,0.0123955664721056,0.174715909090909
2011,26123,106,1377,71,314,0,20,71,334,0.0102845177977583,0.212574850299401
2011,26125,9610,28014,5266,9507,3753,6362,9019,15869,0.019194343178261,0.568340790219926
2011,26127,57,414,18,340,4,44,22,384,0.0213120213120213,0.0572916666666667
2011,26129,71,609,14,146,0,9,14,155,0.00976131998236665,0.0903225806451613
2011,26131,10,61,10,50,0,4,10,54,0.0099009900990099,0.185185185185185
2011,26133,78,602,17,131,15,21,32,152,0.00953097567093052,0.210526315789474
2011,26135,10,191,14,89,0,14,14,103,0.0160511142278323,0.135922330097087
2011,26137,123,795,49,221,0,0,49,221,0.013129752851711,0.221719457013575
2011,26139,1243,4869,546,1705,229,344,775,2049,0.0127702538469689,0.378233284529039
2011,26141,27,273,25,116,0,4,25,120,0.0114646030381198,0.208333333333333
2011,26143,70,804,13,182,0,34,13,216,0.0112207792207792,0.0601851851851852
2011,26145,515,3121,393,1386,98,190,491,1576,0.0118958658846795,0.311548223350254
2011,26147,390,2386,271,878,44,172,315,1050,0.00939135101292429,0.3
2011,26149,72,546,118,542,0,19,118,561,0.0138597228055439,0.210338680926916
2011,26151,88,702,23,175,0,23,23,198,0.00663805820034867,0.116161616161616
2011,26153,20,122,13,95,0,3,13,98,0.0155802861685215,0.13265306122449
2011,26155,151,1472,45,437,57,116,102,553,0.011621553463349,0.184448462929476
2011,26157,80,1158,101,380,36,75,137,455,0.0118836188884246,0.301098901098901
2011,26159,184,1087,147,877,58,105,205,982,0.0193037290401211,0.208757637474542
2011,26161,2641,7011,3565,5499,1790,2354,5355,7853,0.0370968732432956,0.681905004456896
2011,26163,4207,18303,2888,9926,1933,4929,4821,14855,0.0124348853152836,0.324537192864355
2011,26165,122,726,86,202,0,26,86,228,0.0102725839152962,0.37719298245614
2011,27001,111,483,5,55,0,9,5,64,0.00509757068896854,0.078125
2011,27003,2198,9464,697,1733,237,791,934,2524,0.0116714064414696,0.370047543581616
2011,27005,78,476,87,470,0,15,87,485,0.0217997123336929,0.179381443298969
2011,27007,284,771,157,419,10,30,167,449,0.0166815277158567,0.371937639198218
2011,27009,241,1499,47,207,0,14,47,221,0.00897571277719113,0.212669683257919
2011,27011,18,153,3,14,1,2,4,16,0.0041386445938955,0.25
2011,27013,273,1126,214,356,53,72,267,428,0.0117737676056338,0.623831775700935
2011,27015,70,295,19,166,0,17,19,183,0.0103191609337995,0.103825136612022
2011,27017,297,960,92,190,10,38,102,228,0.00940904588973259,0.447368421052632
2011,27019,1030,2532,466,757,68,131,534,888,0.01557484872402,0.601351351351351
2011,27021,133,686,67,183,8,17,75,200,0.00972715334857254,0.375
2011,27023,20,270,33,114,2,4,35,118,0.013827044762128,0.296610169491525
2011,27025,294,2285,82,210,18,98,100,308,0.00868094701240135,0.324675324675325
2011,27027,115,637,465,1142,35,79,500,1221,0.0354436993816947,0.40950040950041
2011,27029,20,129,4,33,2,2,6,35,0.00586166471277843,0.171428571428571
2011,27031,17,90,36,44,13,46,49,90,0.0218181818181818,0.544444444444444
2011,27033,20,273,4,41,0,52,4,93,0.0114110429447853,0.043010752688172
2011,27035,253,1298,155,419,13,62,168,481,0.0111528473381562,0.349272349272349
2011,27037,3043,8834,2035,4122,454,1397,2489,5519,0.0212112593776903,0.450987497735097
2011,27039,89,322,27,64,0,6,27,70,0.00546533416614616,0.385714285714286
2011,27041,259,679,3,85,0,16,3,101,0.00400174333372955,0.0297029702970297
2011,27043,16,150,25,105,0,4,25,109,0.0104376137125347,0.229357798165138
2011,27045,76,359,28,109,12,36,40,145,0.0100680461047077,0.275862068965517
2011,27047,65,447,52,187,74,127,126,314,0.0141505182514646,0.401273885350318
2011,27049,224,855,235,543,27,43,262,586,0.0184805575704059,0.447098976109215
2011,27051,46,140,10,30,0,2,10,32,0.00732600732600733,0.3125
2011,27053,8169,18821,9266,16163,2668,4786,11934,20949,0.0271306685730271,0.569669196620364
2011,27055,19,86,127,404,52,59,179,463,0.0345677168881589,0.386609071274298
2011,27057,95,462,68,246,5,13,73,259,0.0176671214188267,0.281853281853282
2011,27059,187,1201,37,314,0,43,37,357,0.0143598407143719,0.103641456582633
2011,27061,165,679,65,335,6,41,71,376,0.01175,0.188829787234043
2011,27063,41,167,10,81,2,8,12,89,0.0121934511576928,0.134831460674157
2011,27065,87,450,19,120,14,16,33,136,0.0120353982300885,0.242647058823529
2011,27067,133,670,91,282,5,11,96,293,0.0105032979638658,0.327645051194539
2011,27069,8,52,18,47,0,0,18,47,0.0141694302080193,0.382978723404255
2011,27071,55,258,32,150,0,9,32,159,0.0164630358252226,0.20125786163522
2011,27073,34,126,6,27,0,2,6,29,0.00544192156126853,0.206896551724138
2011,27075,16,200,11,147,3,7,14,154,0.018819503849444,0.0909090909090909
2011,27077,0,84,40,79,15,15,55,94,0.0308196721311475,0.585106382978723
2011,27079,190,669,29,144,3,22,32,166,0.00888318082089153,0.192771084337349
2011,27081,32,104,19,76,0,7,19,83,0.0194881427565156,0.228915662650602
2011,27083,79,363,111,340,12,22,123,362,0.0225601395986539,0.339779005524862
2011,27085,208,828,60,142,7,34,67,176,0.00714111823419622,0.380681818181818
2011,27087,24,90,9,28,0,0,9,28,0.00827178729689808,0.321428571428571
2011,27089,34,186,10,45,2,5,12,50,0.00746157289956723,0.24
2011,27091,21,100,31,106,3,23,34,129,0.00872801082543978,0.263565891472868
2011,27093,121,484,13,64,7,37,20,101,0.00640131829129167,0.198019801980198
2011,27095,190,946,20,123,3,14,23,137,0.00780448900535491,0.167883211678832
2011,27097,111,695,26,147,51,65,77,212,0.00943900267141585,0.363207547169811
2011,27099,113,707,50,420,25,100,75,520,0.0200076952674105,0.144230769230769
2011,27101,18,117,12,54,2,8,14,62,0.00984439504604636,0.225806451612903
2011,27103,191,863,192,344,0,8,192,352,0.0175072117775788,0.545454545454545
2011,27105,76,262,124,286,13,89,137,375,0.0273025118310885,0.365333333333333
2011,27107,0,108,9,96,0,6,9,102,0.0211530485275819,0.0882352941176471
2011,27109,505,1897,1567,2398,313,490,1880,2888,0.0302405210416645,0.650969529085873
2011,27111,195,1021,106,383,9,85,115,468,0.0114210410718208,0.245726495726496
2011,27113,45,391,5,56,5,7,10,63,0.00670855074007028,0.158730158730159
2011,27115,71,750,27,330,4,37,31,367,0.0174970202622169,0.0844686648501362
2011,27117,62,168,17,124,0,12,17,136,0.0207380298871607,0.125
2011,27119,96,513,122,516,14,24,136,540,0.0259865255052935,0.251851851851852
2011,27121,43,214,41,64,2,28,43,92,0.0115273775216138,0.467391304347826
2011,27123,4845,13105,2649,5455,989,2166,3638,7621,0.0232680975788477,0.477365175173862
2011,27125,12,121,1,26,0,0,1,26,0.00909090909090909,0.0384615384615385
2011,27127,35,265,20,76,18,21,38,97,0.00883907417532349,0.391752577319588
2011,27129,48,373,38,104,6,15,44,119,0.0107400722021661,0.369747899159664
2011,27131,407,2169,203,746,8,54,211,800,0.020580895783489,0.26375
2011,27133,9,73,17,103,14,28,31,131,0.0200674019607843,0.236641221374046
2011,27135,43,178,2,68,1,31,3,99,0.00940975192472198,0.0303030303030303
2011,27137,817,2417,560,1608,65,287,625,1895,0.0140811579987665,0.329815303430079
2011,27139,1375,3983,432,740,65,223,497,963,0.011864427661488,0.516095534787124
2011,27141,868,3542,179,603,47,105,226,708,0.0129836787089675,0.319209039548023
2011,27143,28,278,12,99,1,13,13,112,0.0108202106076708,0.116071428571429
2011,27145,730,3080,283,1091,51,197,334,1288,0.0142092779524519,0.259316770186335
2011,27147,119,686,253,492,0,9,253,501,0.0206283196771936,0.50499001996008
2011,27149,39,157,35,157,9,38,44,195,0.0335339638865004,0.225641025641026
2011,27151,21,322,12,25,0,8,12,33,0.00473321858864028,0.363636363636364
2011,27153,56,423,9,66,4,63,13,129,0.00771069934249851,0.10077519379845
2011,27155,8,63,5,51,11,20,16,71,0.0268837561529724,0.225352112676056
2011,27157,76,311,62,176,12,57,74,233,0.0154735024571656,0.317596566523605
2011,27159,46,289,24,78,3,11,27,89,0.00931742043551089,0.303370786516854
2011,27161,111,282,22,355,0,3,22,358,0.0271294331615641,0.0614525139664804
2011,27163,2316,6256,1274,2181,242,428,1516,2609,0.0168210801854252,0.581065542353392
2011,27165,16,203,17,51,0,20,17,71,0.00932737782448765,0.23943661971831
2011,27167,64,111,3,150,11,13,14,163,0.0356908254871907,0.0858895705521472
2011,27169,164,643,159,427,22,28,181,455,0.0150707164386738,0.397802197802198
2011,27171,967,2963,271,800,81,220,352,1020,0.0131027926932662,0.345098039215686
2011,27173,52,223,17,127,0,18,17,145,0.0200886672208368,0.117241379310345
2011,28001,115,222,33,670,11,52,44,722,0.0328092338453149,0.0609418282548476
2011,28003,171,639,172,633,0,33,172,666,0.0266218971099652,0.258258258258258
2011,28005,6,167,0,175,0,0,0,175,0.0191403259324073,0
2011,28007,52,415,0,215,0,0,0,215,0.0166938426896498,0
2011,28009,4,97,1,94,0,0,1,94,0.0162041027409067,0.0106382978723404
2011,28011,35,434,92,535,0,3,92,538,0.0252238735993249,0.171003717472119
2011,28013,24,386,15,117,0,13,15,130,0.0129818254443779,0.115384615384615
2011,28015,74,248,0,80,0,0,0,80,0.0108020523899541,0
2011,28017,48,207,21,94,0,13,21,107,0.00952889838810224,0.196261682242991
2011,28019,0,140,10,103,0,0,10,103,0.0173634524612272,0.0970873786407767
2011,28021,10,65,4,93,0,0,4,93,0.0162275344616995,0.043010752688172
2011,28023,41,271,27,59,5,5,32,64,0.00570613409415121,0.5
2011,28025,58,493,34,111,0,8,34,119,0.00881938783072704,0.285714285714286
2011,28027,75,379,29,191,0,32,29,223,0.0142164987887288,0.130044843049327
2011,28029,102,335,22,96,0,0,22,96,0.00511536207172164,0.229166666666667
2011,28031,81,429,10,93,0,4,10,97,0.00778866227718002,0.103092783505155
2011,28033,299,1570,1023,5094,166,312,1189,5406,0.0534300595973473,0.219940806511284
2011,28035,588,2017,292,1121,56,198,348,1319,0.0296171550465926,0.263836239575436
2011,28037,37,86,0,30,0,1,0,31,0.00569852941176471,0
2011,28039,47,426,40,337,0,139,40,476,0.0331614880869444,0.0840336134453782
2011,28041,62,1292,39,216,21,69,60,285,0.0292728019720624,0.210526315789474
2011,28043,109,541,45,271,0,61,45,332,0.0226714012564873,0.135542168674699
2011,28045,456,1595,197,831,0,44,197,875,0.0295797978432102,0.225142857142857
2011,28047,596,3381,992,4838,259,1091,1251,5929,0.0494780148709432,0.21099679541238
2011,28049,933,3262,657,1914,79,310,736,2224,0.0147027713137296,0.330935251798561
2011,28051,13,198,41,151,0,34,41,185,0.0162737508796622,0.221621621621622
2011,28053,27,59,8,40,0,39,8,79,0.0135832187070151,0.10126582278481
2011,28055,2,186,0,55,0,0,0,55,0.0448979591836735,0
2011,28057,128,477,19,394,0,17,19,411,0.026645056726094,0.0462287104622871
2011,28059,718,2483,775,3037,22,217,797,3254,0.0358129450479304,0.244929317762754
2011,28061,66,270,6,21,0,0,6,21,0.00182481751824818,0.285714285714286
2011,28063,89,263,0,30,0,0,0,30,0.00582637405321422,0
2011,28065,16,134,1,45,0,0,1,45,0.0053475935828877,0.0222222222222222
2011,28067,123,800,125,486,16,56,141,542,0.0124497530722407,0.260147601476015
2011,28069,0,344,0,17,0,0,0,17,0.00242096268869268,0
2011,28071,188,678,509,1067,94,94,603,1161,0.0460148230351552,0.51937984496124
2011,28073,580,1903,267,961,29,118,296,1079,0.0317810962858237,0.274328081556997
2011,28075,196,1412,444,1414,26,122,470,1536,0.0295589254098992,0.305989583333333
2011,28077,29,196,13,79,0,0,13,79,0.00928319623971798,0.164556962025316
2011,28079,38,482,4,187,0,20,4,207,0.0146052353065688,0.0193236714975845
2011,28081,350,1896,272,922,101,155,373,1077,0.0201628755967425,0.346332404828227
2011,28083,71,736,0,173,19,27,19,200,0.0100999899000101,0.095
2011,28085,110,362,71,341,0,0,71,341,0.0149306011646745,0.208211143695015
2011,28087,60,986,278,1010,28,153,306,1163,0.0305867501249244,0.26311263972485
2011,28089,1441,2773,589,1162,83,137,672,1299,0.0215823752242972,0.517321016166282
2011,28091,74,402,17,289,8,27,25,316,0.017964752700398,0.0791139240506329
2011,28093,34,935,0,409,0,0,0,409,0.0166918336530221,0
2011,28095,38,501,20,111,0,0,20,111,0.00447761194029851,0.18018018018018
2011,28097,2,57,0,38,6,6,6,44,0.00614439324116743,0.136363636363636
2011,28099,105,677,16,126,0,4,16,130,0.00700808625336927,0.123076923076923
2011,28101,52,321,0,200,0,0,0,200,0.0144102601051949,0
2011,28103,17,60,40,60,0,0,40,60,0.00814221739720451,0.666666666666667
2011,28105,362,884,251,584,67,110,318,694,0.0293993052613742,0.45821325648415
2011,28107,90,447,61,341,54,113,115,454,0.0205578699510958,0.253303964757709
2011,28109,89,482,188,1093,17,57,205,1150,0.0310945273631841,0.178260869565217
2011,28111,0,73,0,115,0,7,0,122,0.0151064883605745,0
2011,28113,135,485,71,603,15,15,86,618,0.0239386427022002,0.13915857605178
2011,28115,7,463,38,206,33,57,71,263,0.0137415747949214,0.269961977186312
2011,28117,1,487,50,191,34,34,84,225,0.0136009188176268,0.373333333333333
2011,28119,39,200,0,83,0,0,0,83,0.0156870156870157,0
2011,28121,1501,4656,514,1794,42,183,556,1977,0.0211254060523166,0.281234193222054
2011,28123,4,378,22,221,11,109,33,330,0.0185216366391648,0.1
2011,28125,28,147,5,11,0,0,5,11,0.00352677140109009,0.454545454545455
2011,28127,39,647,24,251,0,27,24,278,0.0155056054436946,0.0863309352517986
2011,28129,6,174,33,41,0,19,33,60,0.00561377245508982,0.55
2011,28131,46,422,140,248,0,0,140,248,0.0224332881049299,0.564516129032258
2011,28133,103,1419,63,262,6,17,69,279,0.0146410579345088,0.247311827956989
2011,28135,15,246,11,434,0,17,11,451,0.0452493227651249,0.024390243902439
2011,28137,69,384,44,114,0,12,44,126,0.0070635721493441,0.349206349206349
2011,28139,6,434,0,173,0,0,0,173,0.0119269217511203,0
2011,28141,38,211,16,209,0,20,16,229,0.0169103529759267,0.0698689956331878
2011,28143,47,253,27,263,0,30,27,293,0.0449248696718798,0.0921501706484642
2011,28145,70,527,3,189,12,12,15,201,0.0113437552909306,0.0746268656716418
2011,28147,110,191,0,67,0,0,0,67,0.0066087985796015,0
2011,28149,46,543,298,802,0,22,298,824,0.0258299112880474,0.361650485436893
2011,28151,158,593,213,447,16,76,229,523,0.0163396650837291,0.437858508604206
2011,28153,11,147,33,140,0,6,33,146,0.0108711839166046,0.226027397260274
2011,28155,92,233,5,65,0,0,5,65,0.00957008244994111,0.0769230769230769
2011,28157,3,357,50,169,0,0,50,169,0.0252125913769954,0.29585798816568
2011,28159,48,277,59,192,0,0,59,192,0.0148285449490269,0.307291666666667
2011,28161,14,334,0,3,0,22,0,25,0.00298080362465721,0
2011,28163,86,282,51,661,16,97,67,758,0.0408163265306122,0.0883905013192612
2011,29001,55,406,137,424,9,12,146,436,0.0317737939075936,0.334862385321101
2011,29003,81,522,20,120,12,19,32,139,0.0118844049247606,0.23021582733813
2011,29005,2,34,8,68,0,0,8,68,0.0164688786631146,0.117647058823529
2011,29007,89,1219,133,450,0,0,133,450,0.0259920291110726,0.295555555555556
2011,29009,37,800,42,691,21,21,63,712,0.0295779328680625,0.0884831460674157
2011,29011,64,193,6,104,3,3,9,107,0.0128405136205448,0.0841121495327103
2011,29013,11,383,0,138,0,5,0,143,0.0123713123972662,0
2011,29015,14,464,63,289,0,3,63,292,0.0201950342347327,0.215753424657534
2011,29017,42,296,0,59,0,0,0,59,0.00701629206802236,0
2011,29019,907,2679,993,2315,431,662,1424,2977,0.0322280320006928,0.478333893181055
2011,29021,308,2716,321,1799,38,161,359,1960,0.0336128689269606,0.183163265306122
2011,29023,63,631,94,533,37,53,131,586,0.0201187901259999,0.223549488054608
2011,29025,18,199,4,87,2,2,6,89,0.0139717425431711,0.0674157303370786
2011,29027,248,1869,143,524,37,59,180,583,0.0201702186548575,0.308747855917667
2011,29029,202,1269,194,777,16,75,210,852,0.0263695450324977,0.246478873239437
2011,29031,369,1414,284,1015,43,144,327,1159,0.024230640575347,0.28213977566868
2011,29033,16,112,0,32,0,0,0,32,0.00494437577255871,0
2011,29035,0,75,69,71,0,0,69,71,0.0171871217622852,0.971830985915493
2011,29037,689,3084,358,1386,23,102,381,1488,0.0229286407692189,0.256048387096774
2011,29039,2,346,69,158,0,7,69,165,0.0167819365337673,0.418181818181818
2011,29041,36,200,0,6,0,6,0,12,0.00217430693966298,0
2011,29043,782,2817,402,1281,20,136,422,1417,0.0286372547038257,0.297812279463656
2011,29045,16,92,4,177,0,17,4,194,0.0389323700581979,0.0206185567010309
2011,29047,1537,5570,1144,3296,144,341,1288,3637,0.0251834925910539,0.354138025845477
2011,29049,31,638,27,195,0,0,27,195,0.0138987883107627,0.138461538461538
2011,29051,651,3012,172,590,55,81,227,671,0.0132766125840918,0.338301043219076
2011,29053,63,982,23,248,0,3,23,251,0.0212747923376844,0.0916334661354582
2011,29055,84,533,39,185,0,0,39,185,0.0110718774313244,0.210810810810811
2011,29057,0,314,12,51,0,7,12,58,0.0103294746215494,0.206896551724138
2011,29059,101,375,103,273,5,43,108,316,0.0276513825691285,0.341772151898734
2011,29061,10,152,25,111,0,7,25,118,0.0213458755426917,0.211864406779661
2011,29063,72,1112,39,165,0,2,39,167,0.0175807979787346,0.233532934131737
2011,29065,82,258,0,129,0,6,0,135,0.0124861265260821,0
2011,29067,36,192,0,140,25,33,25,173,0.0181971179131167,0.144508670520231
2011,29069,33,638,45,543,0,20,45,563,0.0264406142863852,0.0799289520426288
2011,29071,225,1731,328,790,0,36,328,826,0.0122321441793653,0.397094430992736
2011,29073,38,377,0,68,0,0,0,68,0.00627885503231764,0
2011,29075,29,184,0,83,0,0,0,83,0.0181738559229253,0
2011,29077,1054,5169,1176,4653,336,648,1512,5301,0.0300290603810139,0.285229202037351
2011,29079,67,445,3,57,0,37,3,94,0.0136806869451317,0.0319148936170213
2011,29081,15,97,4,121,0,0,4,121,0.0197229013854931,0.0330578512396694
2011,29083,66,589,36,192,0,3,36,195,0.0123277279049184,0.184615384615385
2011,29085,0,157,2,135,0,0,2,135,0.0180433039294306,0.0148148148148148
2011,29087,15,120,6,55,0,4,6,59,0.0163616195230172,0.101694915254237
2011,29089,91,318,26,40,0,0,26,40,0.00610407446970853,0.65
2011,29091,28,433,129,573,5,38,134,611,0.0228377065111759,0.219312602291326
2011,29093,13,340,0,115,0,3,0,118,0.0158751513520786,0
2011,29095,1890,7286,4625,12011,387,1071,5012,13082,0.0295576296959057,0.383121846812414
2011,29097,314,1450,242,1728,46,64,288,1792,0.0241392316396358,0.160714285714286
2011,29099,912,4359,387,1422,53,205,440,1627,0.0112763716004547,0.270436385986478
2011,29101,266,1090,321,1162,71,263,392,1425,0.0476190476190476,0.275087719298246
2011,29103,92,194,0,22,0,0,0,22,0.00771929824561404,0
2011,29105,121,925,165,483,19,19,184,502,0.0211796472871488,0.366533864541833
2011,29107,87,1040,28,176,20,20,48,196,0.00871149828881284,0.244897959183673
2011,29109,247,1013,19,519,5,36,24,555,0.0217238139971818,0.0432432432432432
2011,29111,30,173,10,120,0,0,10,120,0.0182565038795071,0.0833333333333333
2011,29113,176,1045,49,485,18,32,67,517,0.0155530820372432,0.129593810444874
2011,29115,60,253,0,63,0,5,0,68,0.0077990595251749,0
2011,29117,42,381,0,106,4,4,4,110,0.0105263157894737,0.0363636363636364
2011,29119,66,548,3,534,19,44,22,578,0.0397196261682243,0.0380622837370242
2011,29121,52,201,38,158,3,19,41,177,0.0165761378535306,0.231638418079096
2011,29123,32,211,134,372,0,2,134,374,0.0447047573511834,0.358288770053476
2011,29125,40,463,12,16,0,0,12,16,0.00256,0.75
2011,29127,73,548,43,266,0,26,43,292,0.0152895591161378,0.147260273972603
2011,29129,13,75,1,50,0,4,1,54,0.0208012326656394,0.0185185185185185
2011,29131,41,473,50,203,0,44,50,247,0.0147120138185717,0.202429149797571
2011,29133,20,566,15,423,0,78,15,501,0.0511694413236646,0.029940119760479
2011,29135,128,825,1,174,13,13,14,187,0.0180886051460631,0.0748663101604278
2011,29137,58,268,34,93,0,0,34,93,0.0150024197451202,0.365591397849462
2011,29139,77,438,14,106,0,0,14,106,0.0124340175953079,0.132075471698113
2011,29141,112,557,42,157,0,0,42,157,0.0106853603756891,0.267515923566879
2011,29143,138,544,22,178,0,4,22,182,0.0142588530241304,0.120879120879121
2011,29145,294,1566,232,955,6,98,238,1053,0.0276850269488629,0.226020892687559
2011,29147,91,681,116,239,45,85,161,324,0.0258723947935798,0.496913580246914
2011,29149,10,330,3,214,0,0,3,214,0.0281282860147213,0.014018691588785
2011,29151,69,389,3,49,0,0,3,49,0.00539647577092511,0.0612244897959184
2011,29153,10,116,2,114,0,0,2,114,0.0158619730068179,0.0175438596491228
2011,29155,42,330,78,199,0,3,78,202,0.017327157316864,0.386138613861386
2011,29157,27,319,37,130,9,20,46,150,0.0117980179329873,0.306666666666667
2011,29159,63,688,133,365,0,39,133,404,0.0148365773044436,0.329207920792079
2011,29161,190,1051,269,529,179,284,448,813,0.0302444105502027,0.551045510455105
2011,29163,105,1060,5,281,26,45,31,326,0.0255165936130244,0.0950920245398773
2011,29165,1018,3174,1020,2948,208,321,1228,3269,0.0550086660945362,0.375650045885592
2011,29167,138,914,5,93,3,22,8,115,0.00577947532415318,0.0695652173913043
2011,29169,295,1238,1026,3435,382,1156,1408,4591,0.170358825930461,0.306686996297103
2011,29171,0,85,2,46,0,0,2,46,0.012870733072188,0.0434782608695652
2011,29173,32,228,19,38,0,4,19,42,0.00580431177446103,0.452380952380952
2011,29175,41,1280,14,175,0,12,14,187,0.01089489629457,0.0748663101604278
2011,29177,40,435,31,62,0,0,31,62,0.00391809908998989,0.5
2011,29179,16,106,0,52,0,0,0,52,0.0111039931667734,0
2011,29181,15,173,6,166,0,0,6,166,0.0171967264062986,0.036144578313253
2011,29183,2554,7104,1859,3864,384,565,2243,4429,0.0190173169653017,0.50643486114247
2011,29185,22,300,30,112,0,5,30,117,0.016281658780963,0.256410256410256
2011,29186,84,415,0,38,0,0,0,38,0.00302764719942634,0
2011,29187,387,4006,165,418,0,120,165,538,0.0119760479041916,0.306691449814126
2011,29189,5709,19038,6751,12180,1818,2805,8569,14985,0.0221543783911649,0.571838505171839
2011,29195,95,442,99,253,0,27,99,280,0.0184855086815871,0.353571428571429
2011,29197,16,68,27,73,0,0,27,73,0.0255602240896359,0.36986301369863
2011,29199,1,51,0,60,0,0,0,60,0.0187149095446039,0
2011,29201,82,804,24,494,59,69,83,563,0.0215932190388525,0.147424511545293
2011,29203,4,108,77,176,0,15,77,191,0.0331424605240326,0.403141361256544
2011,29205,0,108,3,91,0,0,3,91,0.0207289293849658,0.032967032967033
2011,29207,57,713,13,288,0,13,13,301,0.0146052695424329,0.0431893687707641
2011,29209,192,892,78,1057,9,40,87,1097,0.0453755790866976,0.0793072014585232
2011,29211,24,192,23,120,6,12,29,132,0.0285776142022083,0.21969696969697
2011,29213,245,1238,245,1585,7,71,252,1656,0.0481185529565596,0.152173913043478
2011,29215,30,506,89,432,0,111,89,543,0.030662375063527,0.16390423572744
2011,29217,63,435,16,221,0,0,16,221,0.0160307558392572,0.0723981900452489
2011,29219,67,831,46,370,0,21,46,391,0.018095987411487,0.117647058823529
2011,29221,77,765,38,92,0,7,38,99,0.00584243139569194,0.383838383838384
2011,29223,32,322,18,67,0,0,18,67,0.00694948656778342,0.26865671641791
2011,29225,114,1445,32,325,0,0,32,325,0.0140056022408964,0.0984615384615385
2011,29227,8,57,0,3,0,0,0,3,0.00198412698412698,0
2011,29229,27,308,24,121,0,6,24,127,0.0102196829484188,0.188976377952756
2011,29510,3187,9827,3003,5682,716,1419,3719,7101,0.0336824430087941,0.523729052246163
2011,30001,27,148,55,210,0,0,55,210,0.0346363186541316,0.261904761904762
2011,30003,8,141,12,179,0,10,12,189,0.0262245039544887,0.0634920634920635
2011,30005,0,29,1,49,0,0,1,49,0.0123987854251012,0.0204081632653061
2011,30007,26,178,45,241,0,0,45,241,0.0666298037047277,0.186721991701245
2011,30009,54,225,49,159,0,8,49,167,0.0223860589812332,0.293413173652695
2011,30011,7,30,0,6,0,0,0,6,0.00621761658031088,0
2011,30013,133,1293,327,1748,47,136,374,1884,0.0349063420599188,0.198513800424628
2011,30015,13,99,5,44,18,20,23,64,0.016784683975872,0.359375
2011,30017,24,241,32,344,0,2,32,346,0.0430027342779021,0.092485549132948
2011,30019,0,4,0,20,0,0,0,20,0.0152091254752852,0
2011,30021,22,245,0,124,0,5,0,129,0.0204859456884231,0
2011,30023,76,332,28,103,0,8,28,111,0.0164590747330961,0.252252252252252
2011,30025,0,44,30,97,0,14,30,111,0.0553339980059821,0.27027027027027
2011,30027,106,275,52,169,11,22,63,191,0.0224679449476532,0.329842931937173
2011,30029,151,420,519,1438,6,56,525,1494,0.0241111631134709,0.35140562248996
2011,30031,540,1131,1360,2363,118,188,1478,2551,0.0458722195249141,0.57938063504508
2011,30033,9,10,0,1,0,0,0,1,0.00119617224880383,0
2011,30035,30,238,36,172,0,0,36,172,0.022051282051282,0.209302325581395
2011,30037,2,20,2,2,0,13,2,15,0.0249169435215947,0.133333333333333
2011,30039,30,154,21,50,0,0,21,50,0.0206782464846981,0.42
2011,30041,20,288,25,244,26,42,51,286,0.0285030894957146,0.178321678321678
2011,30043,60,416,61,192,0,10,61,202,0.0251525339310173,0.301980198019802
2011,30045,12,57,17,29,0,0,17,29,0.0182619647355164,0.586206896551724
2011,30047,130,507,178,692,0,17,178,709,0.0367414624034824,0.251057827926657
2011,30049,433,1113,421,1096,29,72,450,1168,0.0272362652737618,0.38527397260274
2011,30051,0,7,0,33,15,15,15,48,0.0295566502463054,0.3125
2011,30053,17,57,77,443,17,29,94,472,0.0322470451595272,0.199152542372881
2011,30055,0,20,0,0,0,0,0,0,0,NA
2011,30057,56,179,46,170,0,8,46,178,0.030416951469583,0.258426966292135
2011,30059,0,47,8,39,0,0,8,39,0.0293896006028636,0.205128205128205
2011,30061,0,52,15,19,0,0,15,19,0.00618892508143322,0.789473684210526
2011,30063,337,1712,1115,2298,57,248,1172,2546,0.0365678501666092,0.460329929300864
2011,30065,0,87,9,42,0,1,9,43,0.0130224106602059,0.209302325581395
2011,30067,22,91,75,407,42,49,117,456,0.0388085106382979,0.256578947368421
2011,30069,0,7,0,34,0,0,0,34,0.0833333333333333,0
2011,30071,2,4,21,29,0,2,21,31,0.0102819237147595,0.67741935483871
2011,30073,19,118,2,64,0,0,2,64,0.0152308424559733,0.03125
2011,30075,0,63,3,38,0,0,3,38,0.0317725752508361,0.0789473684210526
2011,30077,112,602,74,177,0,0,74,177,0.0327474560592044,0.418079096045198
2011,30079,14,34,5,5,0,0,5,5,0.00587544065804935,1
2011,30081,169,457,345,888,16,97,361,985,0.0343397015757914,0.366497461928934
2011,30083,47,151,51,272,0,0,51,272,0.0407673860911271,0.1875
2011,30085,22,97,12,129,0,0,12,129,0.0219238613188307,0.0930232558139535
2011,30087,91,179,42,125,0,8,42,133,0.0233415233415233,0.315789473684211
2011,30089,14,128,9,242,0,0,9,242,0.0286492245767728,0.0371900826446281
2011,30091,8,48,3,55,0,5,3,60,0.0234649980445835,0.05
2011,30093,103,788,122,482,44,54,166,536,0.023049797884235,0.309701492537313
2011,30095,45,168,38,107,0,12,38,119,0.0183133271775931,0.319327731092437
2011,30097,0,24,15,135,0,13,15,148,0.0537010159651669,0.101351351351351
2011,30099,27,158,10,44,9,9,19,53,0.0123456790123457,0.358490566037736
2011,30101,12,353,0,96,0,1,0,97,0.0255599472990777,0
2011,30103,0,2,32,40,0,0,32,40,0.0699300699300699,0.8
2011,30105,29,86,22,77,0,3,22,80,0.0152613506295307,0.275
2011,30107,2,40,0,8,0,0,0,8,0.00529100529100529,0
2011,30109,0,0,3,12,0,0,3,12,0.0170212765957447,0.25
2011,30111,524,2070,733,2590,57,222,790,2812,0.0285952531066322,0.280938833570412
2011,31001,100,538,160,526,0,29,160,555,0.0276918471210458,0.288288288288288
2011,31003,27,118,3,71,0,0,3,71,0.0151418212838558,0.0422535211267606
2011,31005,3,14,0,12,0,0,0,12,0.0410958904109589,0
2011,31007,0,22,0,10,0,6,0,16,0.0308285163776493,0
2011,31009,4,15,0,4,0,0,0,4,0.00938967136150235,0
2011,31011,29,91,7,38,0,2,7,40,0.0104356900600052,0.175
2011,31013,44,168,40,320,24,24,64,344,0.0451621373244059,0.186046511627907
2011,31015,15,27,0,11,0,0,0,11,0.00718015665796345,0
2011,31017,17,59,0,53,0,0,0,53,0.0237030411449016,0
2011,31019,306,841,207,559,12,69,219,628,0.0229826166514181,0.348726114649682
2011,31021,20,142,27,50,0,0,27,50,0.0100989699050697,0.54
2011,31023,37,229,26,82,0,16,26,98,0.0169140490162237,0.26530612244898
2011,31025,123,412,77,304,0,54,77,358,0.0207849512308407,0.215083798882682
2011,31027,34,181,0,99,6,20,6,119,0.0198069241011984,0.0504201680672269
2011,31029,7,16,48,89,0,32,48,121,0.042953496627618,0.396694214876033
2011,31031,24,64,26,43,0,15,26,58,0.014320987654321,0.448275862068966
2011,31033,120,277,16,211,0,26,16,237,0.0338910338910339,0.0675105485232067
2011,31035,27,84,18,90,0,0,18,90,0.0204545454545455,0.2
2011,31037,58,198,3,124,4,98,7,222,0.034434620753839,0.0315315315315315
2011,31039,31,61,19,58,0,10,19,68,0.0108366533864542,0.279411764705882
2011,31041,16,146,49,92,16,18,65,110,0.0143005720228809,0.590909090909091
2011,31043,11,147,32,405,19,125,51,530,0.0411938442406342,0.0962264150943396
2011,31045,29,152,12,112,0,0,12,112,0.0206565842862412,0.107142857142857
2011,31047,131,297,30,369,0,162,30,531,0.034493958685202,0.0564971751412429
2011,31049,13,32,0,27,6,10,6,37,0.0256410256410256,0.162162162162162
2011,31051,0,92,15,109,0,0,15,109,0.0268870251603355,0.137614678899083
2011,31053,177,782,155,362,0,37,155,399,0.0160900072586499,0.388471177944862
2011,31055,2025,5486,3395,8400,1033,1719,4428,10119,0.0310371163301424,0.437592647494812
2011,31057,0,7,0,15,0,0,0,15,0.0101626016260163,0
2011,31059,10,122,9,32,4,6,13,38,0.00904977375565611,0.342105263157895
2011,31061,18,89,5,62,0,9,5,71,0.0302513847464849,0.0704225352112676
2011,31063,12,61,4,15,0,5,4,20,0.0106666666666667,0.2
2011,31065,23,132,16,85,0,4,16,89,0.0252769099687589,0.179775280898876
2011,31067,123,552,34,352,0,17,34,369,0.0237085582112567,0.0921409214092141
2011,31069,4,10,4,111,0,2,4,113,0.0706691682301438,0.0353982300884956
2011,31071,1,54,12,20,0,11,12,31,0.0205026455026455,0.387096774193548
2011,31073,24,69,0,12,0,0,0,12,0.00805910006715917,0
2011,31075,2,13,0,14,0,0,0,14,0.0296610169491525,0
2011,31077,5,45,0,14,0,0,0,14,0.00810654313839027,0
2011,31079,184,1315,28,882,38,101,66,983,0.0265188302579044,0.0671414038657172
2011,31081,3,269,32,70,0,19,32,89,0.0142514011208967,0.359550561797753
2011,31083,8,66,32,65,0,5,32,70,0.0275157232704403,0.457142857142857
2011,31085,0,12,0,4,0,0,0,4,0.00574712643678161,0
2011,31087,5,52,0,44,0,0,0,44,0.0205896116050538,0
2011,31089,23,130,56,128,0,0,56,128,0.0174125969255884,0.4375
2011,31091,2,4,4,4,0,0,4,4,0.00735294117647059,1
2011,31093,14,215,5,22,0,9,5,31,0.00710194730813288,0.161290322580645
2011,31095,7,139,3,35,0,26,3,61,0.0111171860761801,0.0491803278688525
2011,31097,22,299,1,38,0,16,1,54,0.0138532580810672,0.0185185185185185
2011,31099,17,225,68,93,0,0,68,93,0.0203857957036388,0.731182795698925
2011,31101,57,182,23,270,0,1,23,271,0.0444845699277741,0.0848708487084871
2011,31103,0,5,0,0,0,0,0,0,0,NA
2011,31105,44,93,28,71,0,0,28,71,0.025884068538097,0.394366197183099
2011,31107,29,109,24,78,0,10,24,88,0.0143066168102748,0.272727272727273
2011,31109,832,3848,1737,4236,606,1052,2343,5288,0.0302860219241475,0.443078668683812
2011,31111,182,454,23,443,11,26,34,469,0.0192236750420134,0.0724946695095949
2011,31113,3,30,0,0,0,0,0,0,0,NA
2011,31115,0,7,0,3,0,0,0,3,0.00657894736842105,0
2011,31117,0,7,0,4,3,3,3,7,0.0226537216828479,0.428571428571429
2011,31119,118,586,173,463,38,60,211,523,0.0234729141420942,0.403441682600382
2011,31121,59,177,11,61,0,11,11,72,0.0135211267605634,0.152777777777778
2011,31123,2,27,50,86,0,0,50,86,0.0249564712710389,0.581395348837209
2011,31125,2,49,0,3,3,11,3,14,0.00535782625334864,0.214285714285714
2011,31127,84,157,46,155,0,0,46,155,0.0324267782426778,0.296774193548387
2011,31129,17,98,10,49,5,19,15,68,0.02025618111409,0.220588235294118
2011,31131,151,371,13,218,2,20,15,238,0.021866960676222,0.0630252100840336
2011,31133,12,70,0,9,0,3,0,12,0.00572519083969466,0
2011,31135,8,55,11,28,0,0,11,28,0.0135069946936807,0.392857142857143
2011,31137,10,117,38,109,8,25,46,134,0.0210890777463015,0.343283582089552
2011,31139,29,131,0,49,0,3,0,52,0.010566957935379,0
2011,31141,165,529,48,255,0,21,48,276,0.0133811693978474,0.173913043478261
2011,31143,19,156,3,31,0,3,3,34,0.00889586603872318,0.0882352941176471
2011,31145,78,265,14,161,0,0,14,161,0.0214666666666667,0.0869565217391304
2011,31147,58,77,18,218,0,0,18,218,0.0363333333333333,0.0825688073394495
2011,31149,0,8,5,67,3,3,8,70,0.0572363041700736,0.114285714285714
2011,31151,47,283,3,42,0,15,3,57,0.00645161290322581,0.0526315789473684
2011,31153,1262,4027,1271,3301,128,406,1399,3707,0.0382298950147474,0.377394119233882
2011,31155,35,382,31,155,2,15,33,170,0.0122021246052254,0.194117647058824
2011,31157,210,518,178,911,16,31,194,942,0.0386287213975232,0.205944798301486
2011,31159,87,421,60,187,23,49,83,236,0.0225384394995702,0.351694915254237
2011,31161,34,92,30,104,2,2,32,106,0.027082268778743,0.30188679245283
2011,31163,2,37,0,38,0,9,0,47,0.0203287197231834,0
2011,31165,4,12,5,18,0,0,5,18,0.018018018018018,0.277777777777778
2011,31167,16,136,2,10,0,10,2,20,0.00493096646942801,0.1
2011,31169,29,147,0,36,0,0,0,36,0.00938477580813347,0
2011,31171,2,12,3,3,0,0,3,3,0.00561797752808989,1
2011,31173,16,53,17,116,0,0,17,116,0.0304701864985553,0.146551724137931
2011,31175,18,35,0,9,0,0,0,9,0.00289482148600836,0
2011,31177,71,385,80,209,0,5,80,214,0.0159725332139125,0.373831775700935
2011,31179,77,139,115,149,0,13,115,162,0.0321556173084557,0.709876543209877
2011,31181,20,110,3,37,0,0,3,37,0.0135680234690136,0.0810810810810811
2011,31183,0,0,0,2,0,0,0,2,0.00397614314115308,0
2011,31185,35,364,34,92,1,1,35,93,0.0099422706863374,0.376344086021505
2011,32001,0,446,103,596,67,199,170,795,0.0483135824977211,0.213836477987421
2011,32003,369,2605,14365,53906,2547,8275,16912,62181,0.0490949788598115,0.271980186873804
2011,32005,132,688,430,1258,43,69,473,1327,0.038626109736574,0.356443104747551
2011,32007,31,406,147,1177,20,35,167,1212,0.0409459459459459,0.137788778877888
2011,32009,5,27,0,13,0,0,0,13,0.0168831168831169,0
2011,32011,0,28,0,9,0,7,0,16,0.0129659643435981,0
2011,32013,18,227,87,396,0,6,87,402,0.0384762633996937,0.216417910447761
2011,32015,0,60,14,157,0,0,14,157,0.0435023552230535,0.089171974522293
2011,32017,0,144,11,27,0,4,11,31,0.00993589743589744,0.354838709677419
2011,32019,145,1754,107,1040,10,47,117,1087,0.0311756101758109,0.107635694572217
2011,32021,0,118,25,104,0,0,25,104,0.0294200848656294,0.240384615384615
2011,32023,50,1062,234,1276,0,181,234,1457,0.0454673115930722,0.16060398078243
2011,32027,45,714,8,115,0,1,8,116,0.0228077074321667,0.0689655172413793
2011,32029,68,261,0,82,0,0,0,82,0.0257699560025141,0
2011,32031,858,3623,2819,10080,713,1492,3532,11572,0.0421385342548558,0.305219495333564
2011,32033,5,194,4,191,0,0,4,191,0.0282586181387779,0.0209424083769634
2011,32510,208,1761,208,1216,9,115,217,1331,0.0344524111510884,0.163035311795642
2011,33001,288,990,339,737,36,82,375,819,0.0189486835407894,0.457875457875458
2011,33003,218,575,374,1094,16,21,390,1115,0.0310662840266362,0.349775784753363
2011,33005,148,489,656,1563,66,143,722,1706,0.0332611959213117,0.423212192262603
2011,33007,72,458,152,537,3,8,155,545,0.0221203019725627,0.284403669724771
2011,33009,346,1097,1404,2325,469,567,1873,2892,0.0485846283074339,0.647648686030429
2011,33011,1018,4219,2909,6773,441,1136,3350,7909,0.0291822404905893,0.423568086989506
2011,33013,901,3159,993,2159,70,165,1063,2324,0.0229619310154035,0.457401032702238
2011,33015,974,3061,2626,5522,310,572,2936,6094,0.0297103074387901,0.481785362651789
2011,33017,700,2261,804,2197,125,241,929,2438,0.03118324955553,0.381050041017227
2011,33019,244,845,311,701,23,40,334,741,0.0236559826331248,0.450742240215924
2011,34001,867,3128,835,2646,267,1203,1102,3849,0.0208726491833149,0.286308131982333
2011,34003,4085,8356,5018,8871,2630,4403,7648,13274,0.0210748590934349,0.576163929486214
2011,34005,2085,6376,2286,5993,624,1376,2910,7369,0.0240670703428635,0.394897543764418
2011,34007,1925,7260,2174,5272,217,1224,2391,6496,0.0190434311009484,0.368072660098522
2011,34009,551,1318,787,1844,61,218,848,2062,0.0290124238459049,0.411251212415131
2011,34011,398,3798,200,1174,84,500,284,1674,0.0161480138135937,0.169653524492234
2011,34013,3284,8411,3395,7686,972,3361,4367,11047,0.0215389414781091,0.395310944147732
2011,34015,1250,4640,876,2110,150,583,1026,2693,0.0141826416684222,0.380987746008169
2011,34017,4558,8129,8032,11582,3355,5866,11387,17448,0.0401779546270966,0.652624942686841
2011,34019,1447,2962,931,1604,149,229,1080,1833,0.0206537538451137,0.589198036006547
2011,34021,2756,6460,2757,4914,1208,2293,3965,7207,0.0297354056384633,0.550159567087554
2011,34023,6333,12426,4480,7781,3966,5990,8446,13771,0.02558524078478,0.613317841841551
2011,34025,3620,8139,2350,5514,709,1506,3059,7020,0.0163929449622052,0.435754985754986
2011,34027,4361,8535,3064,5231,1285,2193,4349,7424,0.0219425544869332,0.585802801724138
2011,34029,2518,8870,1388,4489,404,1082,1792,5571,0.014038934038934,0.32166576916173
2011,34031,1601,5316,1193,2752,464,1708,1657,4460,0.0138107860381004,0.37152466367713
2011,34033,167,979,81,605,46,77,127,682,0.0152109911678116,0.186217008797654
2011,34035,4060,7071,1577,2751,970,1607,2547,4358,0.019836049904188,0.584442404772832
2011,34037,830,2390,564,1166,38,111,602,1277,0.0125472856791943,0.47141738449491
2011,34039,3172,8175,1624,3784,685,2105,2309,5889,0.0165157838056135,0.392086941755816
2011,34041,720,2123,264,928,54,167,318,1095,0.0147250648844183,0.29041095890411
2011,35001,1774,7741,5398,12886,861,1893,6259,14779,0.0343832808708539,0.423506326544421
2011,35003,17,64,8,216,0,0,8,216,0.0689875439156819,0.037037037037037
2011,35005,214,986,311,1425,16,193,327,1618,0.0403109273008122,0.202101359703337
2011,35006,87,619,45,384,0,96,45,480,0.0272882319499716,0.09375
2011,35007,52,328,78,303,21,23,99,326,0.0329226418905272,0.303680981595092
2011,35009,186,497,272,1040,59,166,331,1206,0.0419872575984403,0.274461028192372
2011,35011,0,15,11,22,0,0,11,22,0.014895057549086,0.5
2011,35013,311,2214,1497,4402,350,773,1847,5175,0.0419694413806527,0.356908212560386
2011,35015,203,609,176,1061,15,31,191,1092,0.0315780341806194,0.174908424908425
2011,35017,115,270,120,705,31,40,151,745,0.035824196960954,0.202684563758389
2011,35019,8,363,0,115,0,0,0,115,0.0356147414060081,0
2011,35021,0,6,7,19,0,0,7,19,0.0374015748031496,0.368421052631579
2011,35023,4,68,11,43,14,34,25,77,0.0241834170854271,0.324675324675325
2011,35025,78,1182,323,1171,51,147,374,1318,0.0341920253197395,0.283763277693475
2011,35027,151,378,130,612,0,13,130,625,0.0408603556485356,0.208
2011,35028,187,398,469,610,42,60,511,670,0.052499608211879,0.762686567164179
2011,35029,25,265,165,718,6,111,171,829,0.0513567092057985,0.20627261761158
2011,35031,17,314,153,871,54,56,207,927,0.0231807951987997,0.223300970873786
2011,35033,35,155,5,56,0,13,5,69,0.0187296416938111,0.072463768115942
2011,35035,227,713,370,1701,129,523,499,2224,0.0545552666437718,0.224370503597122
2011,35037,42,148,26,213,0,0,26,213,0.0334065244667503,0.122065727699531
2011,35039,69,725,79,290,35,54,114,344,0.0129153369626431,0.331395348837209
2011,35041,20,269,94,422,67,100,161,522,0.0474631751227496,0.308429118773946
2011,35043,890,2828,1218,3263,144,294,1362,3557,0.0424447812130831,0.382906944053978
2011,35045,269,881,327,1875,35,121,362,1996,0.025584495488105,0.181362725450902
2011,35047,86,389,168,379,0,34,168,413,0.0210864903502502,0.406779661016949
2011,35049,690,2473,2027,3674,205,580,2232,4254,0.04190678842687,0.524682651622003
2011,35051,0,104,24,77,0,0,24,77,0.00876993166287016,0.311688311688312
2011,35053,53,223,30,133,26,33,56,166,0.0148705545104363,0.337349397590361
2011,35055,124,544,211,666,1,68,212,734,0.0310267574079554,0.288828337874659
2011,35057,66,631,95,525,0,102,95,627,0.0568965517241379,0.151515151515152
2011,35059,3,146,8,182,0,1,8,183,0.060019678583142,0.0437158469945355
2011,35061,159,2153,151,942,71,131,222,1073,0.0220936457604085,0.206896551724138
2011,36001,2275,6237,1666,2852,638,1371,2304,4223,0.0209384885415944,0.545583708264267
2011,36003,89,647,119,330,11,32,130,362,0.011870798491556,0.359116022099448
2011,36005,3750,23087,1932,7184,1759,7694,3691,14878,0.0175569438314684,0.248084419948918
2011,36007,516,2128,649,1497,128,307,777,1804,0.0134759613948068,0.430709534368071
2011,36009,189,1175,157,510,36,99,193,609,0.011354102578444,0.316912972085386
2011,36011,204,2258,199,690,74,104,273,794,0.0142585209927091,0.343828715365239
2011,36013,233,1453,307,958,91,232,398,1190,0.0132348688747025,0.334453781512605
2011,36015,311,1698,499,1272,35,59,534,1331,0.0219723983095615,0.401202103681443
2011,36017,115,680,109,391,3,8,112,399,0.0113623419523864,0.280701754385965
2011,36019,137,2582,96,629,63,246,159,875,0.0157999277717588,0.181714285714286
2011,36021,422,1322,163,711,30,87,193,798,0.0176478393560087,0.241854636591479
2011,36023,129,605,135,253,29,56,164,309,0.0102172403531396,0.530744336569579
2011,36025,202,989,66,402,13,18,79,420,0.0124311845142959,0.188095238095238
2011,36027,1370,6096,1155,2483,235,509,1390,2992,0.0151112637501389,0.464572192513369
2011,36029,2182,6839,2726,5973,1156,2257,3882,8230,0.0132056095760727,0.471688942891859
2011,36031,322,1321,284,755,34,57,318,812,0.0282680591818973,0.391625615763547
2011,36033,275,2562,69,204,25,73,94,277,0.00772642325179214,0.339350180505415
2011,36035,254,1499,23,182,46,124,69,306,0.00792171481826654,0.225490196078431
2011,36037,272,1117,130,438,3,29,133,467,0.0113575563013765,0.284796573875803
2011,36039,162,1288,119,440,16,25,135,465,0.0132948307410796,0.290322580645161
2011,36041,0,68,2,18,0,0,2,18,0.00472689075630252,0.111111111111111
2011,36043,220,1022,89,370,4,34,93,404,0.00913138801618335,0.23019801980198
2011,36045,400,1750,1143,3329,390,1903,1533,5232,0.0727808922336445,0.293004587155963
2011,36047,13746,26579,9450,16486,4665,13595,14115,30081,0.0184410024019098,0.469233070709085
2011,36049,51,276,30,102,29,91,59,193,0.0106465136804943,0.305699481865285
2011,36051,399,2030,116,345,3,56,119,401,0.00947990543735225,0.296758104738155
2011,36053,260,1157,168,737,29,102,197,839,0.017783335806185,0.234803337306317
2011,36055,2115,6698,2506,5078,1312,2562,3818,7640,0.0155965793680119,0.499738219895288
2011,36057,169,1391,61,231,18,127,79,358,0.010485926012712,0.220670391061453
2011,36059,7328,15264,2540,5087,1585,4075,4125,9162,0.0100772567687664,0.450229207596595
2011,36061,15227,27689,27981,34524,14292,19185,42273,53709,0.0457833523141865,0.787074791934313
2011,36063,792,3146,316,1256,46,192,362,1448,0.00972464741437206,0.25
2011,36065,758,5259,392,1549,182,446,574,1995,0.0124982771798374,0.287719298245614
2011,36067,1794,5192,1694,3739,772,1595,2466,5334,0.0174388381954366,0.462317210348706
2011,36069,947,2475,401,803,81,152,482,955,0.0130814749876719,0.504712041884817
2011,36071,1732,4993,1507,3436,281,865,1788,4301,0.0183937048282941,0.415717275052313
2011,36073,84,1544,25,273,0,65,25,338,0.0115804981669922,0.0739644970414201
2011,36075,256,1512,253,820,47,138,300,958,0.0122196994821296,0.313152400835073
2011,36077,211,871,151,569,49,66,200,635,0.0158385712860421,0.31496062992126
2011,36079,837,2185,210,571,93,122,303,693,0.0101209253417455,0.437229437229437
2011,36081,11067,28579,6224,13167,5580,14718,11804,27885,0.0181000086329609,0.423310023310023
2011,36083,1248,3493,427,884,169,240,596,1124,0.0105340106089858,0.530249110320285
2011,36085,1772,5443,828,1983,281,716,1109,2699,0.00860801479851377,0.410892923304928
2011,36087,1217,2752,899,1634,496,1040,1395,2674,0.0137276040864521,0.521690351533283
2011,36089,282,1838,240,1052,22,185,262,1237,0.017527204715484,0.211802748585287
2011,36091,1314,4140,1440,2520,340,633,1780,3153,0.0208673898224319,0.564541706311449
2011,36093,876,2948,568,1211,163,316,731,1527,0.0146397584008437,0.47871643745907
2011,36095,51,662,30,214,0,4,30,218,0.0098061265800009,0.137614678899083
2011,36097,50,383,19,253,0,21,19,274,0.020988127154347,0.0693430656934307
2011,36099,159,1624,59,359,3,16,62,375,0.0153167503982355,0.165333333333333
2011,36101,298,1755,245,726,117,144,362,870,0.0128610708689353,0.416091954022988
2011,36103,5450,12603,2589,5852,1268,2686,3857,8538,0.00853991294049867,0.451745139376903
2011,36105,456,2102,215,930,28,198,243,1128,0.0211073894575326,0.215425531914894
2011,36107,231,587,85,416,0,25,85,441,0.0125053168864313,0.192743764172336
2011,36109,732,1699,1091,1611,825,1080,1916,2691,0.047213839567689,0.712002972872538
2011,36111,1258,4794,559,1336,49,261,608,1597,0.0125631303198603,0.380713838447088
2011,36113,185,1196,316,816,49,108,365,924,0.0196729688298416,0.395021645021645
2011,36115,211,2418,160,580,18,62,178,642,0.0144315065413838,0.277258566978193
2011,36117,589,2226,125,945,0,141,125,1086,0.0169706061600488,0.115101289134438
2011,36119,5968,11920,3730,5712,1876,4066,5606,9778,0.015277026963687,0.573327878911843
2011,36121,135,2035,27,186,17,46,44,232,0.00773771804022279,0.189655172413793
2011,36123,96,410,182,327,17,37,199,364,0.0221572924275627,0.546703296703297
2011,37001,732,2788,564,1773,149,342,713,2115,0.0214023335121078,0.337115839243499
2011,37003,113,796,55,434,0,54,55,488,0.0189957181782795,0.112704918032787
2011,37005,0,65,12,167,0,0,12,167,0.020699058006941,0.0718562874251497
2011,37007,49,920,13,322,0,0,13,322,0.0173819163292847,0.0403726708074534
2011,37009,91,323,28,164,0,89,28,253,0.0126569613287308,0.110671936758893
2011,37011,61,756,60,251,0,11,60,262,0.0201802356928291,0.229007633587786
2011,37013,135,637,265,688,10,82,275,770,0.0230463021160696,0.357142857142857
2011,37015,73,754,0,206,0,6,0,212,0.0143340094658553,0
2011,37017,82,460,0,472,0,18,0,490,0.0206986862670553,0
2011,37019,793,2054,715,2129,29,313,744,2442,0.0308930130175718,0.304668304668305
2011,37021,1365,4090,2700,5957,142,590,2842,6547,0.0391290835415197,0.434091950511685
2011,37023,113,1472,102,904,3,72,105,976,0.0157160799974236,0.107581967213115
2011,37025,835,3915,466,2469,26,242,492,2711,0.0238260548588102,0.181482847657691
2011,37027,166,1078,229,753,58,102,287,855,0.0149491205371193,0.335672514619883
2011,37029,50,177,21,173,19,20,40,193,0.030279259491685,0.207253886010363
2011,37031,363,1760,513,1267,105,258,618,1525,0.0315063115922567,0.405245901639344
2011,37033,62,917,44,263,0,40,44,303,0.0178046774003996,0.145214521452145
2011,37035,526,2923,583,1732,24,258,607,1990,0.0190399647904169,0.305025125628141
2011,37037,621,1425,423,834,46,68,469,902,0.0201034144601943,0.519955654101996
2011,37039,172,342,74,420,0,0,74,420,0.0205640423031727,0.176190476190476
2011,37041,35,246,5,256,13,33,18,289,0.0283583554116377,0.0622837370242214
2011,37043,11,140,31,189,0,0,31,189,0.0239270793771363,0.164021164021164
2011,37045,343,2120,303,1184,20,41,323,1225,0.0185831310679612,0.263673469387755
2011,37047,127,1291,62,406,0,30,62,436,0.0112252516670529,0.142201834862385
2011,37049,434,2018,689,2824,147,619,836,3443,0.0525215852579553,0.242811501597444
2011,37051,850,3666,2717,10060,1080,3872,3797,13932,0.073172268907563,0.272538041917887
2011,37053,11,172,119,525,0,15,119,540,0.0333931111248531,0.22037037037037
2011,37055,166,419,376,853,39,92,415,945,0.0381063752570668,0.439153439153439
2011,37057,619,3180,374,1241,29,105,403,1346,0.0121454932640336,0.299405646359584
2011,37059,148,619,204,681,12,36,216,717,0.0251094379268079,0.301255230125523
2011,37061,71,1621,57,505,0,145,57,650,0.017107964415434,0.0876923076923077
2011,37063,3028,7066,4023,7182,1173,1731,5196,8913,0.0515431723946496,0.58296869740828
2011,37065,117,1711,66,662,25,97,91,759,0.0203763859432468,0.119894598155468
2011,37067,1586,4825,1831,4424,400,663,2231,5087,0.022281792179691,0.438568901120503
2011,37069,108,1254,107,396,21,90,128,486,0.0120475954387705,0.263374485596708
2011,37071,447,3686,584,2197,152,422,736,2619,0.0189466830644578,0.28102329133257
2011,37073,0,94,11,181,0,0,11,181,0.0220947265625,0.0607734806629834
2011,37075,0,129,13,68,0,5,13,73,0.0121001160285099,0.178082191780822
2011,37077,286,1611,161,758,8,72,169,830,0.0207189216175736,0.203614457831325
2011,37079,64,1222,8,98,0,27,8,125,0.00854583988514391,0.064
2011,37081,1948,6448,2672,6921,647,1342,3319,8263,0.0263193099582102,0.401670095606922
2011,37083,187,1141,74,436,0,40,74,476,0.0127242107514235,0.15546218487395
2011,37085,544,2689,464,1991,152,665,616,2656,0.037964008519032,0.231927710843373
2011,37087,365,930,333,1207,12,62,345,1269,0.0294151735008461,0.271867612293144
2011,37089,486,1887,648,2158,16,166,664,2324,0.0301896596518576,0.285714285714286
2011,37091,51,494,134,952,0,49,134,1001,0.0600551955843533,0.133866133866134
2011,37093,395,1842,273,743,175,583,448,1326,0.0477287452307249,0.337858220211161
2011,37095,8,313,0,32,0,31,0,63,0.0156755411793979,0
2011,37097,502,2566,803,2997,90,252,893,3249,0.0309696975473982,0.274853801169591
2011,37099,142,757,184,473,23,64,207,537,0.0215161471271737,0.385474860335196
2011,37101,507,3487,314,1747,163,271,477,2018,0.0188181318015237,0.236372646184341
2011,37103,36,349,12,45,0,0,12,45,0.00628667225481978,0.266666666666667
2011,37105,71,1013,289,869,37,57,326,926,0.0247534015878532,0.352051835853132
2011,37107,34,911,98,567,0,92,98,659,0.0163677909691521,0.148710166919575
2011,37109,311,1464,417,1270,0,114,417,1384,0.0260601039391429,0.301300578034682
2011,37111,101,958,63,205,8,13,71,218,0.00687914168507416,0.325688073394495
2011,37113,91,363,178,742,48,126,226,868,0.0347366736033296,0.26036866359447
2011,37115,129,443,81,349,3,43,84,392,0.0270531400966184,0.214285714285714
2011,37117,87,516,7,135,0,29,7,164,0.00960918732056015,0.0426829268292683
2011,37119,4225,11257,10804,24735,2635,4694,13439,29429,0.0500068819148376,0.456658398178667
2011,37121,18,188,5,119,0,22,5,141,0.0123684210526316,0.0354609929078014
2011,37123,35,654,50,197,9,15,59,212,0.0112711999574672,0.278301886792453
2011,37125,370,1286,1000,1959,62,229,1062,2188,0.0349386816555953,0.485374771480804
2011,37127,380,2224,66,634,62,212,128,846,0.0131628080657207,0.151300236406619
2011,37129,1552,5419,1626,4458,206,348,1832,4806,0.0357568001904649,0.381190178942988
2011,37131,54,699,0,316,0,12,0,328,0.020997375328084,0
2011,37133,233,1562,1429,6390,382,1644,1811,8034,0.089891914874572,0.225416977844162
2011,37135,1527,3475,1715,2556,785,1241,2500,3797,0.0476578973792549,0.658414537792994
2011,37137,71,469,12,133,0,3,12,136,0.0137082955347243,0.0882352941176471
2011,37139,75,1002,147,779,0,48,147,827,0.0318015766198808,0.177750906892382
2011,37141,328,1995,208,718,0,47,208,765,0.0213490358049842,0.271895424836601
2011,37143,0,244,71,252,0,0,71,252,0.0265263157894737,0.281746031746032
2011,37145,129,644,77,435,23,40,100,475,0.0176134678137051,0.210526315789474
2011,37147,650,2786,972,2476,115,299,1087,2775,0.028674168449115,0.391711711711712
2011,37149,118,239,226,593,0,0,226,593,0.0387227373645031,0.381112984822934
2011,37151,528,3015,234,993,53,125,287,1118,0.0117440675651544,0.256708407871199
2011,37153,45,629,27,314,0,61,27,375,0.0122297231190686,0.072
2011,37155,186,1651,229,1255,39,109,268,1364,0.0165199171581867,0.196480938416422
2011,37157,276,1098,345,1026,9,293,354,1319,0.0201367897163445,0.268385140257771
2011,37159,334,2856,386,1471,35,104,421,1575,0.0170777988614801,0.267301587301587
2011,37161,228,914,156,1105,0,19,156,1124,0.0239164201970339,0.138790035587189
2011,37163,108,1501,103,664,33,108,136,772,0.0184221829809574,0.176165803108808
2011,37165,110,885,111,438,0,13,111,451,0.0190552644921413,0.246119733924612
2011,37167,449,1189,83,329,47,144,130,473,0.0115532107178623,0.274841437632135
2011,37169,124,999,30,238,22,55,52,293,0.00879219804951238,0.177474402730375
2011,37171,167,933,154,413,66,173,220,586,0.0114874931388693,0.37542662116041
2011,37173,33,88,172,400,0,11,172,411,0.0432495001578449,0.418491484184915
2011,37175,132,692,189,445,0,49,189,494,0.0204005781540368,0.382591093117409
2011,37177,3,409,0,44,0,0,0,44,0.0127351664254703,0
2011,37179,1313,3738,945,2741,49,399,994,3140,0.0255064740954949,0.31656050955414
2011,37181,112,771,35,140,0,58,35,198,0.00674777630099172,0.176767676767677
2011,37183,6429,14360,10087,19448,2134,4187,12221,23635,0.0417566225809073,0.517072138777237
2011,37185,110,363,5,272,47,123,52,395,0.0268214843484756,0.131645569620253
2011,37187,30,116,20,82,0,1,20,83,0.00916823152546117,0.240963855421687
2011,37189,393,902,310,678,125,204,435,882,0.0322923150148281,0.493197278911565
2011,37191,292,2454,312,1502,166,575,478,2077,0.0263334727980424,0.230139624458353
2011,37193,84,644,149,362,0,33,149,395,0.00812840827245601,0.377215189873418
2011,37195,300,1523,376,1221,1,26,377,1247,0.0233774511641858,0.302325581395349
2011,37197,107,741,29,173,0,29,29,202,0.0076882088756946,0.143564356435644
2011,37199,30,281,22,157,13,13,35,170,0.0130478164095479,0.205882352941176
2011,38001,7,43,3,29,0,0,3,29,0.0164305949008499,0.103448275862069
2011,38003,57,92,59,93,0,8,59,101,0.0129770011563664,0.584158415841584
2011,38005,2,44,1,15,0,3,1,18,0.0046972860125261,0.0555555555555556
2011,38007,2,2,23,39,0,0,23,39,0.0587349397590361,0.58974358974359
2011,38009,28,100,1,43,9,23,10,66,0.0141570141570142,0.151515151515152
2011,38011,13,41,8,21,0,0,8,21,0.009391771019678,0.380952380952381
2011,38013,2,21,3,48,0,0,3,48,0.032,0.0625
2011,38015,523,1733,234,1220,58,108,292,1328,0.0247941599297997,0.219879518072289
2011,38017,473,1406,1496,3486,144,457,1640,3943,0.0434610085422982,0.415926959168146
2011,38019,8,48,4,16,0,3,4,19,0.00624589086127548,0.210526315789474
2011,38021,28,121,26,76,0,16,26,92,0.0254565578306586,0.282608695652174
2011,38023,13,31,5,30,16,16,21,46,0.027495517035266,0.456521739130435
2011,38025,27,91,3,27,0,9,3,36,0.014405762304922,0.0833333333333333
2011,38027,10,37,2,15,0,16,2,31,0.0177956371986223,0.0645161290322581
2011,38029,34,76,17,58,0,10,17,68,0.0254205607476636,0.25
2011,38031,12,69,8,26,0,19,8,45,0.0183523654159869,0.177777777777778
2011,38033,0,8,11,36,0,2,11,38,0.0338379341050757,0.289473684210526
2011,38035,153,561,652,1478,154,370,806,1848,0.0483415297687559,0.436147186147186
2011,38037,11,38,6,38,0,0,6,38,0.0202020202020202,0.157894736842105
2011,38039,4,42,10,23,0,0,10,23,0.012221041445271,0.434782608695652
2011,38041,16,40,3,67,0,0,3,67,0.0357142857142857,0.0447761194029851
2011,38043,3,33,3,50,0,0,3,50,0.0269396551724138,0.06
2011,38045,11,42,4,50,0,0,4,50,0.0161917098445596,0.08
2011,38047,3,26,10,40,0,0,10,40,0.0268096514745308,0.25
2011,38049,28,115,19,67,0,2,19,69,0.0175438596491228,0.27536231884058
2011,38051,9,36,0,4,0,5,0,9,0.00399644760213144,0
2011,38053,39,81,20,183,0,2,20,185,0.045243335778919,0.108108108108108
2011,38055,25,165,27,121,2,2,29,123,0.0183281180151989,0.235772357723577
2011,38057,115,186,26,63,0,0,26,63,0.010322792069474,0.412698412698413
2011,38059,179,779,142,425,0,44,142,469,0.0253458711629918,0.302771855010661
2011,38061,8,165,9,130,0,5,9,135,0.0275904353157572,0.0666666666666667
2011,38063,5,33,17,56,0,0,17,56,0.0235294117647059,0.303571428571429
2011,38065,0,19,0,4,0,1,0,5,0.00383141762452107,0
2011,38067,18,133,12,59,3,11,15,70,0.0130087344359784,0.214285714285714
2011,38069,0,98,0,53,0,1,0,54,0.0172029308697037,0
2011,38071,86,201,9,88,0,23,9,111,0.0140862944162437,0.0810810810810811
2011,38073,9,114,5,72,10,10,15,82,0.0209504343382729,0.182926829268293
2011,38075,6,52,4,16,0,4,4,20,0.0115740740740741,0.2
2011,38077,106,263,11,253,2,28,13,281,0.026861676703948,0.0462633451957295
2011,38079,0,40,27,43,0,47,27,90,0.0114271203656679,0.3
2011,38081,33,74,2,18,0,0,2,18,0.00647249190938511,0.111111111111111
2011,38083,1,9,0,10,0,0,0,10,0.00974658869395711,0
2011,38085,0,38,16,39,0,18,16,57,0.0264746864839758,0.280701754385965
2011,38087,16,16,0,0,0,0,0,0,0,NA
2011,38089,82,410,156,518,3,9,159,527,0.0331488237514153,0.301707779886148
2011,38091,14,43,0,26,0,1,0,27,0.0193826274228284,0
2011,38093,36,506,108,436,0,41,108,477,0.0329328914664457,0.226415094339623
2011,38095,13,56,0,14,0,3,0,17,0.0103343465045593,0
2011,38097,74,178,26,105,12,14,38,119,0.0215112075198843,0.319327731092437
2011,38099,33,154,16,79,0,3,16,82,0.0103092783505155,0.195121951219512
2011,38101,161,663,510,1553,259,303,769,1856,0.0491421309044694,0.414331896551724
2011,38103,6,41,70,84,1,5,71,89,0.027588344699318,0.797752808988764
2011,38105,72,344,107,605,14,54,121,659,0.0442044539844379,0.18361153262519
2011,39001,23,441,102,200,0,20,102,220,0.011482254697286,0.463636363636364
2011,39003,180,1431,168,750,0,52,168,802,0.011555862943431,0.209476309226933
2011,39005,158,932,126,444,64,64,190,508,0.0145546228117927,0.374015748031496
2011,39007,129,1448,155,949,21,187,176,1136,0.0163352170599485,0.154929577464789
2011,39009,200,767,429,721,120,132,549,853,0.0254452167168809,0.643610785463071
2011,39011,126,1010,57,177,0,4,57,181,0.00587738667359397,0.314917127071823
2011,39013,65,1294,95,634,7,62,102,696,0.0137383786344525,0.146551724137931
2011,39015,15,694,12,104,8,18,20,122,0.0040518100298904,0.163934426229508
2011,39017,1872,6689,930,3124,202,604,1132,3728,0.0160067324454062,0.303648068669528
2011,39019,55,498,18,129,22,28,40,157,0.00774161735700197,0.254777070063694
2011,39021,152,1156,74,216,0,46,74,262,0.00981751414546408,0.282442748091603
2011,39023,294,1761,219,1066,8,120,227,1186,0.0127198627198627,0.191399662731872
2011,39025,1016,4000,837,1984,76,340,913,2324,0.0178539875698142,0.392857142857143
2011,39027,100,822,13,64,9,69,22,133,0.00481482822285776,0.165413533834586
2011,39029,96,1052,168,1360,0,85,168,1445,0.0189871754441291,0.116262975778547
2011,39031,69,426,30,135,6,15,36,150,0.00599328751797986,0.24
2011,39033,78,957,0,220,17,34,17,254,0.00833141994948667,0.0669291338582677
2011,39035,4069,11985,5307,10336,1524,3544,6831,13880,0.0158027704943603,0.492146974063401
2011,39037,122,798,8,436,0,13,8,449,0.0125890203555207,0.0178173719376392
2011,39039,77,422,121,411,0,1,121,412,0.0158351910216004,0.293689320388349
2011,39041,3089,5931,1129,1861,165,383,1294,2244,0.0202946523048539,0.576648841354724
2011,39043,221,1465,119,520,0,80,119,600,0.0110744015208845,0.198333333333333
2011,39045,933,4156,510,1299,112,188,622,1487,0.0155537425212334,0.418291862811029
2011,39047,138,712,0,146,25,41,25,187,0.00960304010681456,0.133689839572193
2011,39049,5016,16057,7370,14169,2368,4205,9738,18374,0.0247724518040045,0.529988026559269
2011,39051,196,765,13,337,0,36,13,373,0.0131019705644736,0.0348525469168901
2011,39053,29,263,38,264,0,11,38,275,0.013262599469496,0.138181818181818
2011,39055,282,1355,246,411,13,61,259,472,0.00752527024010714,0.548728813559322
2011,39057,1094,3093,1140,2329,357,694,1497,3023,0.0294685331045777,0.495203440291102
2011,39059,53,786,16,236,0,39,16,275,0.0100736290706619,0.0581818181818182
2011,39061,2642,8232,4707,9560,1247,2351,5954,11911,0.0225769703908274,0.499874065989422
2011,39063,349,1700,192,587,56,82,248,669,0.0135255347539525,0.370702541106129
2011,39065,90,403,18,127,0,0,18,127,0.00652352578590508,0.141732283464567
2011,39067,47,353,17,130,0,0,17,130,0.0115565828073607,0.130769230769231
2011,39069,43,517,10,68,0,2,10,70,0.00368227248816412,0.142857142857143
2011,39071,79,990,32,274,14,66,46,340,0.0117366840415617,0.135294117647059
2011,39073,104,861,8,81,0,0,8,81,0.00402064926039909,0.0987654320987654
2011,39075,34,282,33,101,0,44,33,145,0.00614980066163373,0.227586206896552
2011,39077,152,1390,29,527,11,35,40,562,0.0143038941206414,0.0711743772241993
2011,39079,50,760,18,138,0,14,18,152,0.00683238189418798,0.118421052631579
2011,39081,80,733,29,487,53,117,82,604,0.0123240155070394,0.135761589403974
2011,39083,121,1318,173,433,0,26,173,459,0.0118678250077567,0.376906318082789
2011,39085,873,3377,471,1047,183,532,654,1579,0.00979631847031015,0.41418619379354
2011,39087,29,582,209,1057,0,34,209,1091,0.0254016298020955,0.191567369385885
2011,39089,838,3833,266,1158,36,119,302,1277,0.0116480589608873,0.236491777603759
2011,39091,127,811,30,399,0,14,30,413,0.0134130102952161,0.0726392251815981
2011,39093,1272,5768,559,1884,75,368,634,2252,0.0110970399680689,0.281527531083481
2011,39095,1005,4282,1408,4524,194,468,1602,4992,0.0173327916835932,0.320913461538462
2011,39097,319,2347,19,253,10,48,29,301,0.0101665146755835,0.0963455149501661
2011,39099,638,3617,324,1796,53,207,377,2003,0.0119406010241614,0.188217673489765
2011,39101,198,2932,115,479,0,39,115,518,0.0113189406520409,0.222007722007722
2011,39103,1121,3845,465,1210,11,122,476,1332,0.0115101448273478,0.357357357357357
2011,39105,9,438,20,168,0,0,20,168,0.0102501525320317,0.119047619047619
2011,39107,114,586,50,161,0,31,50,192,0.00711638250555967,0.260416666666667
2011,39109,598,2032,384,1007,17,132,401,1139,0.0162940074102685,0.352063213345039
2011,39111,2,117,16,97,0,10,16,107,0.0101614434947768,0.149532710280374
2011,39113,2043,8219,1908,5440,924,1484,2832,6924,0.019137486422169,0.409012131715771
2011,39115,0,199,37,98,9,9,46,107,0.0102549357868507,0.429906542056075
2011,39117,164,847,5,171,0,0,5,171,0.00732961851693099,0.0292397660818713
2011,39119,150,1185,58,544,57,83,115,627,0.0109174487646045,0.18341307814992
2011,39121,18,1055,0,65,0,0,0,65,0.00620880695386379,0
2011,39123,210,935,117,336,8,52,125,388,0.0128989361702128,0.322164948453608
2011,39125,44,258,35,142,0,37,35,179,0.0134941575574821,0.195530726256983
2011,39127,30,796,23,145,0,7,23,152,0.00640782429071287,0.151315789473684
2011,39129,258,3325,78,445,5,21,83,466,0.0124522352563931,0.178111587982833
2011,39131,141,965,33,265,0,11,33,276,0.014520202020202,0.119565217391304
2011,39133,799,3130,424,937,203,285,627,1222,0.0120091198553402,0.513093289689034
2011,39135,128,837,50,359,21,90,71,449,0.0155756755819197,0.158129175946548
2011,39137,32,300,39,88,26,42,65,130,0.00576726853289561,0.5
2011,39139,308,3377,78,881,5,34,83,915,0.0105897875098375,0.0907103825136612
2011,39141,128,2169,112,514,0,3,112,517,0.00954120990661795,0.216634429400387
2011,39143,157,1184,29,620,0,49,29,669,0.0161006955307935,0.0433482810164425
2011,39145,31,1012,130,856,0,35,130,891,0.0166791463871209,0.145903479236813
2011,39147,246,1172,29,324,0,65,29,389,0.0103844100373732,0.0745501285347044
2011,39149,42,746,79,286,17,69,96,355,0.0110657398460148,0.270422535211268
2011,39151,1071,4507,623,2370,121,284,744,2654,0.0103451636165195,0.280331574981161
2011,39153,2398,6679,1363,2893,567,1151,1930,4044,0.0109709151381809,0.477250247279921
2011,39155,355,1956,232,1682,40,126,272,1808,0.0122659430122117,0.150442477876106
2011,39157,114,1163,73,334,7,65,80,399,0.00629436819687648,0.200501253132832
2011,39159,706,2550,34,252,180,238,214,490,0.0144897536741875,0.436734693877551
2011,39161,8,378,55,307,0,0,55,307,0.0157516675218061,0.179153094462541
2011,39163,15,398,0,62,0,0,0,62,0.00684175678658133,0
2011,39165,1835,6187,1526,2886,313,508,1839,3394,0.0245027614337797,0.541838538597525
2011,39167,35,433,68,1093,47,62,115,1155,0.026691008249948,0.0995670995670996
2011,39169,231,1603,188,529,28,80,216,609,0.00824320848955725,0.354679802955665
2011,39171,102,778,112,572,0,16,112,588,0.0226171243941842,0.19047619047619
2011,39173,901,2843,638,1169,348,407,986,1576,0.020454250486697,0.625634517766497
2011,39175,71,526,78,180,9,15,87,195,0.0125952719286914,0.446153846153846
2011,40001,49,193,52,198,0,7,52,205,0.0143950565269293,0.253658536585366
2011,40003,22,439,8,76,0,0,8,76,0.0176048181607598,0.105263157894737
2011,40005,88,795,0,160,3,11,3,171,0.0176488801733925,0.0175438596491228
2011,40007,15,76,15,160,1,6,16,166,0.0440552016985138,0.0963855421686747
2011,40009,124,360,107,617,0,22,107,639,0.0440902504657421,0.167449139280125
2011,40011,48,506,17,344,0,53,17,397,0.0521476421909891,0.0428211586901763
2011,40013,160,530,125,1068,0,83,125,1151,0.0423068440785121,0.108601216333623
2011,40015,54,884,51,552,0,65,51,617,0.0324122714856062,0.0826580226904376
2011,40017,1165,3612,403,1769,29,156,432,1925,0.0260547081195945,0.224415584415584
2011,40019,89,539,181,553,21,34,202,587,0.0186930768740845,0.34412265758092
2011,40021,130,574,204,534,21,34,225,568,0.0198712566470753,0.39612676056338
2011,40023,11,174,29,270,0,0,29,270,0.0265173836181497,0.107407407407407
2011,40025,3,31,0,60,0,0,0,60,0.0349243306169965,0
2011,40027,1719,7835,1238,3823,361,488,1599,4311,0.0276519865043425,0.370911621433542
2011,40029,20,155,10,66,0,0,10,66,0.0168668540761564,0.151515151515152
2011,40031,167,1777,1126,4714,225,1499,1351,6213,0.0835597277886865,0.217447287944632
2011,40033,10,103,21,147,0,31,21,178,0.0422101019682239,0.117977528089888
2011,40035,26,750,0,224,0,24,0,248,0.0238759988447097,0
2011,40037,258,1929,177,864,10,25,187,889,0.0190915923977236,0.210348706411699
2011,40039,97,608,99,413,0,26,99,439,0.0274083785977399,0.225512528473804
2011,40041,54,626,91,897,0,69,91,966,0.0334256055363322,0.0942028985507246
2011,40043,59,122,3,13,0,0,3,13,0.00391920410009044,0.230769230769231
2011,40045,14,95,2,25,4,9,6,34,0.0117484450587422,0.176470588235294
2011,40047,174,941,366,1079,93,189,459,1268,0.0321598863751649,0.36198738170347
2011,40049,63,504,0,179,0,4,0,183,0.00979447655748234,0
2011,40051,282,1729,76,646,24,93,100,739,0.0215936650790404,0.13531799729364
2011,40053,2,126,23,80,0,0,23,80,0.0247066090179123,0.2875
2011,40055,18,485,0,116,0,0,0,116,0.0255844728716365,0
2011,40057,0,91,10,58,0,0,10,58,0.0292486132123046,0.172413793103448
2011,40059,26,71,10,65,0,24,10,89,0.0353034510115034,0.112359550561798
2011,40061,42,206,23,175,0,19,23,194,0.0229585798816568,0.118556701030928
2011,40063,10,487,0,77,0,0,0,77,0.00806451612903226,0
2011,40065,19,471,173,502,32,72,205,574,0.0347604917337855,0.357142857142857
2011,40067,38,311,0,133,0,0,0,133,0.0302547770700637,0
2011,40069,82,368,3,133,0,0,3,133,0.0186431174656574,0.0225563909774436
2011,40071,113,716,140,701,27,153,167,854,0.0277822961059241,0.195550351288056
2011,40073,74,409,9,94,0,8,9,102,0.0103051121438674,0.0882352941176471
2011,40075,53,283,9,137,0,10,9,147,0.0226991970352069,0.0612244897959184
2011,40077,16,239,44,121,0,0,44,121,0.0168664622247003,0.363636363636364
2011,40079,31,1027,45,601,3,63,48,664,0.0200422577724117,0.072289156626506
2011,40081,109,765,39,366,0,4,39,370,0.0163391477147273,0.105405405405405
2011,40083,407,1428,107,465,60,79,167,544,0.020388276740874,0.306985294117647
2011,40085,14,160,23,134,7,30,30,164,0.0258797538267319,0.182926829268293
2011,40087,293,1513,57,361,3,3,60,364,0.016231160260412,0.164835164835165
2011,40089,69,364,38,286,3,9,41,295,0.0135850794381764,0.138983050847458
2011,40091,65,605,46,198,0,8,46,206,0.0143724272657504,0.223300970873786
2011,40093,41,139,0,109,0,5,0,114,0.021635984057696,0
2011,40095,17,328,38,284,0,0,38,284,0.0262404139332902,0.133802816901408
2011,40097,48,709,23,582,0,12,23,594,0.0218800648298217,0.0387205387205387
2011,40099,16,284,11,221,8,8,19,229,0.0251648351648352,0.0829694323144105
2011,40101,126,1818,160,828,7,85,167,913,0.0196949759475376,0.182913472070099
2011,40103,8,294,27,178,0,0,27,178,0.0227011860732049,0.151685393258427
2011,40105,50,210,27,112,0,85,27,197,0.027614241659658,0.137055837563452
2011,40107,55,646,26,128,0,0,26,128,0.0154477431812696,0.203125
2011,40109,2627,11668,4395,12446,886,2854,5281,15300,0.0333690287431653,0.34516339869281
2011,40111,104,897,30,243,0,43,30,286,0.0109331396460109,0.104895104895105
2011,40113,204,1816,55,462,10,46,65,508,0.0158423252042662,0.127952755905512
2011,40115,74,444,46,561,0,36,46,597,0.0283623925127084,0.0770519262981574
2011,40117,72,607,30,144,0,6,30,150,0.0132450331125828,0.2
2011,40119,394,1932,595,1421,240,345,835,1766,0.0429172033342244,0.47281993204983
2011,40121,56,1359,105,769,0,18,105,787,0.0245753185111167,0.133418043202033
2011,40123,97,696,66,203,14,38,80,241,0.01019587934171,0.33195020746888
2011,40125,237,1616,32,588,44,89,76,677,0.0150900499286733,0.112259970457903
2011,40127,10,271,18,152,6,8,24,160,0.0200300450676014,0.15
2011,40129,31,108,0,48,0,0,0,48,0.0193158953722334,0
2011,40131,567,2544,400,1307,36,42,436,1349,0.0240480604677695,0.323202372127502
2011,40133,58,579,31,190,10,10,41,200,0.0121477162293489,0.205
2011,40135,82,620,22,697,0,32,22,729,0.0262305699481865,0.0301783264746228
2011,40137,116,1136,123,542,0,175,123,717,0.0235267095419346,0.171548117154812
2011,40139,8,191,64,707,77,185,141,892,0.0738655183835707,0.158071748878924
2011,40141,21,290,25,225,0,15,25,240,0.0448681996634885,0.104166666666667
2011,40143,2180,9649,2934,9917,407,1370,3341,11287,0.0292082436237165,0.296004252680074
2011,40145,519,2428,336,1311,6,127,342,1438,0.0304693293781121,0.237830319888734
2011,40147,197,913,460,1164,33,101,493,1265,0.0366008911521324,0.389723320158103
2011,40149,18,325,29,75,11,41,40,116,0.0150904123845453,0.344827586206897
2011,40151,37,285,46,147,0,0,46,147,0.0262406283470189,0.312925170068027
2011,40153,66,576,92,433,0,44,92,477,0.0357812617208011,0.192872117400419
2011,41001,107,344,18,319,0,14,18,333,0.0282442748091603,0.0540540540540541
2011,41003,473,1564,1080,1800,376,528,1456,2328,0.0469052224371373,0.625429553264605
2011,41005,2795,9046,2084,4881,305,803,2389,5684,0.0222445728955906,0.420302603800141
2011,41007,284,851,379,987,8,49,387,1036,0.0398216482164822,0.373552123552124
2011,41009,190,1231,96,852,4,52,100,904,0.0268161727625997,0.110619469026549
2011,41011,134,1004,383,1438,44,84,427,1522,0.032952995431615,0.280551905387648
2011,41013,172,763,10,273,0,0,10,273,0.017843137254902,0.0366300366300366
2011,41015,0,132,135,853,45,45,180,898,0.0516240298936476,0.200445434298441
2011,41017,694,2932,1123,3231,62,196,1185,3427,0.0314265277675886,0.345783484096878
2011,41019,378,1912,493,1867,48,171,541,2038,0.0264335464792021,0.265456329735034
2011,41021,0,66,12,31,0,0,12,31,0.0212912087912088,0.387096774193548
2011,41023,6,134,38,101,0,12,38,113,0.0205941315837434,0.336283185840708
2011,41025,10,182,10,156,0,1,10,157,0.0302330059695744,0.0636942675159236
2011,41027,107,357,151,360,0,77,151,437,0.029657278588395,0.345537757437071
2011,41029,380,2901,1437,4651,85,425,1522,5076,0.0361595121742723,0.299842395587076
2011,41031,205,1122,42,333,0,86,42,419,0.0292638636681101,0.100238663484487
2011,41033,139,824,203,1565,17,102,220,1667,0.0279773093447905,0.131973605278944
2011,41035,149,806,365,1612,53,181,418,1793,0.03954391072295,0.233128834355828
2011,41037,7,291,85,299,0,0,85,299,0.0509456466178225,0.284280936454849
2011,41039,940,4320,2286,6126,676,1358,2962,7484,0.0319335045783873,0.395777659005879
2011,41041,206,884,312,871,2,38,314,909,0.0260869565217391,0.345434543454345
2011,41043,484,2381,213,952,28,213,241,1165,0.0149537268794845,0.2068669527897
2011,41045,58,773,69,664,0,35,69,699,0.034542399683732,0.0987124463519313
2011,41047,1163,5396,934,3373,226,999,1160,4372,0.0219078686930944,0.265324794144556
2011,41049,48,388,1,231,2,10,3,241,0.0338959212376934,0.012448132780083
2011,41051,5150,13708,9590,17814,2000,3918,11590,21732,0.0429959461304242,0.533314927296153
2011,41053,504,2077,433,1164,4,46,437,1210,0.0254345952536102,0.361157024793388
2011,41055,12,42,10,42,0,0,10,42,0.0310880829015544,0.238095238095238
2011,41057,97,791,30,259,1,23,31,282,0.015127132281944,0.109929078014184
2011,41059,196,1393,241,1489,12,122,253,1611,0.0333257483295753,0.157045313469894
2011,41061,76,452,37,321,4,14,41,335,0.0197418822558784,0.122388059701493
2011,41063,37,104,31,82,0,13,31,95,0.0181090354555852,0.326315789473684
2011,41065,105,529,214,679,24,107,238,786,0.0457242582897033,0.302798982188295
2011,41067,3962,10585,6082,12544,1443,2508,7525,15052,0.0435017586247757,0.499933563646027
2011,41069,8,60,0,6,0,0,0,6,0.00606673407482305,0
2011,41071,493,2390,495,1682,10,112,505,1794,0.0283300434267667,0.28149386845039
2011,42001,164,1367,442,1396,1,60,443,1456,0.0212291317343442,0.304258241758242
2011,42003,3781,9232,7398,13524,2789,3857,10187,17381,0.0202521232628511,0.586099764110235
2011,42005,174,992,24,294,61,134,85,428,0.00857165745413763,0.198598130841121
2011,42007,634,2330,322,1429,26,191,348,1620,0.0132370244476402,0.214814814814815
2011,42009,143,379,120,447,0,25,120,472,0.0132841743829332,0.254237288135593
2011,42011,1143,4981,674,3104,247,1006,921,4110,0.0151695221785058,0.224087591240876
2011,42013,414,1663,203,1115,0,99,203,1214,0.0137244926798937,0.167215815485997
2011,42015,44,609,126,834,8,39,134,873,0.0200505282498852,0.153493699885452
2011,42017,2429,6766,3257,6581,195,629,3452,7210,0.0166814354826395,0.47877947295423
2011,42019,1370,3189,767,1855,224,342,991,2197,0.01754624157429,0.451069640418753
2011,42021,331,1810,459,1307,28,119,487,1426,0.0139373503396374,0.341514726507714
2011,42023,11,39,0,3,0,0,0,3,0.000789889415481833,0
2011,42025,186,1122,62,517,0,29,62,546,0.0116999164291684,0.113553113553114
2011,42027,822,2722,1488,2197,587,782,2075,2979,0.0357760484219628,0.696542463914065
2011,42029,3849,7258,3893,6578,867,1660,4760,8238,0.025111719412048,0.577810148094198
2011,42031,53,538,89,294,18,23,107,317,0.0122431639116329,0.337539432176656
2011,42033,192,2154,117,483,3,73,120,556,0.00952593074853941,0.215827338129496
2011,42035,231,880,30,142,14,52,44,194,0.00770728218982162,0.22680412371134
2011,42037,217,769,72,440,46,133,118,573,0.013140694874441,0.205933682373473
2011,42039,227,1269,322,905,24,100,346,1005,0.0166600358066441,0.344278606965174
2011,42041,1448,5995,1213,2606,603,861,1816,3467,0.0217098630531569,0.523795788866455
2011,42043,1411,5607,1269,2825,274,694,1543,3519,0.0193314472491554,0.438476840011367
2011,42045,2815,8548,2532,4964,596,1296,3128,6260,0.0169740616814625,0.499680511182109
2011,42047,11,173,65,161,1,4,66,165,0.00703504732668202,0.4
2011,42049,394,2038,1081,2631,110,433,1191,3064,0.0166961828733346,0.388707571801567
2011,42051,295,1948,132,789,20,202,152,991,0.0100013119783624,0.153380423814329
2011,42053,63,750,0,59,9,83,9,142,0.0251416430594901,0.0633802816901408
2011,42055,278,1636,496,1998,81,182,577,2180,0.0216079057181655,0.264678899082569
2011,42057,11,183,23,105,3,8,26,113,0.0109358366398916,0.230088495575221
2011,42059,121,1033,106,510,0,16,106,526,0.0192118046678111,0.201520912547529
2011,42061,99,1614,77,349,30,86,107,435,0.013550135501355,0.245977011494253
2011,42063,289,1149,323,704,80,101,403,805,0.0143981398676444,0.500621118012422
2011,42065,54,501,47,220,0,9,47,229,0.00721600756262801,0.205240174672489
2011,42067,25,288,0,98,0,44,0,142,0.00848774656306037,0
2011,42069,649,2578,584,1763,202,411,786,2174,0.0145898206807688,0.361545538178473
2011,42071,1329,4784,1676,3533,323,1216,1999,4749,0.014091862683715,0.420930722257317
2011,42073,237,785,71,396,14,69,85,465,0.00724028400597907,0.182795698924731
2011,42075,464,1991,227,788,61,274,288,1062,0.0116916573089372,0.271186440677966
2011,42077,1968,6399,1616,4678,416,1564,2032,6242,0.0266214020377613,0.325536686959308
2011,42079,725,3562,557,2649,101,466,658,3115,0.0137971661550863,0.21123595505618
2011,42081,333,1645,272,1062,55,145,327,1207,0.0152187618207036,0.270919635459818
2011,42083,60,466,104,747,6,53,110,800,0.0263478575898297,0.1375
2011,42085,200,1565,316,1365,14,92,330,1457,0.0181388110799875,0.226492793411119
2011,42087,26,408,43,206,0,107,43,313,0.00967961405244928,0.137380191693291
2011,42089,327,1913,881,2921,31,207,912,3128,0.028195675100731,0.29156010230179
2011,42091,6515,15383,4883,7769,1429,2421,6312,10190,0.0185129672525776,0.619430814524043
2011,42093,137,388,111,209,11,45,122,254,0.0196336090283682,0.480314960629921
2011,42095,1600,5045,1556,4334,348,585,1904,4919,0.0243560669828978,0.387070542793251
2011,42097,401,2350,58,292,9,108,67,400,0.00591654710311062,0.1675
2011,42099,179,873,14,227,11,44,25,271,0.00857079604035548,0.0922509225092251
2011,42101,4536,10433,9282,15670,2963,6610,12245,22280,0.0228925826182826,0.5495960502693
2011,42103,93,561,206,1264,10,24,216,1288,0.0324694968236362,0.167701863354037
2011,42105,50,174,28,267,0,2,28,269,0.0218894946700301,0.104089219330855
2011,42107,358,2740,193,1468,47,363,240,1831,0.017030023438372,0.131075914800655
2011,42109,177,671,41,309,3,11,44,320,0.012504884720594,0.1375
2011,42111,209,1424,77,375,4,41,81,416,0.00732059268644634,0.194711538461538
2011,42113,8,96,0,18,0,4,0,22,0.00454357703428335,0
2011,42115,55,435,70,481,22,31,92,512,0.0165926694105065,0.1796875
2011,42117,43,454,142,544,8,19,150,563,0.0197398408190456,0.266429840142096
2011,42119,165,906,315,1534,37,170,352,1704,0.0560563194947036,0.206572769953052
2011,42121,275,1032,109,428,0,16,109,444,0.0113779053378777,0.245495495495495
2011,42123,32,384,81,389,0,17,81,406,0.0134937516617921,0.199507389162562
2011,42125,759,2461,699,2069,59,179,758,2248,0.0153816678982949,0.337188612099644
2011,42127,146,1547,237,1074,24,46,261,1120,0.0290125375608745,0.233035714285714
2011,42129,1220,5046,707,1939,120,335,827,2274,0.00859767855117396,0.363676341248901
2011,42131,61,454,44,167,0,0,44,167,0.00852040816326531,0.263473053892216
2011,42133,1232,4667,1862,5974,279,861,2141,6835,0.0232088285229202,0.313240673006584
2011,44001,395,718,435,812,102,136,537,948,0.0280664357402967,0.566455696202532
2011,44003,763,3107,697,1509,78,309,775,1818,0.0152224334123203,0.426292629262926
2011,44005,263,641,2110,2939,389,586,2499,3525,0.0599408243776357,0.708936170212766
2011,44007,951,3147,3601,6693,862,2395,4463,9088,0.022031301514652,0.491087147887324
2011,44009,908,1579,584,1568,19,162,603,1730,0.0205783344633575,0.348554913294798
2011,45001,64,527,11,89,11,13,22,102,0.00595864002804066,0.215686274509804
2011,45003,198,1126,913,2994,86,293,999,3287,0.0305702035843494,0.303924551262549
2011,45005,49,339,0,110,0,0,0,110,0.0152587043972812,0
2011,45007,588,2405,778,2595,44,448,822,3043,0.0242613174301979,0.270128162997042
2011,45009,0,149,138,214,0,3,138,217,0.0209459459459459,0.63594470046083
2011,45011,3,182,0,222,0,6,0,228,0.0154022833209485,0
2011,45013,466,1153,2672,6367,130,922,2802,7289,0.0668427375351913,0.384414871724516
2011,45015,1106,4553,1145,3615,288,774,1433,4389,0.039257602862254,0.326498063340169
2011,45017,41,171,5,90,0,10,5,100,0.0094197437829691,0.05
2011,45019,1683,5809,4871,9095,383,949,5254,10044,0.0433328875217333,0.523098367184389
2011,45021,40,581,93,401,0,42,93,443,0.0121890821043363,0.209932279909707
2011,45023,12,383,68,325,2,10,70,335,0.015016361109866,0.208955223880597
2011,45025,44,341,29,670,23,76,52,746,0.024234155215541,0.0697050938337802
2011,45027,110,609,58,408,0,55,58,463,0.0198712446351931,0.125269978401728
2011,45029,128,698,61,207,0,0,61,207,0.00801021592755979,0.294685990338164
2011,45031,169,998,112,599,74,95,186,694,0.0151578027738342,0.268011527377522
2011,45033,0,282,16,274,0,18,16,292,0.0143566547027877,0.0547945205479452
2011,45035,714,3790,988,3266,39,192,1027,3458,0.040128112887878,0.296992481203008
2011,45037,195,814,55,506,74,214,129,720,0.0384081937479996,0.179166666666667
2011,45039,146,412,16,91,0,10,16,101,0.00614654333008763,0.158415841584158
2011,45041,353,2195,527,1825,23,68,550,1893,0.0212003449395796,0.2905441098785
2011,45043,211,1028,395,882,105,180,500,1062,0.0247823956315777,0.470809792843691
2011,45045,1861,6948,3709,9543,702,1505,4411,11048,0.0374034275190098,0.399257784214337
2011,45047,247,1236,191,692,0,168,191,860,0.0189615257413736,0.222093023255814
2011,45049,5,159,21,478,0,0,21,478,0.0339271772304635,0.0439330543933054
2011,45051,375,2048,1824,8132,162,665,1986,8797,0.0472586034617988,0.225758781402751
2011,45053,49,1073,21,366,0,173,21,539,0.0349977274202974,0.038961038961039
2011,45055,260,1070,124,560,53,133,177,693,0.0168527029984679,0.255411255411255
2011,45057,95,659,325,1383,55,82,380,1465,0.028678816827516,0.25938566552901
2011,45059,227,1276,197,707,0,55,197,762,0.017022227186418,0.258530183727034
2011,45061,21,361,0,58,0,12,0,70,0.00540498803181222,0
2011,45063,1768,5739,945,3389,196,421,1141,3810,0.0221424088151196,0.299475065616798
2011,45065,3,288,127,165,9,9,136,174,0.0218812877263581,0.781609195402299
2011,45067,43,552,63,311,0,40,63,351,0.0157236930520091,0.179487179487179
2011,45069,31,619,130,766,0,27,130,793,0.0394370399840859,0.163934426229508
2011,45071,184,965,91,364,13,79,104,443,0.0176164154769953,0.234762979683973
2011,45073,253,1223,571,1355,0,58,571,1413,0.0271830091764299,0.40410474168436
2011,45075,100,756,146,599,72,91,218,690,0.0116097117762859,0.315942028985507
2011,45077,525,1896,721,1538,205,300,926,1838,0.0254183377126262,0.503808487486398
2011,45079,2434,9650,3378,8838,741,1576,4119,10414,0.0443352689746777,0.395525254465143
2011,45081,59,312,66,269,0,47,66,316,0.0237023702370237,0.208860759493671
2011,45083,745,3632,1155,3600,189,569,1344,4169,0.0224666422366407,0.322379467498201
2011,45085,70,781,439,1370,85,204,524,1574,0.0231719345768251,0.332909783989835
2011,45087,45,365,78,412,0,14,78,426,0.0212288832411422,0.183098591549296
2011,45089,29,387,0,402,0,45,0,447,0.0190642726148335,0
2011,45091,258,1314,2207,6274,83,229,2290,6503,0.0449384627079173,0.352145163770567
2011,46003,19,99,2,10,0,5,2,15,0.00807319698600646,0.133333333333333
2011,46005,17,156,68,392,21,38,89,430,0.0369733447979364,0.206976744186047
2011,46007,1,35,0,33,0,0,0,33,0.0176093916755603,0
2011,46009,20,281,15,94,4,4,19,98,0.0191107644305772,0.193877551020408
2011,46011,287,593,131,459,22,29,153,488,0.0297361525805862,0.313524590163934
2011,46013,90,275,226,459,27,36,253,495,0.0206749644975357,0.511111111111111
2011,46015,14,38,6,40,0,14,6,54,0.0149584487534626,0.111111111111111
2011,46017,0,28,20,26,0,0,20,26,0.0267489711934156,0.769230769230769
2011,46019,34,228,20,151,0,0,20,151,0.0222320376914016,0.132450331125828
2011,46021,0,21,9,24,0,0,9,24,0.0223671947809879,0.375
2011,46023,52,236,41,114,3,10,44,124,0.0217467555243774,0.354838709677419
2011,46025,1,57,48,95,0,0,48,95,0.036384527001149,0.505263157894737
2011,46027,17,133,189,407,0,70,189,477,0.0690503763752171,0.39622641509434
2011,46029,48,460,130,278,0,13,130,291,0.0162624343355315,0.446735395189003
2011,46031,0,54,3,92,0,0,3,92,0.0405107881990313,0.0326086956521739
2011,46033,1,43,47,237,5,5,52,242,0.0391712528326319,0.214876033057851
2011,46035,134,643,60,166,0,51,60,217,0.0170262848175755,0.276497695852535
2011,46037,26,147,9,147,0,9,9,156,0.0378181818181818,0.0576923076923077
2011,46039,7,40,21,87,0,8,21,95,0.0310762185148839,0.221052631578947
2011,46041,13,84,4,8,0,0,4,8,0.00271831464492015,0.5
2011,46043,3,79,10,17,0,1,10,18,0.00840728631480617,0.555555555555556
2011,46045,20,87,8,38,0,2,8,40,0.0136612021857923,0.2
2011,46047,28,117,15,349,0,9,15,358,0.0690719660428323,0.0418994413407821
2011,46049,21,55,3,14,0,3,3,17,0.0101918465227818,0.176470588235294
2011,46051,0,98,4,49,0,0,4,49,0.00948509485094851,0.0816326530612245
2011,46053,22,63,41,88,0,0,41,88,0.0282958199356913,0.465909090909091
2011,46055,0,13,0,0,4,9,4,9,0.00668647845468053,0.444444444444444
2011,46057,19,85,3,79,9,27,12,106,0.0287574606619642,0.113207547169811
2011,46059,12,61,14,24,0,0,14,24,0.00952759031361651,0.583333333333333
2011,46061,4,50,0,29,0,0,0,29,0.0139423076923077,0
2011,46063,3,9,15,18,0,0,15,18,0.0200445434298441,0.833333333333333
2011,46065,179,532,77,194,65,82,142,276,0.0234096692111959,0.514492753623188
2011,46067,53,199,39,108,0,0,39,108,0.0205792682926829,0.361111111111111
2011,46069,0,11,7,15,0,0,7,15,0.014792899408284,0.466666666666667
2011,46071,32,71,4,5,0,0,4,5,0.00298507462686567,0.8
2011,46073,14,62,0,9,0,0,0,9,0.00599201065246338,0
2011,46075,0,11,0,9,0,0,0,9,0.0111940298507463,0
2011,46077,13,57,24,69,0,3,24,72,0.01899235030335,0.333333333333333
2011,46079,89,148,62,165,0,0,62,165,0.0226523887973641,0.375757575757576
2011,46081,90,302,315,497,0,17,315,514,0.0323494241299012,0.61284046692607
2011,46083,647,1858,273,597,17,42,290,639,0.0232481990831696,0.453834115805947
2011,46085,10,44,36,50,0,0,36,50,0.0216262975778547,0.72
2011,46087,7,170,9,59,0,23,9,82,0.0211995863495346,0.109756097560976
2011,46089,0,29,4,36,3,3,7,39,0.0221339387060159,0.179487179487179
2011,46091,19,68,0,51,0,11,0,62,0.0204148831083306,0
2011,46093,77,632,70,556,21,79,91,635,0.038849801162435,0.143307086614173
2011,46095,0,10,0,6,0,0,0,6,0.00508905852417303,0
2011,46097,11,76,2,4,0,3,2,7,0.00396600566572238,0.285714285714286
2011,46099,636,2486,743,2535,40,187,783,2722,0.0249059849392905,0.28765613519471
2011,46101,14,112,18,51,0,6,18,57,0.0130614115490376,0.315789473684211
2011,46103,377,1676,834,2352,152,477,986,2829,0.043292626939675,0.348533050547897
2011,46105,0,34,15,67,0,2,15,69,0.0318853974121996,0.217391304347826
2011,46107,6,9,6,20,0,4,6,24,0.0135135135135135,0.25
2011,46109,4,36,26,124,0,0,26,124,0.0190769230769231,0.209677419354839
2011,46111,18,50,8,46,0,0,8,46,0.0281001832620648,0.173913043478261
2011,46113,0,41,36,75,0,0,36,75,0.0119142176330421,0.48
2011,46115,22,119,17,50,13,17,30,67,0.0149687220732797,0.447761194029851
2011,46117,55,203,31,31,0,0,31,31,0.0150485436893204,1
2011,46119,16,36,10,21,0,0,10,21,0.0214067278287462,0.476190476190476
2011,46121,0,118,63,99,0,0,63,99,0.0219172016825327,0.636363636363636
2011,46123,9,66,79,83,0,0,79,83,0.0206930939915233,0.951807228915663
2011,46125,48,146,11,80,0,6,11,86,0.0147058823529412,0.127906976744186
2011,46127,21,139,150,430,0,0,150,430,0.0442023026315789,0.348837209302326
2011,46129,30,135,60,79,10,11,70,90,0.0230769230769231,0.777777777777778
2011,46135,114,476,46,703,0,2,46,705,0.0452764754993257,0.0652482269503546
2011,46137,14,74,0,41,0,0,0,41,0.0287719298245614,0
2011,47001,328,1895,251,846,87,179,338,1025,0.0195909785932722,0.329756097560976
2011,47003,120,762,45,332,11,33,56,365,0.0125927203726065,0.153424657534247
2011,47005,15,298,109,282,0,20,109,302,0.0251122567769832,0.360927152317881
2011,47007,5,394,0,96,0,0,0,96,0.0104689203925845,0
2011,47009,489,2251,561,2180,82,216,643,2396,0.0281190954007206,0.268363939899833
2011,47011,172,747,304,1507,46,102,350,1609,0.0245768925276471,0.217526413921691
2011,47013,26,312,48,490,0,25,48,515,0.0180240086795226,0.0932038834951456
2011,47015,6,301,25,86,10,10,35,96,0.0101095197978096,0.364583333333333
2011,47017,87,648,16,337,0,0,16,337,0.0172493217996622,0.0474777448071217
2011,47019,149,1153,84,595,29,39,113,634,0.0156829763023797,0.178233438485804
2011,47021,175,991,116,367,0,0,116,367,0.0139655238022756,0.316076294277929
2011,47023,106,552,8,181,2,44,10,225,0.020670647680294,0.0444444444444444
2011,47025,49,192,126,557,12,24,138,581,0.0260725183988512,0.237521514629948
2011,47027,10,120,0,64,0,0,0,64,0.0111634397348683,0
2011,47029,62,474,36,500,13,42,49,542,0.0214509043416314,0.0904059040590406
2011,47031,183,856,61,416,56,56,117,472,0.0132666254426893,0.247881355932203
2011,47033,68,348,50,84,0,16,50,100,0.0101708706265256,0.5
2011,47035,118,578,319,1230,0,37,319,1267,0.0305684230843467,0.251775848460931
2011,47037,3500,11294,6034,12474,1022,2468,7056,14942,0.0361858356501439,0.472225940302503
2011,47039,16,225,3,170,0,0,3,170,0.0204106135190299,0.0176470588235294
2011,47041,156,670,70,192,0,21,70,213,0.0165231556900163,0.328638497652582
2011,47043,174,1100,186,677,0,81,186,758,0.0231027125876257,0.245382585751979
2011,47045,133,623,62,460,0,1,62,461,0.018036699401385,0.134490238611714
2011,47047,158,766,68,295,19,63,87,358,0.0135647165807821,0.243016759776536
2011,47049,75,268,29,121,5,5,34,126,0.0101083032490975,0.26984126984127
2011,47051,163,685,185,427,28,119,213,546,0.0197454072038189,0.39010989010989
2011,47053,238,1244,74,504,8,44,82,548,0.0164391780410979,0.14963503649635
2011,47055,5,279,102,473,0,0,102,473,0.0233303738778731,0.215644820295983
2011,47057,28,592,42,241,0,0,42,241,0.0151820587123598,0.174273858921162
2011,47059,107,796,146,883,10,62,156,945,0.0194821259225663,0.165079365079365
2011,47061,10,146,24,51,0,1,24,52,0.00543364681295716,0.461538461538462
2011,47063,240,1307,95,796,0,128,95,924,0.0216657287563309,0.102813852813853
2011,47065,658,2783,2131,6287,346,673,2477,6960,0.0306319152869101,0.355890804597701
2011,47067,16,153,0,82,0,0,0,82,0.016935150764147,0
2011,47069,95,1146,42,220,0,20,42,240,0.0126103404791929,0.175
2011,47071,0,336,21,292,0,7,21,299,0.01632096069869,0.0702341137123746
2011,47073,212,1647,343,1142,17,48,360,1190,0.0297225066813198,0.302521008403361
2011,47075,63,312,0,107,0,10,0,117,0.00941953143869254,0
2011,47077,101,554,14,260,16,37,30,297,0.0157668418537984,0.101010101010101
2011,47079,27,298,97,438,61,64,158,502,0.022085349758029,0.314741035856574
2011,47081,90,1113,49,188,0,0,49,188,0.0110816386678456,0.26063829787234
2011,47083,23,122,6,68,0,0,6,68,0.0118964310706788,0.0882352941176471
2011,47085,78,386,14,212,0,23,14,235,0.0183293034864675,0.0595744680851064
2011,47087,0,210,15,153,0,5,15,158,0.0190798212776235,0.0949367088607595
2011,47089,166,1156,138,642,10,24,148,666,0.0192202245245447,0.222222222222222
2011,47091,73,379,52,329,0,0,52,329,0.0242732772613251,0.158054711246201
2011,47093,1563,5056,3012,6456,444,822,3456,7278,0.025645995059675,0.474855729596043
2011,47095,9,641,0,61,15,15,15,76,0.0131807145334721,0.197368421052632
2011,47097,79,989,52,322,44,87,96,409,0.022235511579863,0.234718826405868
2011,47099,47,318,57,445,0,37,57,482,0.0173975816639596,0.118257261410788
2011,47101,0,365,0,109,12,60,12,169,0.0205296404275996,0.0710059171597633
2011,47103,27,204,85,575,0,44,85,619,0.0272915656276178,0.137318255250404
2011,47105,210,1187,176,798,15,62,191,860,0.0246821456246592,0.222093023255814
2011,47107,226,1103,30,299,0,111,30,410,0.011337554959489,0.0731707317073171
2011,47109,6,101,68,418,0,58,68,476,0.0266427851785514,0.142857142857143
2011,47111,32,214,0,78,0,120,0,198,0.0136551724137931,0
2011,47113,394,1346,437,1102,90,197,527,1299,0.0205915921628305,0.405696689761355
2011,47115,97,462,160,488,0,13,160,501,0.0253709424216337,0.31936127744511
2011,47117,83,625,69,369,0,22,69,391,0.0191057903738089,0.176470588235294
2011,47119,557,1960,171,1206,0,81,171,1287,0.0238117263964181,0.132867132867133
2011,47121,0,334,48,318,0,0,48,318,0.0381432169845268,0.150943396226415
2011,47123,89,1006,177,880,4,31,181,911,0.0297449962451432,0.198682766190999
2011,47125,444,1637,2000,7784,795,2057,2795,9841,0.097875599228214,0.284015852047556
2011,47127,15,167,0,110,0,0,0,110,0.0249772933696639,0
2011,47129,62,1074,0,123,0,2,0,125,0.0081147753830174,0
2011,47131,58,520,18,425,0,30,18,455,0.0204853450992751,0.0395604395604396
2011,47133,0,319,9,51,0,47,9,98,0.00644058885383807,0.0918367346938776
2011,47135,11,115,0,168,2,2,2,170,0.0308922405960385,0.0117647058823529
2011,47137,0,108,12,18,0,29,12,47,0.0127267803953425,0.25531914893617
2011,47139,17,408,87,270,0,25,87,295,0.0248525695029486,0.294915254237288
2011,47141,113,832,214,824,109,156,323,980,0.0217410595438814,0.329591836734694
2011,47143,36,520,50,632,12,55,62,687,0.0325176314668434,0.0902474526928675
2011,47145,205,1103,84,698,37,56,121,754,0.0193120405706529,0.160477453580902
2011,47147,164,1402,118,762,19,87,137,849,0.0195947193500739,0.161366313309776
2011,47149,1084,5706,1075,4556,239,398,1314,4954,0.0311823354650285,0.265240209931369
2011,47151,23,108,25,141,0,0,25,141,0.00956970272838333,0.177304964539007
2011,47153,1,236,106,186,0,20,106,206,0.0214829492126395,0.514563106796116
2011,47155,237,1535,497,2146,84,142,581,2288,0.0370490316730358,0.253933566433566
2011,47157,1310,3952,5202,14887,989,2101,6191,16988,0.0290115940494468,0.364433717918531
2011,47159,73,332,20,46,0,11,20,57,0.00438057177989548,0.350877192982456
2011,47161,2,156,67,239,0,15,67,254,0.0277960166338367,0.263779527559055
2011,47163,419,2110,473,2806,0,81,473,2887,0.0256985428294211,0.16383789400762
2011,47165,836,4138,881,3116,69,310,950,3426,0.0323012520742193,0.277291301809691
2011,47167,138,1456,87,908,10,10,97,918,0.0237448591603942,0.105664488017429
2011,47169,1,385,7,60,0,18,7,78,0.0147811256395679,0.0897435897435897
2011,47171,39,260,68,320,0,11,68,331,0.0249096929560506,0.205438066465257
2011,47173,59,466,12,126,0,0,12,126,0.00967221923696937,0.0952380952380952
2011,47175,0,63,0,84,0,0,0,84,0.0216160576428204,0
2011,47177,120,421,64,249,0,61,64,310,0.0115211654959676,0.206451612903226
2011,47179,386,2460,780,1890,174,466,954,2356,0.0283749442979128,0.404923599320883
2011,47181,31,687,4,195,0,1,4,196,0.0161796268779924,0.0204081632653061
2011,47183,116,775,87,481,0,4,87,485,0.0221967963386728,0.179381443298969
2011,47185,19,566,44,218,0,0,44,218,0.0122361921867984,0.201834862385321
2011,47187,2174,4110,2226,3879,133,334,2359,4213,0.0361699205000086,0.559933539045811
2011,47189,712,2830,401,1525,57,177,458,1702,0.0224707233671758,0.26909518213866
2011,48001,250,3563,198,610,8,160,206,770,0.0188508335985507,0.267532467532468
2011,48003,11,345,26,181,9,29,35,210,0.0239098257998406,0.166666666666667
2011,48005,261,2228,107,834,45,190,152,1024,0.0186354619738303,0.1484375
2011,48007,210,886,15,241,1,13,16,254,0.0150233631040397,0.062992125984252
2011,48009,15,113,0,53,0,10,0,63,0.0103244837758112,0
2011,48011,40,83,8,20,0,0,8,20,0.0149365197908887,0.4
2011,48013,159,922,14,236,0,23,14,259,0.00930316091954023,0.0540540540540541
2011,48015,118,782,35,205,11,12,46,217,0.0116478797638218,0.211981566820276
2011,48017,85,199,45,58,7,7,52,65,0.0164348925410872,0.8
2011,48019,125,310,79,145,0,37,79,182,0.0119965724078835,0.434065934065934
2011,48021,281,1739,132,905,16,68,148,973,0.0200230481129358,0.152106885919836
2011,48023,18,47,0,67,0,0,0,67,0.023716814159292,0
2011,48025,248,3473,11,203,32,140,43,343,0.0161594271176859,0.12536443148688
2011,48027,1581,5895,2335,9085,1094,4936,3429,14021,0.0787948949944645,0.244561728835318
2011,48029,6958,21969,9205,23403,3081,7245,12286,30648,0.0294416009590999,0.400874445314539
2011,48031,97,234,2,52,0,0,2,52,0.00705563093622795,0.0384615384615385
2011,48033,0,12,0,0,0,4,0,4,0.0097799511002445,0
2011,48035,43,727,38,211,0,35,38,246,0.0191454587905674,0.154471544715447
2011,48037,236,1439,512,2634,35,208,547,2842,0.0462813685736154,0.19247009148487
2011,48039,2520,10124,933,2994,429,929,1362,3923,0.0199340443803068,0.347183278103492
2011,48041,1211,5556,1318,2378,1048,1587,2366,3965,0.0437203660822582,0.59672131147541
2011,48043,159,339,95,189,0,0,95,189,0.0306072874493927,0.502645502645503
2011,48045,0,17,0,10,0,0,0,10,0.00843881856540084,0
2011,48047,7,145,34,94,0,0,34,94,0.0207459721915692,0.361702127659574
2011,48049,140,1141,8,102,0,23,8,125,0.00497631275130379,0.064
2011,48051,91,440,0,107,0,17,0,124,0.0105379451007054,0
2011,48053,374,1359,70,385,0,52,70,437,0.0147331512760864,0.160183066361556
2011,48055,174,1864,65,238,34,42,99,280,0.0119909211596934,0.353571428571429
2011,48057,76,551,2,118,92,121,94,239,0.0172825222358811,0.393305439330544
2011,48059,176,643,0,57,0,29,0,86,0.0092512908777969,0
2011,48061,495,2672,697,2379,389,1813,1086,4192,0.0183812889703496,0.259064885496183
2011,48063,23,187,29,74,0,69,29,143,0.017426273458445,0.202797202797203
2011,48065,55,269,6,27,0,0,6,27,0.00633505396527452,0.222222222222222
2011,48067,73,474,80,343,5,72,85,415,0.0197233971769403,0.204819277108434
2011,48069,25,142,31,64,0,8,31,72,0.0153028692879915,0.430555555555556
2011,48071,111,897,38,277,4,7,42,284,0.0133433565119338,0.147887323943662
2011,48073,190,1514,60,238,0,55,60,293,0.00899849513221338,0.204778156996587
2011,48075,26,306,11,118,0,1,11,119,0.0266457680250784,0.092436974789916
2011,48077,74,214,20,68,0,9,20,77,0.0100798533839508,0.25974025974026
2011,48079,9,88,0,29,0,24,0,53,0.0275324675324675,0
2011,48081,0,163,3,24,0,0,3,24,0.00999583506872137,0.125
2011,48083,32,165,14,75,0,6,14,81,0.0132223310479922,0.172839506172839
2011,48085,10153,22883,5896,12414,2517,3974,8413,16388,0.0334737947248339,0.513363436660971
2011,48087,0,24,0,49,2,2,2,51,0.0261270491803279,0.0392156862745098
2011,48089,90,565,38,97,0,0,38,97,0.00689459094463004,0.391752577319588
2011,48091,1438,5118,519,1410,47,504,566,1914,0.0261157881810367,0.295715778474399
2011,48093,104,283,44,63,9,31,53,94,0.0099703012303776,0.563829787234043
2011,48095,18,242,0,180,60,185,60,365,0.111723293541475,0.164383561643836
2011,48097,258,1088,112,512,10,56,122,568,0.0227728329724962,0.214788732394366
2011,48099,341,2525,307,2060,162,1226,469,3286,0.0742129274131623,0.142726719415703
2011,48101,12,21,0,9,0,0,0,9,0.00744416873449132,0
2011,48103,10,90,0,36,0,0,0,36,0.0137142857142857,0
2011,48105,0,196,0,8,0,11,0,19,0.00780608052588332,0
2011,48107,14,203,4,43,0,19,4,62,0.0158933606767496,0.0645161290322581
2011,48109,0,2,0,13,0,6,0,19,0.0112028301886792,0
2011,48111,50,250,0,123,6,130,6,253,0.0651390319258496,0.0237154150197628
2011,48113,13911,42375,11649,24343,4940,11207,16589,35550,0.0242948181305633,0.466638537271449
2011,48115,111,975,0,80,0,5,0,85,0.00944339517831352,0
2011,48117,19,254,18,102,0,17,18,119,0.0106937455068296,0.151260504201681
2011,48119,10,227,0,8,0,0,0,8,0.00229885057471264,0
2011,48121,8659,22922,5010,11001,1098,2012,6108,13013,0.0323640451450202,0.469376777069085
2011,48123,171,941,28,154,5,13,33,167,0.0118188251946214,0.197604790419162
2011,48125,7,233,0,58,0,20,0,78,0.0448018380241241,0
2011,48127,33,233,1,21,0,0,1,21,0.00351053159478435,0.0476190476190476
2011,48129,39,180,0,13,0,0,0,13,0.00538525269262635,0
2011,48131,0,475,0,25,0,18,0,43,0.00569234842467567,0
2011,48133,29,481,23,221,10,24,33,245,0.0196897854215221,0.13469387755102
2011,48135,432,2839,94,1298,18,445,112,1743,0.0216169959444879,0.0642570281124498
2011,48137,19,58,21,34,0,0,21,34,0.0240622788393489,0.617647058823529
2011,48139,841,4037,349,1289,14,226,363,1515,0.0166412196970529,0.23960396039604
2011,48141,1008,3651,2959,10914,1758,6239,4717,17153,0.0371787257838679,0.274995627587011
2011,48143,156,892,60,230,25,56,85,286,0.01316395102642,0.297202797202797
2011,48145,185,720,0,83,0,6,0,89,0.00746080979126498,0
2011,48147,329,1843,41,287,6,121,47,408,0.0174329174500085,0.115196078431373
2011,48149,55,458,66,155,12,95,78,250,0.0143389733295096,0.312
2011,48151,16,83,0,21,0,0,0,21,0.00750804433321416,0
2011,48153,31,91,0,20,0,0,0,20,0.00480538202787122,0
2011,48155,0,77,0,6,0,0,0,6,0.00645855758880517,0
2011,48157,6268,15843,2486,5258,1526,2904,4012,8162,0.0232002865215488,0.491546189659397
2011,48159,195,482,0,43,0,0,0,43,0.00612535612535612,0
2011,48161,176,1308,0,137,0,41,0,178,0.0130690161527166,0
2011,48163,216,932,0,20,0,216,0,236,0.0221243086153558,0
2011,48165,13,220,0,198,0,88,0,286,0.0301084324665754,0
2011,48167,2031,8306,1363,3820,340,612,1703,4432,0.0232729105841333,0.384250902527076
2011,48169,12,252,74,653,0,128,74,781,0.169377575363262,0.0947503201024328
2011,48171,190,687,18,221,0,34,18,255,0.0140604322893692,0.0705882352941176
2011,48173,0,25,0,0,0,0,0,0,0,NA
2011,48175,32,351,3,35,0,0,3,35,0.0067101226993865,0.0857142857142857
2011,48177,160,352,0,27,0,22,0,49,0.00389105058365759,0
2011,48179,82,961,32,237,0,1,32,238,0.0155190401669275,0.134453781512605
2011,48181,464,2536,260,976,15,44,275,1020,0.0127630821592132,0.269607843137255
2011,48183,604,3703,264,1396,121,397,385,1793,0.0232687915282392,0.214723926380368
2011,48185,174,1706,41,192,0,0,41,192,0.0105523495465787,0.213541666666667
2011,48187,1161,3976,421,1574,155,260,576,1834,0.0225135646068105,0.314067611777535
2011,48189,115,1932,61,550,8,28,69,578,0.0268126362666419,0.119377162629758
2011,48191,2,63,0,0,0,0,0,0,0,NA
2011,48193,29,309,2,74,0,0,2,74,0.0122801194822436,0.027027027027027
2011,48195,5,75,35,105,0,0,35,105,0.0313995215311005,0.333333333333333
2011,48197,2,187,0,6,0,0,0,6,0.00208695652173913,0
2011,48199,214,1529,57,462,0,40,57,502,0.0141655849652915,0.113545816733068
2011,48201,14734,46920,17280,45303,9765,22357,27045,67660,0.0271966981295135,0.399719184156074
2011,48203,336,1653,128,629,20,54,148,683,0.0162105712861652,0.216691068814056
2011,48205,7,477,31,173,0,27,31,200,0.0446229361892012,0.155
2011,48207,35,152,0,15,0,0,0,15,0.00354609929078014,0
2011,48209,2038,6294,745,1704,112,213,857,1917,0.0219386587319753,0.447052686489306
2011,48211,0,144,0,70,0,1,0,71,0.02824184566428,0
2011,48213,386,2559,90,637,14,135,104,772,0.0142590642950814,0.134715025906736
2011,48215,1002,6120,1079,5444,997,4702,2076,10146,0.0245689655172414,0.20461265523359
2011,48217,158,1091,68,291,0,57,68,348,0.0148192309330154,0.195402298850575
2011,48219,238,758,0,186,6,20,6,206,0.0148940785192683,0.029126213592233
2011,48221,331,1522,211,835,27,161,238,996,0.0274629828769956,0.238955823293173
2011,48223,179,1023,100,269,0,40,100,309,0.013354654680612,0.323624595469256
2011,48225,85,762,34,368,0,67,34,435,0.0258083654701869,0.0781609195402299
2011,48227,132,1760,111,781,8,126,119,907,0.0383282623394185,0.131201764057332
2011,48229,7,154,4,39,0,4,4,43,0.0213293650793651,0.0930232558139535
2011,48231,452,2770,188,644,113,329,301,973,0.0175305839324001,0.309352517985612
2011,48233,62,360,12,244,3,20,15,264,0.0181755593803787,0.0568181818181818
2011,48235,7,10,0,25,0,0,0,25,0.0220848056537102,0
2011,48237,50,771,0,157,0,0,0,157,0.025678770035983,0
2011,48239,25,241,0,71,0,3,0,74,0.00801994147610274,0
2011,48241,165,997,21,176,11,30,32,206,0.00858512190039592,0.155339805825243
2011,48243,51,159,0,15,0,0,0,15,0.00863060989643268,0
2011,48245,977,6860,803,2623,75,772,878,3395,0.0207275080590017,0.258615611192931
2011,48247,20,126,0,65,0,1,0,66,0.0215264187866928,0
2011,48249,119,994,0,250,0,42,0,292,0.0117316191241462,0
2011,48251,500,4611,227,990,28,440,255,1430,0.0149186775583445,0.178321678321678
2011,48253,92,2288,11,301,0,50,11,351,0.0239868789721862,0.0313390313390313
2011,48255,69,1029,0,98,0,98,0,196,0.0187005056769392,0
2011,48257,729,4194,118,886,98,259,216,1145,0.0178992949710016,0.188646288209607
2011,48259,496,1625,132,332,0,111,132,443,0.0196217389378571,0.297968397291196
2011,48261,0,0,0,0,0,0,0,0,0,NA
2011,48263,13,47,0,19,0,0,0,19,0.0304,0
2011,48265,489,1614,184,588,5,55,189,643,0.0183029233440551,0.29393468118196
2011,48267,68,339,0,11,0,0,0,11,0.00333333333333333,0
2011,48269,0,13,0,1,0,0,0,1,0.00480769230769231,0
2011,48271,50,228,82,92,0,32,82,124,0.0475642500958957,0.661290322580645
2011,48273,294,913,132,430,37,68,169,498,0.0276436303080766,0.339357429718876
2011,48275,6,123,0,18,0,0,0,18,0.00685192234488009,0
2011,48277,165,915,81,664,18,85,99,749,0.0227721869204342,0.132176234979973
2011,48279,35,410,32,97,0,60,32,157,0.0180542778288868,0.203821656050955
2011,48281,87,605,60,134,34,64,94,198,0.0150239016617346,0.474747474747475
2011,48283,26,462,0,27,0,66,0,93,0.0217188229799159,0
2011,48285,49,382,0,40,0,0,0,40,0.00294377391816309,0
2011,48287,68,578,24,223,0,0,24,223,0.0204025617566331,0.10762331838565
2011,48289,57,322,26,152,0,2,26,154,0.0130001688333615,0.168831168831169
2011,48291,397,4951,45,674,56,182,101,856,0.0175806120353255,0.117990654205607
2011,48293,46,1176,20,265,0,90,20,355,0.0222794025354588,0.0563380281690141
2011,48295,19,119,27,152,0,0,27,152,0.0730418068236425,0.177631578947368
2011,48297,51,671,0,148,0,15,0,163,0.0196220055374985,0
2011,48299,256,754,0,78,0,0,0,78,0.00521494952196296,0
2011,48301,0,3,0,0,0,0,0,0,0,NA
2011,48303,1461,6299,905,2760,272,486,1177,3246,0.0202930805971642,0.362600123228589
2011,48305,26,176,13,17,2,7,15,24,0.00627450980392157,0.625
2011,48307,108,296,0,24,0,0,0,24,0.00418921277709897,0
2011,48309,1139,3935,540,2252,149,523,689,2775,0.0199723625685538,0.248288288288288
2011,48311,1,33,0,12,0,0,0,12,0.0229445506692161,0
2011,48313,79,671,0,0,0,41,0,41,0.00473988439306358,0
2011,48315,14,381,2,56,0,0,2,56,0.00698689956331878,0.0357142857142857
2011,48317,59,179,18,35,0,24,18,59,0.0207090207090207,0.305084745762712
2011,48319,29,36,0,0,0,0,0,0,0,NA
2011,48321,49,741,40,257,0,128,40,385,0.0164081145584726,0.103896103896104
2011,48323,90,539,12,267,28,234,40,501,0.0167889816024932,0.0798403193612774
2011,48325,128,1403,13,154,10,10,23,164,0.00556498133695283,0.140243902439024
2011,48327,1,78,0,13,0,4,0,17,0.0107663077897403,0
2011,48329,631,3365,598,1154,71,231,669,1385,0.0164831895269265,0.483032490974729
2011,48331,97,618,0,62,0,62,0,124,0.00753204154771305,0
2011,48333,9,92,0,0,4,4,4,4,0.00115141047783535,1
2011,48335,168,1211,0,67,0,3,0,70,0.0107775211701309,0
2011,48337,112,571,0,68,9,23,9,91,0.00662010766768515,0.0989010989010989
2011,48339,4019,15260,3543,7793,1141,2451,4684,10244,0.0359665753809423,0.457243264349863
2011,48341,124,532,32,271,0,70,32,341,0.0280243261012492,0.093841642228739
2011,48343,64,556,34,100,3,16,37,116,0.012823347335839,0.318965517241379
2011,48345,0,19,0,6,0,0,0,6,0.00833333333333333,0
2011,48347,342,1316,136,615,0,46,136,661,0.0183943230833449,0.205748865355522
2011,48349,156,1269,76,287,19,71,95,358,0.0117933851627355,0.26536312849162
2011,48351,79,694,0,20,0,0,0,20,0.00201633229156165,0
2011,48353,48,276,2,88,0,16,2,104,0.0104923325262308,0.0192307692307692
2011,48355,1321,6883,1692,4269,313,983,2005,5252,0.0245334579002686,0.381759329779132
2011,48357,91,332,15,236,13,193,28,429,0.0711089010442566,0.0652680652680653
2011,48359,2,56,0,11,0,0,0,11,0.0083905415713196,0
2011,48361,254,1731,72,525,0,55,72,580,0.0106455224565461,0.124137931034483
2011,48363,189,792,21,87,0,3,21,90,0.00481592465753425,0.233333333333333
2011,48365,37,436,38,252,0,0,38,252,0.0160162704970128,0.150793650793651
2011,48367,438,4458,549,1496,30,171,579,1667,0.0220794701986755,0.347330533893221
2011,48369,73,208,5,96,9,45,14,141,0.0234608985024958,0.099290780141844
2011,48371,77,1002,2,64,0,41,2,105,0.0102309266296405,0.019047619047619
2011,48373,174,1718,0,275,11,64,11,339,0.010452317084451,0.0324483775811209
2011,48375,723,4785,266,1549,75,737,341,2286,0.0304885367903013,0.149168853893263
2011,48377,81,278,5,24,7,22,12,46,0.00923509335474804,0.260869565217391
2011,48379,19,505,0,38,0,0,0,38,0.00485312899106003,0
2011,48381,873,3926,212,751,0,118,212,869,0.0114613558427855,0.243958573072497
2011,48383,15,59,0,10,0,0,0,10,0.00504795557799091,0
2011,48385,9,133,0,32,0,0,0,32,0.0130772374335922,0
2011,48387,84,328,24,110,0,41,24,151,0.016382770966692,0.158940397350993
2011,48389,54,1186,0,73,0,30,0,103,0.0118951380066982,0
2011,48391,4,186,0,7,1,1,1,8,0.00161779575328615,0.125
2011,48393,23,23,7,37,0,0,7,37,0.0592,0.189189189189189
2011,48395,52,508,21,95,0,0,21,95,0.00865761414380753,0.221052631578947
2011,48397,933,3363,365,914,78,243,443,1157,0.023843379701185,0.382886776145203
2011,48399,9,154,0,8,5,21,5,29,0.00400995575221239,0.172413793103448
2011,48401,346,4211,93,470,16,69,109,539,0.0151213353906579,0.202226345083488
2011,48403,83,415,0,50,0,0,0,50,0.00634276290752252,0
2011,48405,14,186,0,117,0,0,0,117,0.0186157517899761,0
2011,48407,17,678,4,172,33,33,37,205,0.0115629759151672,0.180487804878049
2011,48409,302,2410,114,833,25,118,139,951,0.0231736439397631,0.146161934805468
2011,48411,29,115,0,18,0,0,0,18,0.00436999271667881,0
2011,48413,4,88,8,24,0,0,8,24,0.0117073170731707,0.333333333333333
2011,48415,62,539,48,180,0,10,48,190,0.0174375917767988,0.252631578947368
2011,48417,7,44,0,4,19,22,19,26,0.0122641509433962,0.730769230769231
2011,48419,68,534,4,159,0,26,4,185,0.0113046135044302,0.0216216216216216
2011,48421,14,99,11,37,6,22,17,59,0.0318402590393956,0.288135593220339
2011,48423,1550,5691,659,1876,123,374,782,2250,0.0171171650931554,0.347555555555556
2011,48425,43,299,0,86,0,43,0,129,0.0232600072124053,0
2011,48427,111,669,0,173,49,213,49,386,0.0116023926177523,0.126943005181347
2011,48429,74,558,6,58,19,45,25,103,0.015919629057187,0.242718446601942
2011,48431,0,35,0,40,0,0,0,40,0.050251256281407,0
2011,48433,13,32,0,0,0,0,0,0,0,NA
2011,48435,17,84,0,32,0,0,0,32,0.0113314447592068,0
2011,48437,16,529,0,23,0,29,0,52,0.010454362685967,0
2011,48439,9606,33274,8215,23800,2478,6336,10693,30136,0.0271173263482402,0.354824794265994
2011,48441,638,2813,527,1466,90,588,617,2054,0.0257077774162057,0.300389483933788
2011,48443,0,39,0,0,0,0,0,0,0,NA
2011,48445,38,677,32,136,28,33,60,169,0.0209313846916027,0.355029585798817
2011,48447,3,14,0,3,0,0,0,3,0.00229357798165138,0
2011,48449,162,805,13,440,2,63,15,503,0.0267197875166003,0.0298210735586481
2011,48451,681,2747,724,2225,54,439,778,2664,0.0391407834033675,0.292042042042042
2011,48453,10463,24423,11385,19561,2806,5961,14191,25522,0.0398629272589825,0.556030091685605
2011,48455,50,315,0,59,0,44,0,103,0.0100921026846953,0
2011,48457,150,786,52,338,0,0,52,338,0.022177022505085,0.153846153846154
2011,48459,198,1206,45,282,0,19,45,301,0.0114183832176321,0.149501661129568
2011,48461,33,146,0,19,0,0,0,19,0.0087881591119334,0
2011,48463,43,436,0,109,0,50,0,159,0.00989298158287705,0
2011,48465,118,768,274,689,15,154,289,843,0.0292150407208456,0.34282325029656
2011,48467,107,1445,17,161,5,12,22,173,0.00482445132323824,0.127167630057803
2011,48469,302,2208,114,569,38,95,152,664,0.0120018075011297,0.228915662650602
2011,48471,661,4986,105,408,13,13,118,421,0.00986803553430373,0.280285035629454
2011,48473,94,930,16,331,0,45,16,376,0.0154981245620543,0.0425531914893617
2011,48475,12,353,2,134,0,0,2,134,0.0199256505576208,0.0149253731343284
2011,48477,244,905,15,33,0,130,15,163,0.00731368062098981,0.0920245398773006
2011,48479,420,1759,369,1163,586,1696,955,2859,0.0216608959837562,0.334032878628891
2011,48481,122,666,0,107,6,78,6,185,0.00700121102028459,0.0324324324324324
2011,48483,2,225,8,68,0,0,8,68,0.0191711305328447,0.117647058823529
2011,48485,354,2862,538,2236,89,442,627,2678,0.032619552242442,0.234129947722181
2011,48487,45,424,0,55,7,7,7,62,0.00730184901660582,0.112903225806452
2011,48489,16,1072,33,87,0,30,33,117,0.00869759143621766,0.282051282051282
2011,48491,6751,17456,3751,8407,751,1767,4502,10174,0.0390002683328861,0.442500491448791
2011,48493,153,1202,98,369,0,20,98,389,0.0140008638065073,0.251928020565553
2011,48495,16,184,0,82,0,41,0,123,0.0286713286713287,0
2011,48497,357,2000,53,526,5,109,58,635,0.0165519758106558,0.0913385826771654
2011,48499,270,1912,53,283,0,13,53,296,0.00974934949441718,0.179054054054054
2011,48501,0,114,0,36,0,71,0,107,0.0228583635975219,0
2011,48503,101,689,40,184,0,33,40,217,0.0172181226692057,0.184331797235023
2011,48505,0,60,1,188,0,0,1,188,0.0244473342002601,0.00531914893617021
2011,48507,15,331,3,92,0,103,3,195,0.0292091072498502,0.0153846153846154
2011,49001,0,205,0,111,0,5,0,116,0.0303823991618649,0
2011,49003,227,691,102,451,34,83,136,534,0.0189080093477799,0.254681647940075
2011,49005,535,1406,847,1984,238,324,1085,2308,0.0417012972933907,0.470103986135182
2011,49007,11,343,41,263,0,7,41,270,0.0204514467504924,0.151851851851852
2011,49009,11,64,32,33,0,0,32,33,0.0492537313432836,0.96969696969697
2011,49011,2372,6565,1675,4341,199,651,1874,4992,0.0295580503055279,0.375400641025641
2011,49013,35,278,37,212,10,14,47,226,0.0219801595020424,0.207964601769911
2011,49015,36,135,88,273,0,0,88,273,0.0418134476948997,0.322344322344322
2011,49017,8,96,39,130,6,6,45,136,0.0396270396270396,0.330882352941176
2011,49019,1,46,61,187,0,1,61,188,0.0298270664762811,0.324468085106383
2011,49021,123,521,123,595,47,59,170,654,0.027700127064803,0.259938837920489
2011,49023,51,203,0,25,12,12,12,37,0.00658831908831909,0.324324324324324
2011,49025,2,148,63,200,0,0,63,200,0.0399440782903934,0.315
2011,49027,133,286,31,81,1,18,32,99,0.013469387755102,0.323232323232323
2011,49029,20,143,0,40,0,0,0,40,0.00755001887504719,0
2011,49031,0,8,7,12,0,0,7,12,0.0107719928186715,0.583333333333333
2011,49033,0,41,0,0,0,0,0,0,0,NA
2011,49035,3404,10492,6452,16331,1205,3584,7657,19915,0.0325358523364058,0.384484057243284
2011,49037,14,157,114,180,21,21,135,201,0.0248332097850259,0.671641791044776
2011,49039,99,961,46,481,0,30,46,511,0.0348116356700048,0.0900195694716243
2011,49041,29,481,26,128,0,4,26,132,0.0106460198403097,0.196969696969697
2011,49043,175,440,490,894,105,160,595,1054,0.0449562806568565,0.564516129032258
2011,49045,158,1423,312,759,41,83,353,842,0.0263685331329074,0.419239904988124
2011,49047,60,599,112,446,0,0,112,446,0.0243091513598954,0.251121076233184
2011,49049,1471,4913,2694,6505,957,1914,3651,8419,0.0346594979127728,0.433661955101556
2011,49051,84,363,94,345,0,5,94,350,0.026361376817052,0.268571428571429
2011,49053,586,2050,835,2766,139,293,974,3059,0.037260801247305,0.318404707420726
2011,49055,26,55,18,54,7,132,25,186,0.108518086347725,0.134408602150538
2011,49057,935,4228,743,2706,46,175,789,2881,0.0213135856538336,0.273863241929885
2011,50001,217,536,322,543,20,101,342,644,0.0262857142857143,0.531055900621118
2011,50003,23,135,316,835,0,0,316,835,0.0319250621296119,0.378443113772455
2011,50005,82,360,236,370,12,29,248,399,0.0186309301456855,0.621553884711779
2011,50007,657,1530,1520,2600,279,496,1799,3096,0.0309290709290709,0.581072351421189
2011,50009,7,76,47,151,8,8,55,159,0.0340325342465753,0.345911949685535
2011,50011,197,789,141,411,10,78,151,489,0.0151154523816884,0.30879345603272
2011,50013,31,159,44,153,0,10,44,163,0.031291994624688,0.269938650306748
2011,50015,45,302,355,610,59,71,414,681,0.0413152945458958,0.607929515418502
2011,50017,132,420,134,319,26,31,160,350,0.0170965220789371,0.457142857142857
2011,50019,39,475,78,238,10,22,88,260,0.0134770889487871,0.338461538461538
2011,50021,117,567,335,821,23,42,358,863,0.019786316947909,0.414831981460023
2011,50023,292,805,439,771,32,84,471,855,0.0206143311794773,0.550877192982456
2011,50025,53,268,627,1074,38,91,665,1165,0.0367218282111899,0.570815450643777
2011,50027,278,796,948,1781,49,108,997,1889,0.0452574330961451,0.52779248279513
2011,51001,97,222,117,401,0,0,117,401,0.0167586091608158,0.291770573566085
2011,51003,1541,2862,1900,2563,231,443,2131,3006,0.0467205470935654,0.708915502328676
2011,51005,91,587,0,89,0,10,0,99,0.00841765156024148,0
2011,51007,28,161,0,37,0,19,0,56,0.00633484162895928,0
2011,51009,119,745,76,271,0,41,76,312,0.0140350877192982,0.243589743589744
2011,51011,36,417,8,39,0,0,8,39,0.00372635199694248,0.205128205128205
2011,51013,4123,6041,9063,11011,1889,2570,10952,13581,0.0898517357045035,0.806420734850158
2011,51015,191,1371,75,233,18,42,93,275,0.00526114405969007,0.338181818181818
2011,51017,0,126,0,15,0,7,0,22,0.0062929061784897,0
2011,51019,403,1634,176,697,45,67,221,764,0.0157802333987401,0.289267015706806
2011,51021,22,227,2,48,0,0,2,48,0.00909607731665719,0.0416666666666667
2011,51023,128,664,41,174,0,0,41,174,0.00739890292129098,0.235632183908046
2011,51025,39,268,30,104,0,1,30,105,0.00852826510721248,0.285714285714286
2011,51027,29,167,34,369,0,0,34,369,0.020693135935397,0.0921409214092141
2011,51029,114,1000,13,168,0,12,13,180,0.0138888888888889,0.0722222222222222
2011,51031,223,1308,97,331,0,0,97,331,0.00887875536480687,0.293051359516616
2011,51033,127,949,47,287,0,15,47,302,0.015754603787365,0.155629139072848
2011,51035,10,289,54,312,0,14,54,326,0.0147298030001807,0.165644171779141
2011,51036,12,148,22,44,0,1,22,45,0.00845387939132068,0.488888888888889
2011,51037,44,197,7,23,0,17,7,40,0.00459084127166303,0.175
2011,51041,1892,6178,1830,4240,483,862,2313,5102,0.0249662353931375,0.453351626813014
2011,51043,85,427,100,292,0,5,100,297,0.0295404814004376,0.336700336700337
2011,51045,13,73,0,3,0,0,0,3,0.000821018062397373,0
2011,51047,284,1600,118,465,19,55,137,520,0.0168099825434797,0.263461538461538
2011,51049,103,418,0,29,17,30,17,59,0.00876281004010099,0.288135593220339
2011,51051,0,305,15,135,0,7,15,142,0.0124256212810641,0.105633802816901
2011,51053,65,499,52,155,0,26,52,181,0.00965899994663536,0.287292817679558
2011,51057,33,269,20,52,0,11,20,63,0.00834547622201616,0.317460317460317
2011,51059,11154,19919,15718,23862,6211,10445,21929,34307,0.0474621245135433,0.639198997289183
2011,51061,422,1723,314,712,19,64,333,776,0.0177371428571429,0.429123711340206
2011,51063,25,151,157,189,0,0,157,189,0.0173905042326095,0.830687830687831
2011,51065,207,789,35,150,0,29,35,179,0.00981844111677911,0.195530726256983
2011,51067,243,1034,166,407,0,36,166,443,0.0112200187422435,0.374717832957111
2011,51069,411,2178,305,1059,34,60,339,1119,0.021643681940388,0.302949061662198
2011,51071,47,350,29,323,7,31,36,354,0.0289570552147239,0.101694915254237
2011,51073,99,822,25,417,63,341,88,758,0.0294700828117103,0.116094986807388
2011,51075,228,603,176,216,18,21,194,237,0.0146413788842899,0.818565400843882
2011,51077,46,344,4,111,0,1,4,112,0.00959479139895485,0.0357142857142857
2011,51079,142,380,141,295,18,61,159,356,0.0288002588787315,0.446629213483146
2011,51081,0,296,0,52,0,0,0,52,0.00577841982442494,0
2011,51083,115,484,70,490,2,33,72,523,0.0205800181009719,0.137667304015296
2011,51085,713,2503,314,803,33,81,347,884,0.0132990326608596,0.392533936651584
2011,51087,3678,9937,2606,4746,829,1701,3435,6447,0.0314375856402354,0.532805956258725
2011,51089,134,1368,9,381,0,57,9,438,0.0111521323997454,0.0205479452054795
2011,51091,0,50,4,27,0,0,4,27,0.0137055837563452,0.148148148148148
2011,51093,240,838,198,486,53,114,251,600,0.0243565803361208,0.418333333333333
2011,51095,855,2262,760,1471,98,177,858,1648,0.0351071535085851,0.520631067961165
2011,51097,59,134,0,7,0,0,0,7,0.00141499898928644,0
2011,51099,126,692,197,585,13,71,210,656,0.0435793529528998,0.320121951219512
2011,51101,74,375,15,49,0,8,15,57,0.00537735849056604,0.263157894736842
2011,51103,17,111,32,63,20,27,52,90,0.00996567379027793,0.577777777777778
2011,51105,0,180,48,460,0,42,48,502,0.0274827548450673,0.0956175298804781
2011,51107,4350,7074,3926,6322,1089,2129,5015,8451,0.0438282137319068,0.593420896935274
2011,51109,147,601,14,197,7,23,21,220,0.00947173548026004,0.0954545454545455
2011,51111,26,299,17,64,0,7,17,71,0.00767567567567568,0.23943661971831
2011,51113,67,289,35,66,0,0,35,66,0.00699523052464229,0.53030303030303
2011,51115,46,276,0,58,0,0,0,58,0.0086027884900623,0
2011,51117,97,781,21,245,73,137,94,382,0.0159638931840027,0.246073298429319
2011,51119,17,216,5,67,36,36,41,103,0.0122619047619048,0.398058252427184
2011,51121,788,1835,889,1520,243,320,1132,1840,0.037914691943128,0.615217391304348
2011,51125,69,326,41,158,0,9,41,167,0.0149520995612857,0.245508982035928
2011,51127,232,900,30,91,0,2,30,93,0.00723285114325712,0.32258064516129
2011,51131,25,221,15,77,0,8,15,85,0.00933963300736183,0.176470588235294
2011,51133,62,163,52,80,24,24,76,104,0.0107426918706745,0.730769230769231
2011,51135,40,439,24,82,0,59,24,141,0.0128251773694743,0.170212765957447
2011,51137,504,1505,95,387,0,23,95,410,0.0175378561040294,0.231707317073171
2011,51139,10,383,72,150,8,73,80,223,0.0130607941899965,0.358744394618834
2011,51141,6,348,0,39,0,11,0,50,0.00363055474876561,0
2011,51143,219,1040,128,722,0,23,128,745,0.0165067688830789,0.171812080536913
2011,51145,108,1309,59,297,0,7,59,304,0.0151908854687188,0.194078947368421
2011,51147,147,542,229,460,0,0,229,460,0.0361209265802905,0.497826086956522
2011,51149,243,1945,204,997,22,155,226,1152,0.0483505414253337,0.196180555555556
2011,51153,3923,10446,3811,8238,674,1497,4485,9735,0.0398602944789295,0.460708782742681
2011,51155,201,1153,86,351,0,30,86,381,0.0149271274094969,0.225721784776903
2011,51157,10,89,40,40,49,62,89,102,0.0187293426367976,0.872549019607843
2011,51159,16,300,0,127,0,0,0,127,0.0182839044054132,0
2011,51161,877,3205,426,980,74,191,500,1171,0.017967563254722,0.426985482493595
2011,51163,211,442,30,221,13,14,43,235,0.014533984785701,0.182978723404255
2011,51165,524,1578,287,744,91,150,378,894,0.0175528155187309,0.422818791946309
2011,51167,10,362,0,152,0,0,0,152,0.00731120731120731,0
2011,51169,33,421,24,260,0,16,24,276,0.0162181219884828,0.0869565217391304
2011,51171,314,1125,58,555,7,54,65,609,0.0206384709231395,0.106732348111658
2011,51173,64,694,205,498,11,11,216,509,0.0221419871237167,0.424361493123772
2011,51175,64,520,15,89,4,34,19,123,0.00932383262583384,0.154471544715447
2011,51177,689,2782,587,1807,68,260,655,2067,0.0267337489329781,0.316884373488147
2011,51179,928,3101,2041,3865,230,522,2271,4387,0.05626523021675,0.517665830863916
2011,51181,12,238,0,39,0,0,0,39,0.00804621415308438,0
2011,51183,62,293,39,101,0,9,39,110,0.012512797178933,0.354545454545455
2011,51185,43,472,35,791,0,10,35,801,0.0247290914142817,0.0436953807740325
2011,51187,100,1010,216,384,19,74,235,458,0.0181587502973594,0.513100436681223
2011,51191,123,681,351,1017,12,27,363,1044,0.0264786446180379,0.347701149425287
2011,51193,121,474,14,211,19,31,33,242,0.0192093983171932,0.136363636363636
2011,51195,14,736,32,529,0,19,32,548,0.0190834378047082,0.0583941605839416
2011,51197,0,341,0,186,0,0,0,186,0.0089281428502856,0
2011,51199,648,1834,873,1708,153,522,1026,2230,0.0522737927801219,0.460089686098655
2011,51510,3582,6040,5553,7831,1171,1934,6724,9765,0.0942112879884226,0.688581669226831
2011,51515,16,222,19,123,0,0,19,123,0.0283737024221453,0.154471544715447
2011,51520,46,798,205,898,0,0,205,898,0.0719263115738887,0.228285077951002
2011,51530,34,359,0,70,12,12,12,82,0.0195145168967158,0.146341463414634
2011,51540,791,2269,682,862,272,365,954,1227,0.051163372529397,0.777506112469438
2011,51550,1431,6122,1323,4086,341,651,1664,4737,0.0331367652305303,0.351277179649567
2011,51570,121,616,23,197,23,70,46,267,0.0222592746977907,0.172284644194757
2011,51580,79,597,20,39,0,1,20,40,0.0098570724494825,0.5
2011,51590,284,1307,218,765,32,81,250,846,0.0283094632579307,0.295508274231678
2011,51595,8,180,0,8,0,46,0,54,0.0135,0
2011,51600,555,1108,388,479,154,179,542,658,0.0426580226904376,0.82370820668693
2011,51610,406,725,409,510,142,202,551,712,0.0889777555611097,0.773876404494382
2011,51620,56,406,60,221,0,13,60,234,0.0409950946040645,0.256410256410256
2011,51630,391,1468,265,512,12,57,277,569,0.0412528093960705,0.486818980667838
2011,51640,30,528,16,68,0,16,16,84,0.0157068062827225,0.19047619047619
2011,51650,423,2860,690,2080,135,327,825,2407,0.0271141000078853,0.342750311591192
2011,51660,578,2104,315,470,101,306,416,776,0.037189686571456,0.536082474226804
2011,51670,122,743,13,194,8,15,21,209,0.014104467539479,0.100478468899522
2011,51678,83,113,44,69,53,62,97,131,0.0511918718249316,0.740458015267176
2011,51680,587,2503,435,1070,149,219,584,1289,0.0298193258842853,0.453064391000776
2011,51683,638,2315,98,433,0,87,98,520,0.0229935883263321,0.188461538461538
2011,51685,286,798,185,329,5,35,190,364,0.0434886499402628,0.521978021978022
2011,51690,61,964,21,210,0,0,21,210,0.0212787516465701,0.1
2011,51700,1338,5832,1350,4425,439,1304,1789,5729,0.0510628815900887,0.312270902426252
2011,51710,1451,6190,1925,5422,296,770,2221,6192,0.0433376726997858,0.358688630490956
2011,51720,13,221,0,50,0,0,0,50,0.0190839694656489,0
2011,51730,108,638,62,353,0,0,62,353,0.0162852924893892,0.175637393767705
2011,51735,72,259,38,52,0,0,38,52,0.00627791862851624,0.730769230769231
2011,51740,566,3427,340,1168,74,134,414,1302,0.0208220054373901,0.317972350230415
2011,51750,77,396,51,220,0,19,51,239,0.0368315611034058,0.213389121338912
2011,51760,2426,7097,1519,2954,179,774,1698,3728,0.0289494936944772,0.455472103004292
2011,51770,794,3731,638,1430,13,244,651,1674,0.0250707642539426,0.388888888888889
2011,51775,293,1097,45,218,77,114,122,332,0.0202710953718403,0.367469879518072
2011,51790,329,1248,37,213,10,19,47,232,0.0138103458539199,0.202586206896552
2011,51800,457,1973,466,1368,69,114,535,1482,0.0270009291817735,0.360998650472335
2011,51810,2113,9097,3639,10065,831,2429,4470,12494,0.044025356688549,0.357771730430607
2011,51820,75,646,82,255,0,0,82,255,0.0176751923476814,0.32156862745098
2011,51830,311,637,141,278,34,211,175,489,0.07824,0.357873210633947
2011,51840,219,1777,189,471,15,313,204,784,0.0460769908903908,0.260204081632653
2011,53001,5,182,10,136,10,50,20,186,0.0182067345340642,0.10752688172043
2011,53003,57,232,82,544,49,79,131,623,0.0411275415896488,0.210272873194221
2011,53005,563,3805,1225,3219,412,764,1637,3983,0.0364473238714873,0.410996736128546
2011,53007,343,1822,295,830,0,111,295,941,0.0197809589876185,0.313496280552604
2011,53009,442,1711,467,1725,42,128,509,1853,0.0350085017948234,0.274689692390718
2011,53011,708,3304,3413,10570,260,1089,3673,11659,0.0425414687187571,0.315035594819453
2011,53013,19,180,0,32,4,17,4,49,0.0159142578759337,0.0816326530612245
2011,53015,366,1693,412,1950,70,209,482,2159,0.0313189044911222,0.22325150532654
2011,53017,186,1276,97,364,27,153,124,517,0.0212416286618185,0.239845261121857
2011,53019,10,168,8,47,2,19,10,66,0.0126364158529581,0.151515151515152
2011,53021,355,2436,298,1144,18,127,316,1271,0.03045770428948,0.248623131392604
2011,53023,0,31,14,87,0,0,14,87,0.0528233151183971,0.160919540229885
2011,53025,246,1199,145,877,40,194,185,1071,0.0206549409858829,0.172735760971055
2011,53027,108,2042,101,459,0,63,101,522,0.0103944722117127,0.193486590038314
2011,53029,425,1578,606,2271,255,634,861,2905,0.0525820406537912,0.296385542168675
2011,53031,204,762,132,700,43,67,175,767,0.0323478554257518,0.228161668839635
2011,53033,6789,20463,21977,37085,9186,14622,31163,51707,0.0390708000042315,0.602684356083316
2011,53035,801,3480,1995,5330,324,1397,2319,6727,0.0402084840080572,0.344730191764531
2011,53037,317,1026,123,320,5,13,128,333,0.0140476692680869,0.384384384384384
2011,53039,46,221,37,242,0,16,37,258,0.0177869700103413,0.143410852713178
2011,53041,253,1670,103,851,0,102,103,953,0.0185643323268725,0.108079748163694
2011,53043,19,285,33,122,5,6,38,128,0.0169424222369292,0.296875
2011,53045,350,2221,275,719,22,47,297,766,0.0177245065599186,0.387728459530026
2011,53047,111,874,158,417,5,451,163,868,0.030818391620806,0.18778801843318
2011,53049,49,415,120,516,6,51,126,567,0.0356424440533065,0.222222222222222
2011,53051,28,247,53,173,0,22,53,195,0.0208022189033497,0.271794871794872
2011,53053,3257,15261,3830,12399,1427,4207,5257,16606,0.0323375285528732,0.316572323256654
2011,53055,119,340,184,336,8,22,192,358,0.028621682123441,0.536312849162011
2011,53057,657,2223,374,1328,105,489,479,1817,0.0230055329762854,0.263621353880022
2011,53059,23,132,14,170,0,12,14,182,0.0236087689713322,0.0769230769230769
2011,53061,5312,17105,3468,9656,983,2540,4451,12196,0.0260039871643159,0.36495572318793
2011,53063,1223,5375,2785,8244,355,1234,3140,9478,0.0311220418791435,0.331293521840051
2011,53065,196,641,91,411,2,65,93,476,0.0157673324720925,0.195378151260504
2011,53067,1529,5271,1767,4158,583,1929,2350,6087,0.0361763709519253,0.386068670938065
2011,53069,13,20,6,45,0,0,6,45,0.0156358582348853,0.133333333333333
2011,53071,212,1414,247,1258,39,121,286,1379,0.0369526769923361,0.207396664249456
2011,53073,613,2026,928,2648,425,753,1353,3401,0.0266375306437338,0.397824169361952
2011,53075,357,780,473,796,192,252,665,1048,0.0492481203007519,0.634541984732824
2011,53077,388,2200,751,2892,51,804,802,3696,0.0258295362424175,0.216991341991342
2011,54001,10,153,8,168,0,0,8,168,0.0149041873669269,0.0476190476190476
2011,54003,180,1162,540,2710,13,139,553,2849,0.0413677943952374,0.194103194103194
2011,54005,66,369,0,217,0,0,0,217,0.0125281450262687,0
2011,54007,40,325,6,164,0,0,6,164,0.0157646832644429,0.0365853658536585
2011,54009,25,160,37,259,0,14,37,273,0.0158785552259641,0.135531135531136
2011,54011,303,1308,464,2087,65,104,529,2191,0.0338310455043775,0.241442263806481
2011,54013,0,155,42,167,0,0,42,167,0.0301335258029592,0.251497005988024
2011,54015,0,197,2,28,0,0,2,28,0.00426764212772443,0.0714285714285714
2011,54017,15,231,11,39,0,0,11,39,0.00680984808800419,0.282051282051282
2011,54019,37,527,83,449,4,8,87,457,0.0139214670850215,0.190371991247265
2011,54021,29,292,76,477,13,48,89,525,0.0878073256397391,0.16952380952381
2011,54023,0,215,22,80,0,0,22,80,0.00933706816059757,0.275
2011,54025,23,312,280,713,7,7,287,720,0.0280898876404494,0.398611111111111
2011,54027,48,271,13,279,0,0,13,279,0.0166905958363245,0.046594982078853
2011,54029,36,344,194,925,0,28,194,953,0.0422485259564658,0.203567681007345
2011,54031,1,90,2,222,0,24,2,246,0.025802391441158,0.00813008130081301
2011,54033,122,774,210,890,8,30,218,920,0.0189550024723916,0.23695652173913
2011,54035,137,523,36,290,0,0,36,290,0.0142108100161709,0.124137931034483
2011,54037,43,376,361,1148,80,192,441,1340,0.0381722880583409,0.32910447761194
2011,54039,646,2637,755,2333,40,219,795,2552,0.018514488022171,0.311520376175549
2011,54041,22,202,27,250,0,0,27,250,0.0210881484605652,0.108
2011,54043,22,283,0,119,0,48,0,167,0.0109608821212917,0
2011,54045,47,510,28,365,24,33,52,398,0.0151158374477782,0.130653266331658
2011,54047,26,195,2,149,0,0,2,149,0.00932065557362692,0.0134228187919463
2011,54049,185,618,137,531,17,85,154,616,0.0157054714191015,0.25
2011,54051,63,514,45,478,0,10,45,488,0.0205042016806723,0.0922131147540984
2011,54053,57,447,64,401,0,0,64,401,0.0207170903079149,0.159600997506234
2011,54055,148,894,219,911,0,88,219,999,0.0227806535470777,0.219219219219219
2011,54057,13,145,51,403,0,0,51,403,0.020784981174893,0.126550868486352
2011,54059,13,173,32,351,0,28,32,379,0.0201950231789844,0.0844327176781003
2011,54061,339,839,760,1512,140,251,900,1763,0.0327865803764041,0.510493477027794
2011,54063,39,139,51,202,0,0,51,202,0.0206840057341798,0.252475247524752
2011,54065,13,86,17,194,0,0,17,194,0.0152204613211988,0.0876288659793814
2011,54067,40,262,13,308,0,38,13,346,0.0184651510299925,0.0375722543352601
2011,54069,121,518,221,739,11,40,232,779,0.0252185173195209,0.297817715019255
2011,54071,11,51,0,6,5,64,5,70,0.0122893258426966,0.0714285714285714
2011,54073,31,336,0,43,0,0,0,43,0.00787113307706388,0
2011,54075,32,242,17,125,55,55,72,180,0.0270839602768583,0.4
2011,54077,52,630,117,678,0,25,117,703,0.0290988865433172,0.166429587482219
2011,54079,202,1279,143,332,19,38,162,370,0.00960340531561462,0.437837837837838
2011,54081,252,1223,172,1142,0,178,172,1320,0.0236622748050551,0.13030303030303
2011,54083,89,744,0,199,0,19,0,218,0.0103302847936312,0
2011,54085,0,127,26,139,0,0,26,139,0.0184619471377341,0.18705035971223
2011,54087,1,115,11,220,0,0,11,220,0.0205473055010741,0.05
2011,54089,32,301,57,530,0,8,57,538,0.052238081367123,0.105947955390335
2011,54091,102,491,16,91,0,11,16,102,0.00844650546538589,0.156862745098039
2011,54093,28,63,11,53,0,0,11,53,0.0101241642788921,0.207547169811321
2011,54095,9,62,10,109,0,0,10,109,0.0163516351635164,0.0917431192660551
2011,54097,45,278,73,398,0,22,73,420,0.0256849315068493,0.173809523809524
2011,54099,71,516,12,415,9,9,21,424,0.0142722498990171,0.0495283018867925
2011,54101,5,63,17,17,0,0,17,17,0.00258044930176078,1
2011,54103,12,124,16,118,0,22,16,140,0.0117914596142508,0.114285714285714
2011,54105,0,214,0,28,0,0,0,28,0.0067649190625755,0
2011,54107,193,916,329,1448,9,73,338,1521,0.0248180661162419,0.222222222222222
2011,54109,0,173,15,28,0,0,15,28,0.00166231298978865,0.535714285714286
2011,55001,69,747,37,391,2,48,39,439,0.0270987654320988,0.0888382687927107
2011,55003,55,205,73,205,0,9,73,214,0.019818484904612,0.341121495327103
2011,55005,144,846,97,534,8,16,105,550,0.017099331571584,0.190909090909091
2011,55007,111,349,90,159,0,2,90,161,0.0140845070422535,0.559006211180124
2011,55009,672,3106,970,1890,181,396,1151,2286,0.0142588930957267,0.503499562554681
2011,55011,40,211,20,112,3,16,23,128,0.0132615002072109,0.1796875
2011,55013,37,187,93,241,0,16,93,257,0.0219526778850261,0.361867704280156
2011,55015,355,1390,32,82,21,40,53,122,0.00378823164104953,0.434426229508197
2011,55017,230,1930,102,547,14,26,116,573,0.0134327308530839,0.202443280977312
2011,55019,76,547,32,159,3,19,35,178,0.00813379638091757,0.196629213483146
2011,55021,475,1859,86,287,0,45,86,332,0.0084420372771887,0.259036144578313
2011,55023,51,490,37,180,0,0,37,180,0.0151171579743008,0.205555555555556
2011,55025,2289,6335,5070,7375,1406,2142,6476,9517,0.0303880810519123,0.680466533571504
2011,55027,428,3679,175,665,2,14,177,679,0.010939967131763,0.260677466863034
2011,55029,95,362,120,331,12,14,132,345,0.0161600074944962,0.382608695652174
2011,55031,39,376,360,943,15,19,375,962,0.0319208945814116,0.38981288981289
2011,55033,220,849,111,395,8,46,119,441,0.017097662156399,0.26984126984127
2011,55035,238,1218,482,1048,13,105,495,1153,0.0193316902234965,0.429314830875976
2011,55037,0,29,25,64,0,0,25,64,0.0188346085932902,0.390625
2011,55039,468,2073,171,640,52,96,223,736,0.0106520008683696,0.302989130434783
2011,55041,16,193,5,24,2,12,7,36,0.00545041635124905,0.194444444444444
2011,55043,96,768,326,457,16,43,342,500,0.0160194796872998,0.684
2011,55045,68,674,47,201,8,21,55,222,0.00878338278931751,0.247747747747748
2011,55047,110,561,29,80,2,14,31,94,0.00695986968754628,0.329787234042553
2011,55049,106,475,62,157,0,8,62,165,0.0101394948688011,0.375757575757576
2011,55051,26,94,37,150,0,1,37,151,0.0323202054794521,0.245033112582781
2011,55053,57,873,42,166,5,9,47,175,0.0122884628888421,0.268571428571429
2011,55055,353,1561,174,587,46,108,220,695,0.0126817874933854,0.316546762589928
2011,55057,100,551,27,334,2,13,29,347,0.0184731686541738,0.0835734870317003
2011,55059,415,1657,1023,2990,250,417,1273,3407,0.0320215795558145,0.373642500733783
2011,55061,90,369,62,138,6,26,68,164,0.0114813777653318,0.414634146341463
2011,55063,359,1490,612,1387,63,94,675,1481,0.0207356173781555,0.455773126266036
2011,55065,41,260,15,120,0,38,15,158,0.0141387024608501,0.0949367088607595
2011,55067,29,400,16,164,0,0,16,164,0.0112978782033618,0.0975609756097561
2011,55069,34,398,22,104,8,66,30,170,0.00817307692307692,0.176470588235294
2011,55071,191,744,212,515,11,101,223,616,0.0108597923241013,0.362012987012987
2011,55073,366,1766,451,1095,33,128,484,1223,0.0136153632062343,0.395748160261652
2011,55075,162,663,91,414,25,43,116,457,0.0151812111749659,0.25382932166302
2011,55077,61,511,34,174,0,21,34,195,0.0171730515191546,0.174358974358974
2011,55078,12,98,0,26,0,0,0,26,0.0104,0
2011,55079,2996,8650,4176,8475,686,2345,4862,10820,0.018021889433543,0.449353049907579
2011,55081,171,834,211,505,29,59,240,564,0.0191257757129777,0.425531914893617
2011,55083,71,746,20,93,12,25,32,118,0.00440824865511058,0.271186440677966
2011,55085,115,937,142,455,2,29,144,484,0.0178617559139388,0.297520661157025
2011,55087,975,3447,640,1186,188,241,828,1427,0.012342155336447,0.580238262088297
2011,55089,807,1883,523,1072,26,80,549,1152,0.0194880990645036,0.4765625
2011,55091,25,155,6,16,0,4,6,20,0.00382262996941896,0.3
2011,55093,74,412,213,838,13,23,226,861,0.0348371434351608,0.262485481997677
2011,55095,65,390,126,543,9,60,135,603,0.0195671220430282,0.223880597014925
2011,55097,305,973,238,365,3,61,241,426,0.00980595262758097,0.565727699530516
2011,55099,33,220,8,113,3,6,11,119,0.0110780115434742,0.092436974789916
2011,55101,817,3736,259,1408,54,167,313,1575,0.0120944519101555,0.198730158730159
2011,55103,81,648,28,116,3,25,31,141,0.0112296909843899,0.219858156028369
2011,55105,300,1562,417,1965,85,129,502,2094,0.019788506789896,0.239732569245463
2011,55107,53,396,111,245,0,1,111,246,0.0233463035019455,0.451219512195122
2011,55109,401,1084,872,2112,14,125,886,2237,0.0404828260161425,0.396066160035762
2011,55111,239,913,112,664,11,35,123,699,0.0165816629106868,0.175965665236052
2011,55113,27,220,30,207,2,10,32,217,0.0179531728303136,0.147465437788018
2011,55115,132,954,56,262,0,9,56,271,0.00927256552384863,0.206642066420664
2011,55117,394,1612,207,809,6,104,213,913,0.0116373926122314,0.233296823658269
2011,55119,54,186,47,187,3,16,50,203,0.0144043141985383,0.246305418719212
2011,55121,62,306,64,152,3,50,67,202,0.0102257770578111,0.331683168316832
2011,55123,130,528,96,224,5,16,101,240,0.0121040952188824,0.420833333333333
2011,55125,122,403,74,256,0,6,74,262,0.0156679822987681,0.282442748091603
2011,55127,424,1218,494,1450,43,190,537,1640,0.0248812829032209,0.327439024390244
2011,55129,14,281,47,153,6,20,53,173,0.0146324959824072,0.30635838150289
2011,55131,884,2637,176,683,29,57,205,740,0.00823054421693045,0.277027027027027
2011,55133,3142,8534,2433,4072,297,536,2730,4608,0.0172660576584408,0.592447916666667
2011,55135,162,1056,45,329,0,38,45,367,0.00992213690926787,0.122615803814714
2011,55137,128,848,31,214,0,20,31,234,0.0128797886393659,0.132478632478632
2011,55139,862,4296,369,913,126,267,495,1180,0.0106857924239543,0.419491525423729
2011,55141,221,1187,201,452,3,88,204,540,0.0103746397694524,0.377777777777778
2011,56001,193,398,303,941,84,106,387,1047,0.0551546120212822,0.369627507163324
2011,56003,40,119,28,301,2,27,30,328,0.0421810699588477,0.0914634146341463
2011,56005,18,434,242,1298,53,62,295,1360,0.0490567398910652,0.216911764705882
2011,56007,54,362,79,623,0,5,79,628,0.0579924277403269,0.125796178343949
2011,56009,45,400,151,393,0,0,151,393,0.0428758455160375,0.384223918575064
2011,56011,2,62,36,219,1,1,37,220,0.0459866220735786,0.168181818181818
2011,56013,100,502,207,820,0,34,207,854,0.0326839909678901,0.242388758782201
2011,56015,67,264,133,348,0,10,133,358,0.0395973896692844,0.371508379888268
2011,56017,19,63,22,249,47,59,69,308,0.0875746374751208,0.224025974025974
2011,56019,89,267,0,51,3,7,3,58,0.00938207699773536,0.0517241379310345
2011,56021,227,712,586,1980,81,368,667,2348,0.0396474283205566,0.284071550255537
2011,56023,26,291,138,374,0,0,138,374,0.0322886989553656,0.368983957219251
2011,56025,269,938,800,1930,0,18,800,1948,0.0394260155032484,0.410677618069815
2011,56027,5,117,26,92,6,18,32,110,0.0607064017660044,0.290909090909091
2011,56029,153,354,248,915,3,79,251,994,0.0506729200652529,0.25251509054326
2011,56031,13,178,10,71,0,0,10,71,0.011204039766451,0.140845070422535
2011,56033,86,493,180,498,7,52,187,550,0.0274122807017544,0.34
2011,56035,36,165,155,694,0,29,155,723,0.107111111111111,0.214384508990318
2011,56037,52,269,245,1164,27,127,272,1291,0.0477617462079171,0.210689388071263
2011,56039,144,178,195,305,10,20,205,325,0.0211726384364821,0.630769230769231
2011,56041,0,90,154,538,0,0,154,538,0.0418026418026418,0.286245353159851
2011,56043,25,75,29,131,6,6,35,137,0.0240900298927378,0.255474452554745
2011,56045,53,297,25,166,3,4,28,170,0.0341845968228434,0.164705882352941
2011,72001,NA,NA,NA,NA,NA,NA,NA,NA,NA,NA
2011,72003,NA,NA,NA,NA,NA,NA,NA,NA,NA,NA
2011,72005,NA,NA,NA,NA,NA,NA,NA,NA,NA,NA
2011,72007,NA,NA,NA,NA,NA,NA,NA,NA,NA,NA
2011,72009,NA,NA,NA,NA,NA,NA,NA,NA,NA,NA
2011,72011,NA,NA,NA,NA,NA,NA,NA,NA,NA,NA
2011,72013,NA,NA,NA,NA,NA,NA,NA,NA,NA,NA
2011,72015,NA,NA,NA,NA,NA,NA,NA,NA,NA,NA
2011,72017,NA,NA,NA,NA,NA,NA,NA,NA,NA,NA
2011,72019,NA,NA,NA,NA,NA,NA,NA,NA,NA,NA
2011,72021,NA,NA,NA,NA,NA,NA,NA,NA,NA,NA
2011,72023,NA,NA,NA,NA,NA,NA,NA,NA,NA,NA
2011,72025,NA,NA,NA,NA,NA,NA,NA,NA,NA,NA
2011,72027,NA,NA,NA,NA,NA,NA,NA,NA,NA,NA
2011,72029,NA,NA,NA,NA,NA,NA,NA,NA,NA,NA
2011,72031,NA,NA,NA,NA,NA,NA,NA,NA,NA,NA
2011,72033,NA,NA,NA,NA,NA,NA,NA,NA,NA,NA
2011,72035,NA,NA,NA,NA,NA,NA,NA,NA,NA,NA
2011,72037,NA,NA,NA,NA,NA,NA,NA,NA,NA,NA
2011,72039,NA,NA,NA,NA,NA,NA,NA,NA,NA,NA
2011,72041,NA,NA,NA,NA,NA,NA,NA,NA,NA,NA
2011,72043,NA,NA,NA,NA,NA,NA,NA,NA,NA,NA
2011,72045,NA,NA,NA,NA,NA,NA,NA,NA,NA,NA
2011,72047,NA,NA,NA,NA,NA,NA,NA,NA,NA,NA
2011,72049,NA,NA,NA,NA,NA,NA,NA,NA,NA,NA
2011,72051,NA,NA,NA,NA,NA,NA,NA,NA,NA,NA
2011,72053,NA,NA,NA,NA,NA,NA,NA,NA,NA,NA
2011,72054,NA,NA,NA,NA,NA,NA,NA,NA,NA,NA
2011,72055,NA,NA,NA,NA,NA,NA,NA,NA,NA,NA
2011,72057,NA,NA,NA,NA,NA,NA,NA,NA,NA,NA
2011,72059,NA,NA,NA,NA,NA,NA,NA,NA,NA,NA
2011,72061,NA,NA,NA,NA,NA,NA,NA,NA,NA,NA
2011,72063,NA,NA,NA,NA,NA,NA,NA,NA,NA,NA
2011,72065,NA,NA,NA,NA,NA,NA,NA,NA,NA,NA
2011,72067,NA,NA,NA,NA,NA,NA,NA,NA,NA,NA
2011,72069,NA,NA,NA,NA,NA,NA,NA,NA,NA,NA
2011,72071,NA,NA,NA,NA,NA,NA,NA,NA,NA,NA
2011,72073,NA,NA,NA,NA,NA,NA,NA,NA,NA,NA
2011,72075,NA,NA,NA,NA,NA,NA,NA,NA,NA,NA
2011,72077,NA,NA,NA,NA,NA,NA,NA,NA,NA,NA
2011,72079,NA,NA,NA,NA,NA,NA,NA,NA,NA,NA
2011,72081,NA,NA,NA,NA,NA,NA,NA,NA,NA,NA
2011,72083,NA,NA,NA,NA,NA,NA,NA,NA,NA,NA
2011,72085,NA,NA,NA,NA,NA,NA,NA,NA,NA,NA
2011,72087,NA,NA,NA,NA,NA,NA,NA,NA,NA,NA
2011,72089,NA,NA,NA,NA,NA,NA,NA,NA,NA,NA
2011,72091,NA,NA,NA,NA,NA,NA,NA,NA,NA,NA
2011,72093,NA,NA,NA,NA,NA,NA,NA,NA,NA,NA
2011,72095,NA,NA,NA,NA,NA,NA,NA,NA,NA,NA
2011,72097,NA,NA,NA,NA,NA,NA,NA,NA,NA,NA
2011,72099,NA,NA,NA,NA,NA,NA,NA,NA,NA,NA
2011,72101,NA,NA,NA,NA,NA,NA,NA,NA,NA,NA
2011,72103,NA,NA,NA,NA,NA,NA,NA,NA,NA,NA
2011,72105,NA,NA,NA,NA,NA,NA,NA,NA,NA,NA
2011,72107,NA,NA,NA,NA,NA,NA,NA,NA,NA,NA
2011,72109,NA,NA,NA,NA,NA,NA,NA,NA,NA,NA
2011,72111,NA,NA,NA,NA,NA,NA,NA,NA,NA,NA
2011,72113,NA,NA,NA,NA,NA,NA,NA,NA,NA,NA
2011,72115,NA,NA,NA,NA,NA,NA,NA,NA,NA,NA
2011,72117,NA,NA,NA,NA,NA,NA,NA,NA,NA,NA
2011,72119,NA,NA,NA,NA,NA,NA,NA,NA,NA,NA
2011,72121,NA,NA,NA,NA,NA,NA,NA,NA,NA,NA
2011,72123,NA,NA,NA,NA,NA,NA,NA,NA,NA,NA
2011,72125,NA,NA,NA,NA,NA,NA,NA,NA,NA,NA
2011,72127,NA,NA,NA,NA,NA,NA,NA,NA,NA,NA
2011,72129,NA,NA,NA,NA,NA,NA,NA,NA,NA,NA
2011,72131,NA,NA,NA,NA,NA,NA,NA,NA,NA,NA
2011,72133,NA,NA,NA,NA,NA,NA,NA,NA,NA,NA
2011,72135,NA,NA,NA,NA,NA,NA,NA,NA,NA,NA
2011,72137,NA,NA,NA,NA,NA,NA,NA,NA,NA,NA
2011,72139,NA,NA,NA,NA,NA,NA,NA,NA,NA,NA
2011,72141,NA,NA,NA,NA,NA,NA,NA,NA,NA,NA
2011,72143,NA,NA,NA,NA,NA,NA,NA,NA,NA,NA
2011,72145,NA,NA,NA,NA,NA,NA,NA,NA,NA,NA
2011,72147,NA,NA,NA,NA,NA,NA,NA,NA,NA,NA
2011,72149,NA,NA,NA,NA,NA,NA,NA,NA,NA,NA
2011,72151,NA,NA,NA,NA,NA,NA,NA,NA,NA,NA
2011,72153,NA,NA,NA,NA,NA,NA,NA,NA,NA,NA
2012,01001,117,1071,421,805,34,40,455,845,0.0240439335306169,0.538461538461538
2012,01003,805,3725,1458,4846,247,356,1705,5202,0.0408734118534466,0.327758554402153
2012,01005,46,1364,22,271,0,61,22,332,0.0174902539247708,0.0662650602409639
2012,01007,8,796,0,128,0,0,0,128,0.00824848562959144,0
2012,01009,103,1462,94,436,0,98,94,534,0.0137973800480583,0.176029962546816
2012,01011,99,343,0,140,0,0,0,140,0.0184818481848185,0
2012,01013,19,156,66,109,0,23,66,132,0.0093743342092181,0.5
2012,01015,188,1814,235,1411,26,136,261,1547,0.0197565865931063,0.168713639301875
2012,01017,93,567,76,426,7,20,83,446,0.0188815037466661,0.18609865470852
2012,01019,169,557,29,340,0,21,29,361,0.019510349673026,0.0803324099722992
2012,01021,46,568,70,418,0,12,70,430,0.0148557609258939,0.162790697674419
2012,01023,82,176,25,92,0,0,25,92,0.00956639284600187,0.271739130434783
2012,01025,55,241,62,161,48,78,110,239,0.0138840478680144,0.460251046025105
2012,01027,15,283,0,160,0,0,0,160,0.0165408870050656,0
2012,01029,11,230,0,192,0,0,0,192,0.018873488646417,0
2012,01031,175,956,551,1416,149,358,700,1774,0.0530994642162292,0.394588500563698
2012,01033,202,1237,125,746,22,58,147,804,0.021193589202868,0.182835820895522
2012,01035,0,92,0,12,0,0,0,12,0.0013437849944009,0
2012,01037,21,364,11,67,0,29,11,96,0.0117748068195756,0.114583333333333
2012,01039,123,659,73,409,0,7,73,416,0.0158718046547119,0.175480769230769
2012,01041,9,270,15,118,0,11,15,129,0.0136119025007914,0.116279069767442
2012,01043,170,1248,57,757,0,113,57,870,0.0158415120450117,0.0655172413793104
2012,01045,210,1684,633,2098,100,347,733,2445,0.07404603270745,0.299795501022495
2012,01047,41,470,44,579,7,42,51,621,0.0222508868107062,0.0821256038647343
2012,01049,85,691,162,653,0,163,162,816,0.0174206357678103,0.198529411764706
2012,01051,397,3747,212,851,75,126,287,977,0.0184027123752119,0.293756397134084
2012,01053,58,679,77,311,59,382,136,693,0.0264201296225696,0.196248196248196
2012,01055,276,2433,247,850,8,25,255,875,0.0122578204894723,0.291428571428571
2012,01057,17,254,37,278,0,23,37,301,0.0249875477336875,0.122923588039867
2012,01059,55,669,5,286,0,20,5,306,0.0145340552864064,0.0163398692810458
2012,01061,50,642,97,495,3,3,100,498,0.0265784277098788,0.200803212851406
2012,01063,9,183,0,40,0,15,0,55,0.00921890714046262,0
2012,01065,29,327,0,177,0,0,0,177,0.016916754276976,0
2012,01067,66,290,13,173,0,35,13,208,0.0172171177882626,0.0625
2012,01069,243,1350,348,1713,60,137,408,1850,0.0271201348676977,0.220540540540541
2012,01071,90,555,51,325,0,3,51,328,0.00882052385306298,0.155487804878049
2012,01073,2661,9461,3393,7447,506,1179,3899,8626,0.0196254644154792,0.452005564572224
2012,01075,13,296,0,49,0,16,0,65,0.00635634656757285,0
2012,01077,233,1892,320,898,16,45,336,943,0.0150475521797409,0.356309650053022
2012,01079,170,542,50,208,0,30,50,238,0.0102260032654464,0.210084033613445
2012,01081,714,2821,1372,3378,486,660,1858,4038,0.0502326275719653,0.46012877662209
2012,01083,525,2370,171,843,83,189,254,1032,0.0181648566349251,0.246124031007752
2012,01085,23,220,75,90,0,0,75,90,0.0121146856912101,0.833333333333333
2012,01087,28,226,90,151,0,1,90,152,0.0117692605497484,0.592105263157895
2012,01089,1054,3492,2541,6476,554,1083,3095,7559,0.0341453719221057,0.409445693874851
2012,01091,69,478,73,209,0,0,73,209,0.014863807695043,0.349282296650718
2012,01093,31,583,42,222,0,7,42,229,0.0105578607653296,0.183406113537118
2012,01095,192,1668,216,1193,0,36,216,1229,0.0199587508322913,0.175752644426363
2012,01097,497,2526,1230,4518,269,788,1499,5306,0.0198201024997385,0.282510365623822
2012,01099,60,230,40,162,11,24,51,186,0.0121101634220978,0.274193548387097
2012,01101,992,4346,1767,3706,473,747,2240,4453,0.0304233165719283,0.50303166404671
2012,01103,162,2187,293,915,23,45,316,960,0.0118660618271263,0.329166666666667
2012,01105,11,194,69,104,0,31,69,135,0.0200148257968866,0.511111111111111
2012,01107,1,269,9,139,0,0,9,139,0.0103808812546677,0.0647482014388489
2012,01109,45,465,220,623,59,108,279,731,0.0383626344791393,0.381668946648427
2012,01111,17,259,44,440,0,21,44,461,0.0297919090086597,0.0954446854663774
2012,01113,51,585,329,1864,107,302,436,2166,0.0619777955820076,0.20129270544783
2012,01115,460,2484,67,696,0,149,67,845,0.0148011911017691,0.0792899408284024
2012,01117,2185,6028,777,2023,231,436,1008,2459,0.0188608332821992,0.409922732818219
2012,01119,11,103,0,85,0,29,0,114,0.013558515699334,0
2012,01121,230,2488,102,1232,71,148,173,1380,0.0247214359929777,0.12536231884058
2012,01123,117,928,22,552,0,38,22,590,0.0203336090432865,0.0372881355932203
2012,01125,865,2808,757,1902,225,310,982,2212,0.0193241779361918,0.443942133815552
2012,01127,145,1197,53,499,18,42,71,541,0.0116547103556733,0.131238447319778
2012,01129,7,224,26,143,0,0,26,143,0.0123691722169363,0.181818181818182
2012,01131,7,198,0,14,0,9,0,23,0.00302910575530093,0
2012,01133,142,700,5,264,0,0,5,264,0.0153524075366364,0.0189393939393939
2012,02013,17,61,38,461,6,23,44,484,0.199258954302182,0.0909090909090909
2012,02016,7,118,31,415,5,60,36,475,0.11780753968254,0.0757894736842105
2012,02020,1048,3604,2686,7513,686,1547,3372,9060,0.0494277078855198,0.372185430463576
2012,02050,50,283,132,252,0,9,132,261,0.0292896420154865,0.505747126436782
2012,02060,9,15,3,15,0,5,3,20,0.0322061191626409,0.15
2012,02068,15,30,36,69,9,9,45,78,0.0564399421128799,0.576923076923077
2012,02070,56,123,26,72,0,2,26,74,0.0275810659709281,0.351351351351351
2012,02090,215,1157,947,3269,219,678,1166,3947,0.0668122418579457,0.295414238662275
2012,02100,14,21,2,19,0,0,2,19,0.0103655210038189,0.105263157894737
2012,02105,13,57,14,39,0,2,14,41,0.0251379521765788,0.341463414634146
2012,02110,128,389,426,1016,15,55,441,1071,0.0501451446764678,0.411764705882353
2012,02122,177,822,300,1213,36,83,336,1296,0.0342984174032711,0.259259259259259
2012,02130,24,235,82,335,0,6,82,341,0.0375220070422535,0.240469208211144
2012,02150,29,409,184,448,37,63,221,511,0.0623855451104871,0.432485322896282
2012,02164,2,23,16,39,0,0,16,39,0.0461538461538462,0.41025641025641
2012,02170,445,1932,412,1707,29,99,441,1806,0.032205717138934,0.244186046511628
2012,02180,12,127,25,98,0,34,25,132,0.0254580520732883,0.189393939393939
2012,02185,131,438,88,284,20,55,108,339,0.0573507020808662,0.31858407079646
2012,02188,34,156,51,113,0,0,51,113,0.0289966641005902,0.451327433628319
2012,02195,21,76,27,68,0,12,27,80,0.029585798816568,0.3375
2012,02198,39,119,34,122,0,5,34,127,0.0338847385272145,0.267716535433071
2012,02220,2,108,106,268,61,93,167,361,0.0597682119205298,0.462603878116344
2012,02230,1,7,16,32,2,5,18,37,0.0472541507024266,0.486486486486487
2012,02240,19,159,139,351,0,0,139,351,0.0783657066309444,0.396011396011396
2012,02261,20,198,65,182,11,71,76,253,0.039158025073518,0.300395256916996
2012,02270,10,90,58,78,0,0,58,78,0.0232974910394265,0.743589743589744
2012,02275,14,43,5,37,1,3,6,40,0.0226372382569327,0.15
2012,02282,2,6,0,7,0,0,0,7,0.0162790697674419,0
2012,02290,12,161,32,65,0,0,32,65,0.0183150183150183,0.492307692307692
2012,04001,198,987,144,708,56,75,200,783,0.0188474870017331,0.255427841634738
2012,04003,367,2853,1522,4333,363,849,1885,5182,0.0583525702381623,0.363759166345041
2012,04005,660,2084,1100,2773,31,281,1131,3054,0.0390876977422823,0.370333988212181
2012,04007,148,1410,312,854,8,64,320,918,0.0239280594291672,0.348583877995643
2012,04009,61,917,63,569,0,53,63,622,0.0280420179432848,0.101286173633441
2012,04011,34,315,22,122,0,8,22,130,0.0243126987095568,0.169230769230769
2012,04012,10,349,125,674,3,39,128,713,0.0449247054375906,0.179523141654979
2012,04013,5540,21238,30378,82574,5965,14873,36343,97447,0.0397516029628808,0.372951450532084
2012,04015,331,3176,1184,8910,18,483,1202,9393,0.0643956013821094,0.127967635473225
2012,04017,284,2167,287,1216,43,132,330,1348,0.0206640708832817,0.244807121661721
2012,04019,1917,8303,7147,19009,1832,4433,8979,23442,0.0360869893179925,0.383030458152035
2012,04021,2003,14863,2179,11477,524,3116,2703,14593,0.0600050987680718,0.185225793188515
2012,04023,163,747,94,314,75,304,169,618,0.0216674847486151,0.273462783171521
2012,04025,969,4816,2097,6046,184,403,2281,6449,0.0412664691541302,0.353698247790355
2012,04027,234,2050,884,4456,209,1171,1093,5627,0.0470398421695006,0.194242047272081
2012,05001,41,348,43,290,25,112,68,402,0.0305424707491263,0.169154228855721
2012,05003,24,142,4,108,0,0,4,108,0.00732749847343782,0.037037037037037
2012,05005,81,528,215,998,15,52,230,1050,0.0334001336005344,0.219047619047619
2012,05007,596,2969,2371,5481,812,1112,3183,6593,0.04649899850481,0.48278477172759
2012,05009,74,424,155,859,0,29,155,888,0.0346604215456674,0.17454954954955
2012,05011,94,152,0,98,0,19,0,117,0.0150714929795182,0
2012,05013,0,151,0,23,0,0,0,23,0.0060351613749672,0
2012,05015,65,480,129,647,7,12,136,659,0.0343175545487684,0.206373292867982
2012,05017,5,268,7,69,0,0,7,69,0.00855336556340647,0.101449275362319
2012,05019,44,307,49,336,0,26,49,362,0.0269565864919205,0.135359116022099
2012,05021,3,179,29,244,0,0,29,244,0.0216927453769559,0.118852459016393
2012,05023,166,827,59,574,11,22,70,596,0.0313998208735051,0.11744966442953
2012,05025,10,95,0,27,0,1,0,28,0.004778972520908,0
2012,05027,55,209,57,219,14,22,71,241,0.0156860192658162,0.294605809128631
2012,05029,101,631,99,291,0,0,99,291,0.0203539204028817,0.34020618556701
2012,05031,210,1960,504,1051,67,126,571,1177,0.0194738583719391,0.485131690739167
2012,05033,57,1292,115,1191,0,85,115,1276,0.0316987131713619,0.0901253918495298
2012,05035,82,729,92,1003,5,40,97,1043,0.0333578533277897,0.0930009587727709
2012,05037,55,342,9,123,0,10,9,133,0.0110593713620489,0.0676691729323308
2012,05039,41,217,0,87,0,0,0,87,0.0157866086009799,0
2012,05041,13,221,0,53,23,28,23,81,0.00939675174013921,0.283950617283951
2012,05043,110,631,35,93,0,24,35,117,0.00992029845684246,0.299145299145299
2012,05045,358,2324,496,1505,29,74,525,1579,0.0231698190729138,0.332488917036099
2012,05047,68,569,53,198,3,17,56,215,0.0176403019363308,0.26046511627907
2012,05049,9,233,0,160,0,3,0,163,0.0182878940872882,0
2012,05051,316,1722,420,1796,69,259,489,2055,0.0300021899408716,0.237956204379562
2012,05053,124,436,4,80,0,48,4,128,0.0105837605424177,0.03125
2012,05055,83,749,52,552,0,43,52,595,0.0213682887412462,0.0873949579831933
2012,05057,44,389,5,273,0,13,5,286,0.0195649199616911,0.0174825174825175
2012,05059,50,916,71,168,0,0,71,168,0.00744153082919915,0.422619047619048
2012,05061,29,238,7,137,0,42,7,179,0.0198513918154597,0.0391061452513966
2012,05063,100,898,21,434,0,25,21,459,0.0186486815910291,0.0457516339869281
2012,05065,36,532,3,207,0,0,3,207,0.0203659976387249,0.0144927536231884
2012,05067,97,1397,40,266,0,2,40,268,0.0212647782274062,0.149253731343284
2012,05069,100,1494,116,610,49,93,165,703,0.0140084489080185,0.234708392603129
2012,05071,16,392,18,239,0,55,18,294,0.0178322314550858,0.0612244897959184
2012,05073,3,148,0,101,0,0,0,101,0.0195812330360605,0
2012,05075,1,186,4,101,0,8,4,109,0.00929320487680109,0.036697247706422
2012,05077,0,418,5,150,17,39,22,189,0.0266234680940978,0.116402116402116
2012,05079,4,870,0,171,0,0,0,171,0.0174205378973105,0
2012,05081,62,162,18,311,4,42,22,353,0.0385876694359423,0.0623229461756374
2012,05083,2,358,59,307,0,4,59,311,0.0205348299768901,0.189710610932476
2012,05085,356,1539,219,820,25,158,244,978,0.0222353583121135,0.249488752556237
2012,05087,21,209,32,220,0,0,32,220,0.0206437083607019,0.145454545454545
2012,05089,35,408,27,307,0,4,27,311,0.0245055551178,0.0868167202572347
2012,05091,28,831,108,1129,0,70,108,1199,0.0416276082352533,0.0900750625521268
2012,05093,41,615,147,864,89,104,236,968,0.0332748960159499,0.243801652892562
2012,05095,6,124,0,149,0,0,0,149,0.0264653641207815,0
2012,05097,3,326,21,140,0,0,21,140,0.0207131232430833,0.15
2012,05099,18,168,12,61,0,2,12,63,0.0101826410214967,0.19047619047619
2012,05101,15,143,28,97,5,9,33,106,0.0177257525083612,0.311320754716981
2012,05103,30,386,128,243,16,16,144,259,0.0145464757090705,0.555984555984556
2012,05105,79,387,4,31,0,14,4,45,0.00620432924307183,0.0888888888888889
2012,05107,0,208,42,244,0,3,42,247,0.0181404230317274,0.17004048582996
2012,05109,37,359,31,81,0,3,31,84,0.011124354390147,0.369047619047619
2012,05111,64,726,2,232,0,15,2,247,0.0149262750785593,0.00809716599190283
2012,05113,20,163,21,199,15,15,36,214,0.0149776035834267,0.168224299065421
2012,05115,183,1241,103,613,19,67,122,680,0.0176234287935726,0.179411764705882
2012,05117,9,131,0,41,0,0,0,41,0.00661503710874476,0
2012,05119,1661,5962,2712,6056,475,1139,3187,7195,0.0281766809083896,0.442946490618485
2012,05121,22,173,28,343,0,6,28,349,0.0283118358075769,0.0802292263610315
2012,05123,32,808,74,697,0,71,74,768,0.0404700426832481,0.0963541666666667
2012,05125,527,3156,592,1409,4,45,596,1454,0.01980278927871,0.40990371389271
2012,05127,0,128,54,218,0,20,54,238,0.0322362183394284,0.226890756302521
2012,05129,0,140,0,3,0,0,0,3,0.000506756756756757,0
2012,05131,136,1343,460,2308,52,118,512,2426,0.0296272776122319,0.211046990931575
2012,05133,21,165,13,210,63,141,76,351,0.0336335760827903,0.216524216524217
2012,05135,38,404,20,218,0,0,20,218,0.0175114467025464,0.0917431192660551
2012,05137,114,308,0,140,39,40,39,180,0.0201207243460765,0.216666666666667
2012,05139,159,439,68,559,3,7,71,566,0.0200780418588152,0.125441696113074
2012,05141,34,430,15,189,16,22,31,211,0.0170051579626048,0.146919431279621
2012,05143,1156,4279,1355,3808,295,574,1650,4382,0.0357434174035042,0.376540392514833
2012,05145,152,1503,183,1080,4,153,187,1233,0.0252173023826567,0.151662611516626
2012,05147,0,119,0,66,0,10,0,76,0.0150346191889219,0
2012,05149,20,452,0,123,14,14,14,137,0.00948162502595335,0.102189781021898
2012,06001,17035,34251,8161,12789,4833,8647,12994,21436,0.0209092948624157,0.60617652547117
2012,06003,24,38,15,77,3,3,18,80,0.0998751560549313,0.225
2012,06005,234,1525,49,255,7,47,56,302,0.0104599612080909,0.185430463576159
2012,06007,783,3688,365,1372,147,456,512,1828,0.0129788986396297,0.280087527352298
2012,06009,341,1379,56,321,18,18,74,339,0.0100420641033237,0.218289085545723
2012,06011,87,355,77,148,76,162,153,310,0.023780300705738,0.493548387096774
2012,06013,11667,25094,4120,6869,2209,4715,6329,11584,0.0164482605368119,0.546357044198895
2012,06015,125,1651,119,344,11,42,130,386,0.0195799939129553,0.336787564766839
2012,06017,1267,4139,502,1378,193,300,695,1678,0.0133008869900204,0.414183551847437
2012,06019,2177,11417,946,4028,591,2486,1537,6514,0.011939062030337,0.23595333128646
2012,06021,137,1034,46,248,3,23,49,271,0.0153986021933064,0.180811808118081
2012,06023,472,2185,602,1631,7,90,609,1721,0.0190684069404126,0.353864032539221
2012,06025,319,3117,443,1377,107,512,550,1889,0.0182443330532456,0.291159343568025
2012,06027,109,677,31,195,0,6,31,201,0.0150787696924231,0.154228855721393
2012,06029,2147,20792,1346,5811,386,2144,1732,7955,0.0161728081321474,0.217724701445632
2012,06031,430,6481,369,1393,81,512,450,1905,0.0206849374565671,0.236220472440945
2012,06033,498,1715,234,861,0,141,234,1002,0.021826736663254,0.233532934131737
2012,06035,235,4536,101,528,0,67,101,595,0.0239764667956157,0.169747899159664
2012,06037,25813,68473,30970,55959,18971,42265,49941,98224,0.0153947281394202,0.508439892490634
2012,06039,556,5572,67,597,16,283,83,880,0.00953030746071456,0.0943181818181818
2012,06041,3642,8355,1426,2563,530,842,1956,3405,0.0183129497563652,0.574449339207048
2012,06043,132,741,76,317,6,19,82,336,0.024127531236536,0.244047619047619
2012,06045,339,1478,195,797,31,110,226,907,0.0148944905164628,0.249173098125689
2012,06047,599,5474,213,875,29,303,242,1178,0.00810167673071897,0.205432937181664
2012,06049,3,216,103,269,0,0,103,269,0.0393045002922268,0.382899628252788
2012,06051,370,959,37,170,42,119,79,289,0.0298646274671902,0.273356401384083
2012,06053,1771,7204,2484,4997,1019,2042,3503,7039,0.0272258558603858,0.49765591703367
2012,06055,1218,3076,388,844,133,357,521,1201,0.0129157839267855,0.433805162364696
2012,06057,1060,2741,340,762,131,299,471,1061,0.0145591766723842,0.443920829406221
2012,06059,19816,45047,11127,20717,6458,13852,17585,34569,0.0174650272542132,0.508692759408719
2012,06061,3334,10932,1587,3122,256,808,1843,3930,0.0165214210944496,0.468956743002545
2012,06063,129,412,15,190,0,0,15,190,0.0126759623724064,0.0789473684210526
2012,06065,12230,55656,5243,17457,2193,7461,7436,24918,0.018518036841366,0.298418813708965
2012,06067,7689,28959,4191,10368,1589,4639,5780,15007,0.0163684990107131,0.385153594989005
2012,06069,334,2033,35,170,36,146,71,316,0.00922951106957182,0.224683544303797
2012,06071,8684,46120,3215,12816,1663,6016,4878,18832,0.0154852375493987,0.259027187765506
2012,06073,11003,27380,17807,36879,7640,18446,25447,55325,0.0275108601389143,0.459954812471758
2012,06075,13201,19862,9168,11617,4773,8115,13941,19732,0.0315823675251569,0.706517332252179
2012,06077,3099,15901,783,3167,673,2358,1456,5525,0.0133242655978315,0.263529411764706
2012,06079,2454,7922,770,1796,254,610,1024,2406,0.0134660913074869,0.425602660016625
2012,06081,11177,21269,2980,4561,2480,4568,5460,9129,0.0180277495823344,0.598093986197831
2012,06083,2222,6447,2024,4141,642,2224,2666,6365,0.0243553392337156,0.41885310290652
2012,06085,13546,26002,10680,14727,11767,17265,22447,31992,0.0266479640029253,0.70164416104026
2012,06087,2070,6033,1416,2439,437,698,1853,3137,0.0185230017064544,0.590691743704176
2012,06089,966,3831,514,1690,126,461,640,2151,0.0176603885121266,0.297536029753603
2012,06091,62,62,0,20,0,0,0,20,0.00809061488673139,0
2012,06093,223,870,179,605,16,53,195,658,0.0204328789243238,0.296352583586626
2012,06095,2676,10895,1062,3010,716,1860,1778,4870,0.0179030953606352,0.365092402464066
2012,06097,2939,7636,1638,3391,456,977,2094,4368,0.0131846239756109,0.479395604395604
2012,06099,1821,9226,504,2334,154,1214,658,3548,0.0112961972440845,0.185456595264938
2012,06101,255,2636,60,486,60,383,120,869,0.0146328321013016,0.138089758342923
2012,06103,162,1976,122,501,0,65,122,566,0.0135096429253389,0.215547703180212
2012,06105,93,447,18,102,0,54,18,156,0.0151780502043199,0.115384615384615
2012,06107,939,5816,574,1949,141,974,715,2923,0.0116444904788463,0.244611700307903
2012,06109,286,3256,75,351,0,22,75,373,0.00904439756552945,0.201072386058981
2012,06111,5704,14284,2550,6839,1046,2804,3596,9643,0.0181870990982835,0.372912993881572
2012,06113,1945,5647,766,1568,995,1495,1761,3063,0.0263062970215397,0.574926542605289
2012,06115,294,3459,203,773,73,264,276,1037,0.0236812057547385,0.266152362584378
2012,08001,3061,16589,1510,5558,243,1557,1753,7115,0.025813777990625,0.246380885453268
2012,08003,53,457,14,156,0,0,14,156,0.016553480475382,0.0897435897435897
2012,08005,7153,21411,4668,11352,873,2347,5541,13699,0.0361649665251642,0.404482078983867
2012,08007,42,90,170,403,0,7,170,410,0.0473495784732648,0.414634146341463
2012,08009,17,43,2,56,0,0,2,56,0.0202239075478512,0.0357142857142857
2012,08011,23,438,5,101,10,13,15,114,0.0242089615629645,0.131578947368421
2012,08013,2824,6176,4610,6921,1329,1669,5939,8590,0.0451119922275031,0.691385331781141
2012,08014,1161,3254,835,1214,56,79,891,1293,0.0349837662337662,0.689095127610209
2012,08015,348,805,118,441,5,20,123,461,0.0334275977086506,0.266811279826464
2012,08017,26,67,0,1,0,0,0,1,0.000677506775067751,0
2012,08019,60,240,35,64,0,0,35,64,0.00917299699011036,0.546875
2012,08021,25,103,32,120,13,16,45,136,0.0261387660964828,0.330882352941176
2012,08023,0,54,11,15,14,14,25,29,0.0115445859872611,0.862068965517241
2012,08025,18,360,0,61,11,154,11,215,0.0502453844356158,0.0511627906976744
2012,08027,15,80,43,76,19,19,62,95,0.0283751493428913,0.652631578947368
2012,08029,116,726,171,564,0,117,171,681,0.0308927599346761,0.251101321585903
2012,08031,9402,26156,9742,15241,1453,3035,11195,18276,0.0441916810538686,0.612551980739768
2012,08033,7,63,3,50,0,0,3,50,0.0364963503649635,0.06
2012,08035,3966,8146,3941,7073,412,536,4353,7609,0.0412682572310296,0.572085688001051
2012,08037,431,918,525,765,26,200,551,965,0.0276710443310202,0.570984455958549
2012,08039,170,723,185,510,9,41,194,551,0.0347677940434124,0.352087114337568
2012,08041,1510,5670,7901,20897,1236,4734,9137,25631,0.0651869824411483,0.356482384612383
2012,08043,233,1237,85,1019,14,475,99,1494,0.0413278008298755,0.0662650602409639
2012,08045,280,1422,337,1153,2,142,339,1295,0.0354648774476243,0.261776061776062
2012,08047,19,196,52,171,0,0,52,171,0.0410761470093682,0.304093567251462
2012,08049,26,86,80,182,0,30,80,212,0.0196879643387816,0.377358490566038
2012,08051,107,353,194,358,12,41,206,399,0.0411509900990099,0.516290726817043
2012,08053,8,53,36,36,0,0,36,36,0.0520984081041968,1
2012,08055,31,320,39,172,3,97,42,269,0.0518804243008679,0.156133828996283
2012,08057,4,13,10,59,0,0,10,59,0.055765595463138,0.169491525423729
2012,08059,5718,16710,4422,9345,748,1402,5170,10747,0.0288904062452956,0.481064483111566
2012,08061,20,33,3,11,0,0,3,11,0.0125284738041002,0.272727272727273
2012,08063,38,314,2,200,0,30,2,230,0.0404146898611843,0.00869565217391304
2012,08065,103,164,67,72,0,0,67,72,0.0148637489677952,0.930555555555556
2012,08067,218,803,801,1740,25,37,826,1777,0.0509169054441261,0.464828362408554
2012,08069,1806,4640,4086,7612,397,768,4483,8380,0.04321614778066,0.534964200477327
2012,08071,48,189,55,223,0,3,55,226,0.0208314130334593,0.243362831858407
2012,08073,16,225,1,51,0,49,1,100,0.025,0.01
2012,08075,72,725,50,174,18,99,68,273,0.0183074034334764,0.249084249084249
2012,08077,732,2415,666,3456,74,216,740,3672,0.0376352902591013,0.201525054466231
2012,08079,3,21,3,3,0,0,3,3,0.00482315112540193,1
2012,08081,15,303,16,94,0,27,16,121,0.0138443935926773,0.132231404958678
2012,08083,146,453,200,571,0,0,200,571,0.0322416713721062,0.350262697022767
2012,08085,248,907,323,968,9,127,332,1095,0.0386148041048066,0.303196347031963
2012,08087,139,866,75,234,2,96,77,330,0.0183966997435612,0.233333333333333
2012,08089,53,409,36,201,0,25,36,226,0.0179664520232133,0.15929203539823
2012,08091,121,182,99,258,0,0,99,258,0.0720469142697571,0.383720930232558
2012,08093,112,507,194,630,9,9,203,639,0.051968119713728,0.317683881064163
2012,08095,8,129,4,52,15,56,19,108,0.0384341637010676,0.175925925925926
2012,08097,174,385,308,635,4,54,312,689,0.0525994350713795,0.452830188679245
2012,08099,73,388,0,158,0,22,0,180,0.0227703984819734,0
2012,08101,439,2561,515,1826,35,231,550,2057,0.019533549845213,0.267379679144385
2012,08103,7,110,34,237,17,26,51,263,0.0597727272727273,0.193916349809886
2012,08105,70,407,52,281,0,2,52,283,0.0355751099937146,0.183745583038869
2012,08107,190,386,141,423,21,55,162,478,0.0291197075845263,0.338912133891213
2012,08109,42,204,28,67,0,35,28,102,0.023943661971831,0.274509803921569
2012,08111,0,1,5,34,0,0,5,34,0.0586206896551724,0.147058823529412
2012,08113,36,94,290,470,41,91,331,561,0.102803738317757,0.590017825311943
2012,08115,5,74,9,58,0,0,9,58,0.0342384887839433,0.155172413793103
2012,08117,486,837,654,1111,0,121,654,1232,0.0605673270733986,0.530844155844156
2012,08119,101,506,126,463,18,45,144,508,0.0295537843969981,0.283464566929134
2012,08121,21,203,2,75,0,15,2,90,0.0266666666666667,0.0222222222222222
2012,08123,1608,5917,1157,4561,84,461,1241,5022,0.0322810806641341,0.247112704101951
2012,08125,34,453,50,179,0,138,50,317,0.0472499627366225,0.157728706624606
2012,09001,1952,4704,8283,13180,2493,4975,10776,18155,0.0293115223101774,0.593555494354172
2012,09003,3364,9982,5542,9366,1150,3502,6692,12868,0.0210614182249683,0.520049735778676
2012,09005,814,2629,618,1278,89,244,707,1522,0.0112110430984318,0.464520367936925
2012,09007,1180,3210,1020,1608,250,496,1270,2104,0.0178512340598831,0.60361216730038
2012,09009,2903,8845,4608,8514,1551,3091,6159,11605,0.0198747743643669,0.530719517449375
2012,09011,820,4244,1796,4811,282,825,2078,5636,0.0300519350332192,0.368701206529454
2012,09013,707,3517,772,1522,309,392,1081,1914,0.0198003413851963,0.56478578892372
2012,09015,578,2283,271,1158,118,222,389,1380,0.0174134689396712,0.281884057971015
2012,10001,377,1689,636,2737,157,521,793,3258,0.0311847923885369,0.243400859422959
2012,10003,303,1634,5810,12109,832,1567,6642,13676,0.0384092568668202,0.485668324071366
2012,10005,251,1240,2015,5025,39,713,2054,5738,0.0401829170080604,0.357964447542698
2012,11001,0,0,19197,27823,4160,5376,23357,33199,0.0795315165104736,0.70354528750866
2012,12001,1497,4789,2251,3365,914,1417,3165,4782,0.0328386702467364,0.661856963613551
2012,12003,19,1145,0,292,0,0,0,292,0.0168144650466429,0
2012,12005,350,2553,1091,4563,359,911,1450,5474,0.0473742513933603,0.264888564121301
2012,12007,117,2028,8,54,0,0,8,54,0.00266088499063763,0.148148148148148
2012,12009,1552,7165,2636,9977,582,1573,3218,11550,0.0293489861259338,0.278614718614719
2012,12011,9291,31151,8025,21480,4717,13904,12742,35384,0.0289880005865761,0.360106262717612
2012,12013,50,861,2,135,0,0,2,135,0.0130890052356021,0.0148148148148148
2012,12015,743,3601,1420,5118,187,516,1607,5634,0.0438061767175691,0.28523251686191
2012,12017,297,2538,336,2652,34,200,370,2852,0.0258274847181345,0.129733520336606
2012,12019,705,4352,849,2544,257,836,1106,3380,0.0270779090727018,0.327218934911243
2012,12021,1065,5192,3467,7546,758,2077,4225,9623,0.0403856000134297,0.439052270601683
2012,12023,326,2458,244,1302,7,91,251,1393,0.0305448963929394,0.180186647523331
2012,12027,11,1168,33,418,27,310,60,728,0.031624674196351,0.0824175824175824
2012,12029,33,462,0,130,16,16,16,146,0.0128306529572019,0.10958904109589
2012,12031,3259,11788,4535,15087,1126,2983,5661,18070,0.0316103063243354,0.313281682346431
2012,12033,815,4242,1792,7373,232,630,2024,8003,0.0408601930941525,0.252905160564788
2012,12035,563,2312,689,2647,9,238,698,2885,0.0407336288933443,0.241941074523397
2012,12037,27,972,14,95,38,38,52,133,0.0150981950278125,0.390977443609023
2012,12039,75,1385,69,275,81,120,150,395,0.0124672537322855,0.379746835443038
2012,12041,31,567,27,211,0,26,27,237,0.0209883103081828,0.113924050632911
2012,12043,46,465,85,245,0,0,85,245,0.0259836674090572,0.346938775510204
2012,12045,40,929,53,217,0,11,53,228,0.0192097059566939,0.232456140350877
2012,12047,29,937,7,297,0,17,7,314,0.0317267858947156,0.0222929936305732
2012,12049,69,666,49,689,15,99,64,788,0.0470560133763287,0.0812182741116751
2012,12051,327,1427,77,346,16,369,93,715,0.030457933972311,0.13006993006993
2012,12053,455,3889,502,3643,186,392,688,4035,0.0316977752639517,0.170508054522924
2012,12055,350,1937,289,2086,30,262,319,2348,0.0316570041795874,0.135860306643952
2012,12057,6105,19297,7999,19958,2839,7006,10838,26964,0.0330667294547006,0.401943331849874
2012,12059,91,774,78,392,0,16,78,408,0.0290102389078498,0.191176470588235
2012,12061,554,2609,742,3003,191,375,933,3378,0.0327802037845706,0.276198934280639
2012,12063,123,2192,82,612,26,75,108,687,0.019492126542772,0.157205240174672
2012,12065,55,707,0,143,0,22,0,165,0.0154133582438113,0
2012,12067,23,424,0,67,0,15,0,82,0.0144061841180604,0
2012,12069,1516,6928,1213,6806,283,709,1496,7515,0.0347204575800557,0.199068529607452
2012,12071,1762,10233,5412,18344,641,2692,6053,21036,0.0462885132488657,0.287744818406541
2012,12073,1652,4798,1803,3802,479,730,2282,4532,0.0284341159198424,0.503530450132392
2012,12075,145,1728,9,464,0,70,9,534,0.0185146661119201,0.0168539325842697
2012,12077,59,596,0,132,19,19,19,151,0.0268587691213091,0.125827814569536
2012,12079,77,942,3,136,0,0,3,136,0.0102983492351961,0.0220588235294118
2012,12081,1637,6503,2619,8736,364,1587,2983,10323,0.0438656876242925,0.288966385740579
2012,12083,1353,7128,1315,6564,49,652,1364,7216,0.0296062888746656,0.189024390243902
2012,12085,1134,4124,1341,3767,160,525,1501,4292,0.0385700677582271,0.349720410065238
2012,12086,4754,18421,7973,17629,8511,25573,16484,43202,0.0251493610786248,0.38155640942549
2012,12087,397,1768,885,2472,120,378,1005,2850,0.0500052637119697,0.352631578947368
2012,12089,179,1344,450,1516,39,128,489,1644,0.0318462700734169,0.297445255474453
2012,12091,642,2656,1692,5259,359,938,2051,6197,0.0502310124017184,0.330966596740358
2012,12093,54,705,79,530,9,111,88,641,0.0243116134415535,0.137285491419657
2012,12095,6428,22103,5532,17431,3241,8853,8773,26284,0.0356767644958913,0.333777202861056
2012,12097,1063,6349,693,4024,409,1899,1102,5923,0.0339849555034054,0.186054364342394
2012,12099,5771,17005,10348,24163,2772,8423,13120,32586,0.0343523280011638,0.402626894985577
2012,12101,2356,10893,1965,9150,283,1470,2248,10620,0.0317525810184147,0.211676082862524
2012,12103,4209,13540,5533,17445,1678,4609,7211,22054,0.0320732271303377,0.326970164142559
2012,12105,2686,10863,2149,10104,608,2287,2757,12391,0.0303046607692703,0.222500201759341
2012,12107,141,1503,113,571,7,104,120,675,0.0131730450225405,0.177777777777778
2012,12109,1520,4672,2656,4921,320,818,2976,5739,0.0432371753821582,0.518557239937271
2012,12111,1380,7051,1537,5429,105,754,1642,6183,0.0317138724469384,0.265566876920589
2012,12113,723,3740,1869,5158,142,646,2011,5804,0.0559691417550627,0.346485182632667
2012,12115,1717,7174,3504,10418,500,1746,4004,12164,0.0407806114409663,0.32916803682999
2012,12117,2901,10202,1939,5418,744,1628,2683,7046,0.0247649508813244,0.380783423218848
2012,12119,367,2595,1456,4499,71,600,1527,5099,0.0619321770393043,0.299470484408708
2012,12121,144,1437,93,417,0,31,93,448,0.0153151921236155,0.207589285714286
2012,12123,49,1261,141,260,0,0,141,260,0.016112040651918,0.542307692307692
2012,12125,30,1171,12,152,5,5,17,157,0.014427494945782,0.10828025477707
2012,12127,2063,8620,2104,10690,275,934,2379,11624,0.0325447266007783,0.204662766689608
2012,12129,77,2219,65,377,0,33,65,410,0.0192968419070928,0.158536585365854
2012,12131,338,2064,732,1841,19,50,751,1891,0.0472549166604193,0.397144368059228
2012,12133,91,1194,45,314,0,10,45,324,0.0185428947519029,0.138888888888889
2012,13001,165,291,0,45,0,12,0,57,0.00464964515865894,0
2012,13003,1,105,0,114,0,0,0,114,0.0221833041447752,0
2012,13005,2,432,11,90,0,0,11,90,0.012332145793368,0.122222222222222
2012,13007,0,7,0,1,0,0,0,1,0.000445632798573975,0
2012,13009,101,1044,194,428,0,116,194,544,0.0193168098856615,0.356617647058824
2012,13011,112,481,20,83,0,14,20,97,0.00800726432227175,0.206185567010309
2012,13013,442,2339,61,500,0,37,61,537,0.0121948450096514,0.113594040968343
2012,13015,352,2086,125,950,74,167,199,1117,0.0172182572102416,0.178155774395703
2012,13017,140,515,52,243,0,26,52,269,0.0239451664589639,0.193308550185874
2012,13019,28,478,13,115,0,40,13,155,0.0121721375844197,0.0838709677419355
2012,13021,763,3370,673,1670,176,331,849,2001,0.020130987233272,0.424287856071964
2012,13023,103,309,0,37,0,12,0,49,0.00622459349593496,0
2012,13025,2,361,1,222,0,0,1,222,0.0185851820845542,0.0045045045045045
2012,13027,97,612,0,233,0,29,0,262,0.0245134730538922,0
2012,13029,237,747,574,1070,180,223,754,1293,0.0669289300688441,0.583139984532096
2012,13031,327,1425,106,597,19,81,125,678,0.0186627762944204,0.184365781710914
2012,13033,9,532,38,168,17,17,55,185,0.0128063131662744,0.297297297297297
2012,13035,59,1639,13,188,0,7,13,195,0.0122195763880185,0.0666666666666667
2012,13037,47,669,7,89,0,0,7,89,0.020004495392223,0.0786516853932584
2012,13039,92,675,349,1694,13,133,362,1827,0.0599488121800761,0.198139025725233
2012,13043,36,442,0,90,0,0,0,90,0.0128608173763933,0
2012,13045,567,2858,268,1039,32,341,300,1380,0.0201887206495501,0.217391304347826
2012,13047,89,897,313,1297,0,23,313,1320,0.030660596487968,0.237121212121212
2012,13049,8,928,26,507,0,0,26,507,0.0554219501530389,0.0512820512820513
2012,13051,1040,3601,1944,4746,267,1027,2211,5773,0.0336786960224952,0.382989780010393
2012,13053,14,234,766,1641,133,480,899,2121,0.386409182000364,0.423856671381424
2012,13055,7,586,63,207,0,12,63,219,0.0122203002064617,0.287671232876712
2012,13057,2436,6254,1207,2438,242,456,1449,2894,0.0207226431036705,0.500691085003455
2012,13059,794,2645,961,1405,267,370,1228,1775,0.0290326801661814,0.691830985915493
2012,13061,0,93,36,100,0,4,36,104,0.048643592142189,0.346153846153846
2012,13063,1502,9980,472,4654,134,615,606,5269,0.0333164717040784,0.1150123363067
2012,13065,2,124,0,30,0,0,0,30,0.00693802035152636,0
2012,13067,7864,19908,6530,14435,1551,2868,8081,17303,0.0382806346846488,0.467028838929665
2012,13069,90,727,23,185,0,117,23,302,0.0112051053725141,0.076158940397351
2012,13071,193,1035,33,597,0,93,33,690,0.0240728465268813,0.0478260869565217
2012,13073,872,3337,1183,2666,128,385,1311,3051,0.0378578253154819,0.429695181907571
2012,13075,28,507,53,157,0,91,53,248,0.0225086222544926,0.213709677419355
2012,13077,876,3227,576,2194,27,119,603,2313,0.02788729337722,0.260700389105058
2012,13079,60,363,0,4,0,15,0,19,0.00219831077172278,0
2012,13081,15,448,30,145,0,0,30,145,0.00948828687344588,0.206896551724138
2012,13083,0,126,85,288,0,0,85,288,0.0262295081967213,0.295138888888889
2012,13085,196,751,47,138,0,0,47,138,0.0090007826767545,0.340579710144928
2012,13087,67,660,5,297,7,22,12,319,0.0175990290190886,0.0376175548589342
2012,13089,9307,22935,5428,11902,1433,3389,6861,15291,0.0333550013960631,0.448695310967236
2012,13091,1,372,28,103,0,11,28,114,0.00794148380355277,0.245614035087719
2012,13093,0,236,0,11,0,0,0,11,0.00110220440881764,0
2012,13095,347,2139,134,962,47,150,181,1112,0.0191575501765871,0.162769784172662
2012,13097,1014,5374,530,2166,43,292,573,2458,0.0293899610206375,0.233116354759967
2012,13099,15,157,9,37,0,0,9,37,0.00518062167460095,0.243243243243243
2012,13101,6,211,0,8,0,6,0,14,0.00584063412599082,0
2012,13103,186,1242,161,842,0,72,161,914,0.0276827089075325,0.176148796498906
2012,13105,41,189,47,172,0,7,47,179,0.0131733882837798,0.262569832402235
2012,13107,50,655,0,323,0,0,0,323,0.0220387554585153,0
2012,13109,18,501,0,88,0,26,0,114,0.0162116040955631,0
2012,13111,87,327,37,427,11,30,48,457,0.0258923512747875,0.105032822757112
2012,13113,968,3148,632,1447,162,384,794,1831,0.025745581349569,0.433642818132168
2012,13115,320,1815,355,819,69,227,424,1046,0.0166356537366605,0.405353728489484
2012,13117,2118,4933,1098,2324,241,536,1339,2860,0.0252133436772692,0.468181818181818
2012,13119,15,357,20,84,11,43,31,127,0.00850465412174379,0.244094488188976
2012,13121,11377,26814,10331,19839,3123,4516,13454,24355,0.0399867996768876,0.552412235680558
2012,13123,142,1044,90,365,0,58,90,423,0.0210709838107098,0.212765957446809
2012,13125,0,29,0,45,0,5,0,50,0.0233972859148339,0
2012,13127,291,1696,534,1105,146,326,680,1431,0.0266178084485036,0.475192173305381
2012,13129,137,837,101,429,0,98,101,527,0.0149143908306212,0.191650853889943
2012,13131,2,569,100,372,0,14,100,386,0.0236897017306984,0.259067357512953
2012,13133,88,337,15,104,0,39,15,143,0.0121350984385608,0.104895104895105
2012,13135,5476,17588,4932,13196,1568,3199,6500,16395,0.0323559130702495,0.396462336078073
2012,13137,126,1152,59,251,14,27,73,278,0.00964005825646716,0.262589928057554
2012,13139,993,3978,562,1757,87,287,649,2044,0.0179728648430012,0.317514677103718
2012,13141,12,446,0,112,0,0,0,112,0.0168446382914724,0
2012,13143,73,951,29,233,0,0,29,233,0.0123371809806206,0.124463519313305
2012,13145,234,974,145,316,13,40,158,356,0.0161729965473378,0.443820224719101
2012,13147,101,914,12,260,0,6,12,266,0.0151618787049704,0.0451127819548872
2012,13149,0,414,24,184,4,7,28,191,0.0244652235173562,0.146596858638743
2012,13151,1268,6418,847,2559,116,280,963,2839,0.0222769752277524,0.339203945051074
2012,13153,760,3294,744,2396,220,528,964,2924,0.0326547022101113,0.3296853625171
2012,13155,36,317,15,192,0,0,15,192,0.0296250578614411,0.078125
2012,13157,343,1705,99,497,34,107,133,604,0.015293849542957,0.220198675496689
2012,13159,83,408,24,139,3,37,27,176,0.019180470793374,0.153409090909091
2012,13161,51,299,0,54,15,25,15,79,0.00845010161514601,0.189873417721519
2012,13163,34,554,87,202,7,7,94,209,0.0188679245283019,0.449760765550239
2012,13165,21,149,0,4,0,0,0,4,0.000731528895391368,0
2012,13167,31,885,11,19,0,0,11,19,0.00272792534099067,0.578947368421053
2012,13169,173,989,0,159,21,21,21,180,0.00944534816602823,0.116666666666667
2012,13171,42,535,0,220,0,45,0,265,0.0226109215017065,0
2012,13173,15,580,0,81,0,53,0,134,0.0212765957446809,0
2012,13175,91,600,61,312,7,25,68,337,0.0106094950258154,0.201780415430267
2012,13177,174,1272,32,306,19,49,51,355,0.0194669883746436,0.143661971830986
2012,13179,287,1195,549,2992,202,1078,751,4070,0.113868449766388,0.184520884520885
2012,13181,5,51,19,60,0,0,19,60,0.0108538350217077,0.316666666666667
2012,13183,75,657,22,446,15,36,37,482,0.0571631878557875,0.0767634854771784
2012,13185,244,2097,565,1955,85,380,650,2335,0.0370435003331535,0.278372591006424
2012,13187,122,865,73,328,0,127,73,455,0.0240384615384615,0.16043956043956
2012,13189,23,346,22,103,0,2,22,105,0.00740531772339375,0.20952380952381
2012,13191,86,213,4,86,0,0,4,86,0.00927523727351165,0.0465116279069767
2012,13193,18,470,0,62,0,119,0,181,0.0185698163537499,0
2012,13195,98,485,15,169,8,8,23,177,0.00937847718963599,0.129943502824859
2012,13197,23,273,36,44,3,34,39,78,0.0133699005827905,0.5
2012,13199,138,841,15,55,0,7,15,62,0.00415438220316269,0.241935483870968
2012,13201,0,156,11,20,0,6,11,26,0.00631221170186939,0.423076923076923
2012,13205,70,863,19,98,0,0,19,98,0.00629011553273427,0.193877551020408
2012,13207,93,1106,45,241,0,6,45,247,0.0136035688715096,0.182186234817814
2012,13209,5,83,0,25,0,0,0,25,0.0042852245457662,0
2012,13211,45,332,28,134,0,0,28,134,0.0109200554152066,0.208955223880597
2012,13213,13,676,0,125,0,27,0,152,0.00595098269516874,0
2012,13215,670,3934,1804,6541,401,872,2205,7413,0.0622726623600272,0.297450424929178
2012,13217,330,3548,262,1090,0,71,262,1161,0.0186266645275148,0.225667527993109
2012,13219,248,745,144,291,6,26,150,317,0.0150059171597633,0.473186119873817
2012,13221,130,510,13,39,0,14,13,53,0.0052809884416102,0.245283018867925
2012,13223,912,3976,692,1610,47,117,739,1727,0.0196672398674426,0.427909669947886
2012,13225,71,642,43,307,0,0,43,307,0.0185263411984793,0.140065146579805
2012,13227,118,854,51,201,18,47,69,248,0.0119219305835977,0.278225806451613
2012,13229,76,453,17,100,8,8,25,108,0.00880913539967374,0.231481481481481
2012,13231,62,848,49,120,5,5,54,125,0.010709389993146,0.432
2012,13233,137,1021,32,159,0,69,32,228,0.00858272162619989,0.140350877192982
2012,13235,6,346,0,41,0,11,0,52,0.00586907449209932,0
2012,13237,164,576,50,127,0,0,50,127,0.00838671333289309,0.393700787401575
2012,13239,0,19,0,57,0,0,0,57,0.0347985347985348,0
2012,13241,47,264,80,187,0,0,80,187,0.0158072696534235,0.427807486631016
2012,13243,42,227,0,14,0,0,0,14,0.0026840490797546,0
2012,13245,587,3788,1563,5227,287,964,1850,6191,0.0491614522123051,0.298820869003392
2012,13247,562,3675,262,1199,88,219,350,1418,0.0259959301153134,0.246826516220028
2012,13249,0,129,8,39,0,0,8,39,0.0125968992248062,0.205128205128205
2012,13251,42,324,0,40,9,10,9,50,0.00522193211488251,0.18
2012,13253,10,123,0,62,0,36,0,98,0.0163115845539281,0
2012,13255,134,2080,131,785,15,84,146,869,0.0206732484834067,0.16800920598389
2012,13257,50,438,0,190,26,26,26,216,0.0124309392265193,0.12037037037037
2012,13259,5,237,11,258,0,33,11,291,0.0677374301675978,0.0378006872852234
2012,13261,116,856,47,197,23,36,70,233,0.0116797834477919,0.300429184549356
2012,13263,0,181,0,72,0,10,0,82,0.016935150764147,0
2012,13265,11,67,2,5,0,14,2,19,0.0162671232876712,0.105263157894737
2012,13267,67,1936,29,278,0,16,29,294,0.0173073526814623,0.0986394557823129
2012,13269,43,410,0,99,0,0,0,99,0.0165995975855131,0
2012,13271,20,286,0,42,0,18,0,60,0.00508431488856876,0
2012,13273,11,313,0,27,0,0,0,27,0.00444225074037512,0
2012,13275,75,823,69,534,16,23,85,557,0.0186580913141058,0.152603231597846
2012,13277,94,875,256,422,90,124,346,546,0.0218382529397648,0.633699633699634
2012,13279,51,251,20,40,5,18,25,58,0.00337464362599639,0.431034482758621
2012,13281,31,183,72,188,0,0,72,188,0.0241645244215938,0.382978723404255
2012,13283,5,213,0,9,0,0,0,9,0.00206185567010309,0
2012,13285,79,1374,137,965,165,236,302,1201,0.0281093479380237,0.251457119067444
2012,13287,6,140,0,29,0,0,0,29,0.00508593475973343,0
2012,13289,26,231,0,56,1,2,1,58,0.00936087798579729,0.0172413793103448
2012,13291,65,315,82,500,33,33,115,533,0.0326853498497578,0.215759849906191
2012,13293,87,521,0,135,0,0,0,135,0.00744745407403321,0
2012,13295,127,1675,258,1180,1,51,259,1231,0.0262406207366985,0.210398050365556
2012,13297,562,2671,80,793,0,17,80,810,0.0148015495943279,0.0987654320987654
2012,13299,82,1210,41,527,27,92,68,619,0.0257637559310747,0.109854604200323
2012,13301,11,74,21,68,0,0,21,68,0.0166503428011753,0.308823529411765
2012,13303,33,667,8,46,0,33,8,79,0.00557988416443,0.10126582278481
2012,13305,140,691,118,893,0,53,118,946,0.046859520507232,0.124735729386892
2012,13307,20,56,0,34,0,8,0,42,0.0208230044620724,0
2012,13309,4,188,0,22,0,9,0,31,0.00542907180385289,0
2012,13311,31,424,15,153,0,0,15,153,0.00806919466272876,0.0980392156862745
2012,13313,181,1685,273,1187,17,80,290,1267,0.0200582591900706,0.228887134964483
2012,13315,27,735,21,110,0,16,21,126,0.0192866983009337,0.166666666666667
2012,13317,24,301,7,45,0,0,7,45,0.00624652970571904,0.155555555555556
2012,13319,10,181,2,18,0,6,2,24,0.00376470588235294,0.0833333333333333
2012,13321,28,349,57,544,0,0,57,544,0.0378355821393796,0.104779411764706
2012,15001,217,946,1250,3730,240,659,1490,4389,0.0344067982628055,0.339485076327182
2012,15003,449,2308,7873,20307,3351,8661,11224,28968,0.0448357893857057,0.387462027064347
2012,15005,0,3,0,0,0,0,0,0,0,NA
2012,15007,43,285,611,1316,50,465,661,1781,0.0379477126968231,0.371139809096013
2012,15009,240,1126,1204,3447,285,813,1489,4260,0.039634912217043,0.349530516431925
2012,16001,1303,6244,4229,8997,573,1235,4802,10232,0.0400714330471834,0.46931196247068
2012,16003,22,120,4,61,4,4,8,65,0.0218413978494624,0.123076923076923
2012,16005,280,1741,445,1356,6,62,451,1418,0.0285708528943604,0.318053596614951
2012,16007,25,75,2,156,6,9,8,165,0.0418144956918398,0.0484848484848485
2012,16009,15,110,29,148,0,0,29,148,0.0231069476971116,0.195945945945946
2012,16011,132,614,86,548,0,22,86,570,0.0214438884917798,0.150877192982456
2012,16013,46,249,282,464,110,174,392,638,0.0428331654917758,0.614420062695925
2012,16015,39,186,0,167,0,4,0,171,0.0333073626801714,0
2012,16017,110,298,279,760,23,68,302,828,0.0280259951259139,0.364734299516908
2012,16019,311,1805,397,1410,87,163,484,1573,0.0251442638149587,0.307692307692308
2012,16021,13,61,38,79,5,5,43,84,0.0112209457654288,0.511904761904762
2012,16023,7,63,7,79,0,0,7,79,0.0409751037344398,0.0886075949367089
2012,16025,6,46,0,8,0,0,0,8,0.00932400932400932,0
2012,16027,558,3829,629,3330,68,306,697,3636,0.0324367723805701,0.191694169416942
2012,16029,5,99,26,66,0,34,26,100,0.02211900022119,0.26
2012,16031,106,591,68,414,0,48,68,462,0.0346690679873931,0.147186147186147
2012,16033,0,5,0,5,0,0,0,5,0.0101010101010101,0
2012,16035,21,302,29,126,0,0,29,126,0.0188566297515714,0.23015873015873
2012,16037,10,83,125,168,0,5,125,173,0.053345667591736,0.722543352601156
2012,16039,100,282,88,555,64,354,152,909,0.057611864621625,0.167216721672167
2012,16041,18,77,55,246,29,58,84,304,0.0416952407077218,0.276315789473684
2012,16043,25,157,80,162,0,24,80,186,0.0229176934450468,0.43010752688172
2012,16045,100,769,85,311,0,0,85,311,0.0271071210668526,0.273311897106109
2012,16047,13,147,12,64,6,19,18,83,0.00875712175564465,0.216867469879518
2012,16049,60,386,36,282,10,10,46,292,0.0247018018780137,0.157534246575342
2012,16051,149,654,33,211,25,66,58,277,0.018777114967462,0.209386281588448
2012,16053,52,486,30,153,0,70,30,223,0.016946576487575,0.134529147982063
2012,16055,136,1190,1190,4047,34,135,1224,4182,0.0450209925718592,0.292682926829268
2012,16057,244,441,352,1320,26,47,378,1367,0.0661665053242982,0.276517922457937
2012,16059,22,74,7,106,0,9,7,115,0.019243641231593,0.0608695652173913
2012,16061,25,143,10,62,0,0,10,62,0.0226608187134503,0.161290322580645
2012,16063,59,188,9,70,0,0,9,70,0.0233722871452421,0.128571428571429
2012,16065,73,587,248,744,21,55,269,799,0.0557649357900614,0.336670838548185
2012,16067,9,412,17,223,0,75,17,298,0.0239684710045846,0.0570469798657718
2012,16069,139,682,200,857,11,17,211,874,0.0325185102504,0.241418764302059
2012,16071,9,49,6,112,0,0,6,112,0.0405944182674882,0.0535714285714286
2012,16073,56,402,9,127,0,9,9,136,0.0190050307434321,0.0661764705882353
2012,16075,33,205,180,866,0,99,180,965,0.0674070969544566,0.186528497409326
2012,16077,8,104,0,25,0,6,0,31,0.00658453695836873,0
2012,16079,25,233,39,218,0,0,39,218,0.0233730031092527,0.178899082568807
2012,16081,71,171,274,396,0,9,274,405,0.0624133148404993,0.676543209876543
2012,16083,173,1250,188,1298,20,363,208,1661,0.034200881274966,0.125225767609874
2012,16085,49,137,26,115,11,11,37,126,0.0173529816829638,0.293650793650794
2012,16087,20,203,45,150,0,0,45,150,0.0208971858456395,0.3
2012,17001,108,401,126,653,31,56,157,709,0.0155254341209188,0.221438645980254
2012,17003,18,131,8,213,0,0,8,213,0.0389183263292527,0.0375586854460094
2012,17005,31,301,142,234,0,0,142,234,0.0201550387596899,0.606837606837607
2012,17007,163,1135,194,374,19,44,213,418,0.0122519565026233,0.509569377990431
2012,17009,12,723,36,53,20,20,56,73,0.0143390296601846,0.767123287671233
2012,17011,119,579,48,244,29,60,77,304,0.0125010280450695,0.253289473684211
2012,17013,37,105,18,24,0,9,18,33,0.00917686318131257,0.545454545454545
2012,17015,43,341,11,77,3,16,14,93,0.00833333333333333,0.150537634408602
2012,17017,58,444,48,238,50,403,98,641,0.0692448957545641,0.152886115444618
2012,17019,831,2274,1904,3139,1298,1685,3202,4824,0.0423849438557647,0.663764510779436
2012,17021,141,907,57,252,15,21,72,273,0.0112861217908967,0.263736263736264
2012,17023,25,202,16,227,7,26,23,253,0.0222593700510294,0.0909090909090909
2012,17025,24,210,10,40,0,0,10,40,0.00418410041841004,0.25
2012,17027,107,1055,115,286,0,21,115,307,0.0117759877253548,0.374592833876221
2012,17029,214,1002,80,303,0,0,80,303,0.00967958342650864,0.264026402640264
2012,17031,12276,26916,29568,49567,13061,23091,42629,72658,0.0210187580077279,0.586707588978502
2012,17033,56,421,8,210,22,22,30,232,0.0167460661180886,0.129310344827586
2012,17035,64,331,5,78,0,0,5,78,0.0103654485049834,0.0641025641025641
2012,17037,638,1934,313,683,84,281,397,964,0.0162079459286783,0.411825726141079
2012,17039,82,358,22,115,0,6,22,121,0.0103987624613269,0.181818181818182
2012,17041,28,457,14,173,0,34,14,207,0.015669947009841,0.0676328502415459
2012,17043,9164,21055,5128,8666,1819,3688,6947,12354,0.0201307832820314,0.56232799093411
2012,17045,18,284,32,163,8,21,40,184,0.0141028588947651,0.217391304347826
2012,17047,21,146,5,17,0,2,5,19,0.00405896176030763,0.263157894736842
2012,17049,75,355,20,159,25,28,45,187,0.0081648692311051,0.240641711229947
2012,17051,14,585,35,178,0,3,35,181,0.0122140495310075,0.193370165745856
2012,17053,78,421,7,62,16,18,23,80,0.00820512820512821,0.2875
2012,17055,88,689,42,307,3,36,45,343,0.0125168777141189,0.131195335276968
2012,17057,86,1067,4,206,13,30,17,236,0.00900832124589663,0.0720338983050847
2012,17059,35,70,26,80,0,0,26,80,0.0199104031856645,0.325
2012,17061,21,239,7,129,0,0,7,129,0.0134627426424546,0.0542635658914729
2012,17063,68,1269,42,193,36,54,78,247,0.00761405672009864,0.315789473684211
2012,17065,14,221,10,17,0,5,10,22,0.00371872887085869,0.454545454545455
2012,17067,36,168,108,410,0,18,108,428,0.0315099757049253,0.252336448598131
2012,17069,8,80,17,50,0,0,17,50,0.0157331655129012,0.34
2012,17071,16,110,44,135,0,1,44,136,0.0253494874184529,0.323529411764706
2012,17073,202,934,67,498,7,28,74,526,0.0152287203242617,0.140684410646388
2012,17075,85,495,38,123,33,49,71,172,0.00833818111305022,0.412790697674419
2012,17077,307,1195,375,819,124,208,499,1027,0.0299836505897466,0.485881207400195
2012,17079,28,226,19,79,0,12,19,91,0.0133725202057311,0.208791208791209
2012,17081,166,967,100,381,36,98,136,479,0.0177492866935932,0.2839248434238
2012,17083,84,350,137,167,4,22,141,189,0.0121684264743755,0.746031746031746
2012,17085,100,257,62,303,0,28,62,331,0.0199818895261093,0.187311178247734
2012,17087,29,947,8,98,0,0,8,98,0.0106986899563319,0.0816326530612245
2012,17089,3905,11582,1410,3979,343,1462,1753,5441,0.0168447840301169,0.322183422165043
2012,17091,439,2007,85,616,64,164,149,780,0.0106985611806822,0.191025641025641
2012,17093,1323,3551,233,1202,70,153,303,1355,0.0191630485511038,0.223616236162362
2012,17095,206,1219,41,288,26,118,67,406,0.0110626702997275,0.165024630541872
2012,17097,4201,8810,4038,9239,1481,2560,5519,11799,0.0264056020428031,0.467751504364777
2012,17099,433,1705,136,633,11,88,147,721,0.00925438652787226,0.203883495145631
2012,17101,12,1125,44,245,0,66,44,311,0.0225345989421056,0.141479099678457
2012,17103,111,1173,58,297,5,28,63,325,0.0130637511053943,0.193846153846154
2012,17105,184,1707,14,198,0,33,14,231,0.00858608385370205,0.0606060606060606
2012,17107,61,2311,14,139,1,22,15,161,0.00763069339779136,0.093167701863354
2012,17109,266,605,100,218,25,41,125,259,0.0144757433489828,0.482625482625483
2012,17111,1602,5036,956,2595,116,379,1072,2974,0.0148145196240081,0.360457296570276
2012,17113,940,2377,1383,2128,512,606,1895,2734,0.0269317151976043,0.693123628383321
2012,17115,447,1888,416,927,60,148,476,1075,0.0143199680298388,0.442790697674419
2012,17117,90,874,157,353,12,87,169,440,0.0133280828764426,0.384090909090909
2012,17119,682,3159,1129,2762,133,259,1262,3021,0.0167586608604,0.417742469381
2012,17121,84,541,54,256,0,34,54,290,0.0107890918560958,0.186206896551724
2012,17123,66,216,39,60,1,16,40,76,0.00845948352626892,0.526315789473684
2012,17125,17,333,14,115,0,32,14,147,0.0141196811065219,0.0952380952380952
2012,17127,9,110,31,275,5,17,36,292,0.0271425915597695,0.123287671232877
2012,17129,74,355,6,94,0,6,6,100,0.011285407967498,0.06
2012,17131,53,218,30,92,0,2,30,94,0.00813148788927336,0.319148936170213
2012,17133,204,792,153,333,0,0,153,333,0.0147416884324229,0.459459459459459
2012,17135,50,1946,47,230,1,8,48,238,0.011206328279499,0.201680672268908
2012,17137,273,1085,22,242,55,73,77,315,0.0129374075899458,0.244444444444444
2012,17139,79,303,12,31,0,0,12,31,0.00308059226870715,0.387096774193548
2012,17141,114,830,76,349,3,4,79,353,0.00981864708500223,0.223796033994334
2012,17143,755,2957,1084,2407,415,546,1499,2953,0.0241262112126015,0.507619370132069
2012,17145,127,998,36,74,0,33,36,107,0.00695347023654796,0.336448598130841
2012,17147,92,318,49,65,0,5,49,70,0.00601167983510821,0.7
2012,17149,4,349,12,262,0,51,12,313,0.0276648400212127,0.0383386581469649
2012,17151,14,51,0,60,0,0,0,60,0.0188205771643664,0
2012,17153,26,97,0,33,0,0,0,33,0.0079671656204732,0
2012,17155,12,140,3,13,10,29,13,42,0.0098661028893587,0.30952380952381
2012,17157,26,993,22,269,2,50,24,319,0.0132717590281245,0.0752351097178683
2012,17159,96,183,69,165,0,0,69,165,0.0145502645502645,0.418181818181818
2012,17161,263,1538,563,1991,102,454,665,2445,0.0242658224079239,0.2719836400818
2012,17163,611,2383,1425,4043,137,577,1562,4620,0.0262455263307391,0.338095238095238
2012,17165,31,458,15,86,4,21,19,107,0.00626023870816756,0.177570093457944
2012,17167,1181,3604,796,2080,87,731,883,2811,0.0209259217902048,0.314123087869086
2012,17169,38,182,0,24,0,0,0,24,0.00448681996634885,0
2012,17171,18,106,2,10,0,3,2,13,0.00354223433242507,0.153846153846154
2012,17173,45,515,25,51,0,3,25,54,0.00343162175902389,0.462962962962963
2012,17175,6,126,0,31,0,0,0,31,0.00739327450512759,0
2012,17177,190,748,135,473,0,23,135,496,0.0149916880761674,0.272177419354839
2012,17179,727,2770,369,1235,6,74,375,1309,0.0140181411238073,0.286478227654698
2012,17181,72,279,22,211,0,21,22,232,0.0186976144422953,0.0948275862068965
2012,17183,80,803,76,673,33,159,109,832,0.0153242591125928,0.131009615384615
2012,17185,0,126,24,80,0,16,24,96,0.0115900036218761,0.25
2012,17187,41,236,36,120,0,10,36,130,0.0112330424263372,0.276923076923077
2012,17189,36,349,11,66,6,9,17,75,0.00726462611390934,0.226666666666667
2012,17191,2,293,10,36,0,13,10,49,0.0041855300247715,0.204081632653061
2012,17193,25,280,39,194,21,21,60,215,0.020450870350994,0.27906976744186
2012,17195,63,609,9,222,0,33,9,255,0.00633524632928374,0.0352941176470588
2012,17197,4459,11784,1793,3691,691,1633,2484,5324,0.0124773841553158,0.46656649135988
2012,17199,392,1535,326,820,5,57,331,877,0.0190888709923166,0.377423033067275
2012,17201,893,3111,558,2336,142,360,700,2696,0.0137476670780088,0.259643916913947
2012,17203,246,1155,87,144,21,50,108,194,0.00761560807097433,0.556701030927835
2012,18001,65,416,29,139,0,46,29,185,0.00887928965682745,0.156756756756757
2012,18003,656,2609,902,3269,160,664,1062,3933,0.0173460116963191,0.270022883295195
2012,18005,228,1482,580,1187,260,420,840,1607,0.0310429424150521,0.522713130056005
2012,18007,34,365,0,81,0,13,0,94,0.0158462575859744,0
2012,18009,29,301,0,119,11,11,11,130,0.0146793134598013,0.0846153846153846
2012,18011,527,1395,301,517,1,21,302,538,0.0144837797819357,0.561338289962825
2012,18013,130,501,9,127,10,10,19,137,0.0123378962536023,0.138686131386861
2012,18015,75,561,72,165,5,22,77,187,0.0136546184738956,0.411764705882353
2012,18017,92,671,18,177,17,99,35,276,0.0106898020837368,0.126811594202899
2012,18019,223,1596,346,1722,28,68,374,1790,0.0238536266840794,0.208938547486034
2012,18021,88,486,47,214,0,9,47,223,0.0122588093013028,0.210762331838565
2012,18023,108,807,6,188,0,44,6,232,0.0108193816163783,0.0258620689655172
2012,18025,20,217,9,47,0,4,9,51,0.00697006970069701,0.176470588235294
2012,18027,82,332,18,148,0,4,18,152,0.00769542324827866,0.118421052631579
2012,18029,44,477,52,1122,14,59,66,1181,0.0350569935882213,0.0558848433530906
2012,18031,63,488,90,286,13,26,103,312,0.0180492884415134,0.330128205128205
2012,18033,174,866,55,365,0,0,55,365,0.0131493623459903,0.150684931506849
2012,18035,374,2085,368,1198,72,215,440,1413,0.0199241388062437,0.311394196744515
2012,18037,64,405,320,541,0,37,320,578,0.0203449489616332,0.55363321799308
2012,18039,336,2062,508,2374,85,245,593,2619,0.0211327270820053,0.226422298587247
2012,18041,41,530,24,116,7,44,31,160,0.0096188529517855,0.19375
2012,18043,266,1385,319,1344,28,129,347,1473,0.0293818442941775,0.235573659198914
2012,18045,28,371,0,151,0,0,0,151,0.0127329454422801,0
2012,18047,176,461,88,233,18,76,106,309,0.0199354838709677,0.343042071197411
2012,18049,62,500,14,154,0,6,14,160,0.0113146170709285,0.0875
2012,18051,65,501,175,441,0,6,175,447,0.0198059284859763,0.391498881431767
2012,18053,170,794,140,567,67,93,207,660,0.0145054945054945,0.313636363636364
2012,18055,95,900,26,204,30,30,56,234,0.0102952175634652,0.239316239316239
2012,18057,4248,7981,2281,4128,512,877,2793,5005,0.0282570402655767,0.558041958041958
2012,18059,474,1955,185,475,22,48,207,523,0.0112161959295717,0.395793499043977
2012,18061,60,320,103,368,0,15,103,383,0.0142617762055483,0.268929503916449
2012,18063,904,4199,517,1291,321,471,838,1762,0.0184463986599665,0.475595913734393
2012,18065,146,1944,33,340,0,0,33,340,0.00977741991142808,0.0970588235294118
2012,18067,175,1204,115,598,30,133,145,731,0.0128933258078171,0.198358413132695
2012,18069,77,575,103,288,10,78,113,366,0.0148538961038961,0.308743169398907
2012,18071,76,559,108,297,121,230,229,527,0.0183867141162515,0.434535104364326
2012,18073,168,595,17,311,0,36,17,347,0.0159672372538193,0.0489913544668588
2012,18075,39,246,10,147,0,0,10,147,0.0105474635861376,0.0680272108843537
2012,18077,119,778,71,360,9,40,80,400,0.0183427339845004,0.2
2012,18079,71,700,6,207,7,50,13,257,0.0138216629020114,0.0505836575875486
2012,18081,739,4359,347,1712,105,284,452,1996,0.0218146844739776,0.226452905811623
2012,18083,105,478,68,478,32,70,100,548,0.021953369121064,0.182481751824818
2012,18085,266,1336,304,744,105,158,409,902,0.0178483091596256,0.453436807095344
2012,18087,89,616,73,339,9,53,82,392,0.0186524552721736,0.209183673469388
2012,18089,498,2846,1361,8153,278,672,1639,8825,0.0271401508162035,0.185722379603399
2012,18091,362,3437,318,1128,37,104,355,1232,0.0160904828450899,0.288149350649351
2012,18093,159,808,39,168,0,34,39,202,0.0063125,0.193069306930693
2012,18095,581,2719,162,930,31,121,193,1051,0.0117883260801292,0.183634633682207
2012,18097,4543,13825,3890,9693,1199,2722,5089,12415,0.0212494651262302,0.409907370116794
2012,18099,85,927,88,190,19,56,107,246,0.00800520663846404,0.434959349593496
2012,18101,34,164,9,162,21,35,30,197,0.0278287893770307,0.152284263959391
2012,18103,52,1544,46,371,0,0,46,371,0.0146872525732383,0.123989218328841
2012,18105,810,2594,2007,2794,701,936,2708,3730,0.0493236184758605,0.726005361930295
2012,18107,86,591,129,321,0,56,129,377,0.0148524603080802,0.342175066312997
2012,18109,271,2166,93,500,0,22,93,522,0.0112103771153681,0.17816091954023
2012,18111,20,262,26,148,0,0,26,148,0.015039122040443,0.175675675675676
2012,18113,50,1188,78,281,16,32,94,313,0.0101755526657997,0.300319488817891
2012,18115,3,115,11,115,0,6,11,121,0.0277141548327989,0.0909090909090909
2012,18117,8,316,12,58,0,3,12,61,0.004576144036009,0.19672131147541
2012,18119,41,554,20,106,0,0,20,106,0.00712078462985355,0.188679245283019
2012,18121,116,990,0,119,0,2,0,121,0.00998432213879033,0
2012,18123,69,636,18,107,0,0,18,107,0.00783480998755217,0.168224299065421
2012,18125,8,151,5,11,0,0,5,11,0.00121910672725258,0.454545454545455
2012,18127,591,3018,706,2168,100,307,806,2475,0.0225674973329321,0.325656565656566
2012,18129,61,398,24,208,4,29,28,237,0.0134391834420187,0.118143459915612
2012,18131,22,298,32,61,0,33,32,94,0.010339896601034,0.340425531914894
2012,18133,168,1829,14,233,11,24,25,257,0.0104141340465192,0.0972762645914397
2012,18135,6,506,25,235,0,47,25,282,0.015843586718355,0.0886524822695035
2012,18137,73,451,44,286,15,15,59,301,0.0158730158730159,0.196013289036545
2012,18139,42,301,63,145,0,0,63,145,0.01237306937452,0.43448275862069
2012,18141,547,2614,1496,3685,264,693,1760,4378,0.0256285672471828,0.402010050251256
2012,18143,19,438,16,220,0,15,16,235,0.0144224868049589,0.0680851063829787
2012,18145,285,1270,47,420,16,95,63,515,0.0171472331357795,0.122330097087379
2012,18147,119,397,23,143,0,2,23,145,0.00994240263302249,0.158620689655172
2012,18149,78,586,0,260,0,9,0,269,0.0170231616251107,0
2012,18151,102,406,71,486,0,37,71,523,0.0230345738824048,0.135755258126195
2012,18153,138,883,14,56,0,5,14,61,0.00405773963945986,0.229508196721311
2012,18155,73,265,10,87,0,38,10,125,0.0178393035535893,0.08
2012,18157,617,2810,1377,2306,664,1127,2041,3433,0.0363138242169732,0.594523740168948
2012,18159,10,272,37,91,0,0,37,91,0.00814244810307802,0.406593406593407
2012,18161,14,113,8,49,0,4,8,53,0.0105200476379516,0.150943396226415
2012,18163,595,2383,614,2265,16,102,630,2367,0.0198952703554588,0.26615969581749
2012,18165,71,293,9,128,6,17,15,145,0.0128420866176601,0.103448275862069
2012,18167,278,1255,188,1045,81,171,269,1216,0.0175737780732433,0.221217105263158
2012,18169,39,590,91,260,14,17,105,277,0.0125555253376847,0.379061371841155
2012,18171,11,259,0,30,0,0,0,30,0.00508044030482642,0
2012,18173,302,1531,117,625,41,92,158,717,0.0178322721846399,0.220362622036262
2012,18175,76,499,59,226,0,17,59,243,0.0128646302080576,0.242798353909465
2012,18177,126,902,383,1207,24,72,407,1279,0.0274917782602154,0.318217357310399
2012,18179,76,537,53,151,0,0,53,151,0.00808567603748327,0.350993377483444
2012,18181,165,712,10,141,0,29,10,170,0.010049657129345,0.0588235294117647
2012,18183,136,833,12,203,0,39,12,242,0.0107660823916719,0.0495867768595041
2012,19001,35,171,19,62,0,2,19,64,0.0117216117216117,0.296875
2012,19003,33,89,15,27,10,10,25,37,0.0126538987688098,0.675675675675676
2012,19005,19,247,15,210,28,81,43,291,0.0290651218537755,0.147766323024055
2012,19007,22,167,22,239,0,0,22,239,0.0264673311184939,0.0920502092050209
2012,19009,8,63,5,13,0,10,5,23,0.00522489777373921,0.217391304347826
2012,19011,98,552,9,54,15,18,24,72,0.00406481115564839,0.333333333333333
2012,19013,477,1745,297,1098,172,270,469,1368,0.0167055404266751,0.342836257309941
2012,19015,226,792,78,170,0,13,78,183,0.0101328903654485,0.426229508196721
2012,19017,130,502,21,115,1,10,22,125,0.00791540020263425,0.176
2012,19019,93,286,31,86,0,25,31,111,0.0080417300586829,0.279279279279279
2012,19021,56,262,108,259,6,132,114,391,0.0306546452371619,0.29156010230179
2012,19023,43,277,34,60,0,3,34,63,0.00601719197707736,0.53968253968254
2012,19025,88,504,12,76,2,25,14,101,0.0138679115749005,0.138613861386139
2012,19027,42,396,49,174,0,7,49,181,0.0127797782955589,0.270718232044199
2012,19029,38,240,30,78,5,18,35,96,0.00985019495177509,0.364583333333333
2012,19031,93,392,7,100,11,20,18,120,0.00934943513829373,0.15
2012,19033,246,889,160,378,0,6,160,384,0.0123615761009529,0.416666666666667
2012,19035,73,369,68,161,9,9,77,170,0.0197536602370439,0.452941176470588
2012,19037,6,147,23,65,2,16,25,81,0.009386950979256,0.308641975308642
2012,19039,28,124,0,83,0,22,0,105,0.0166165532520968,0
2012,19041,28,112,29,176,0,50,29,226,0.0193493150684932,0.128318584070796
2012,19043,34,305,33,224,0,5,33,229,0.0180457052797478,0.14410480349345
2012,19045,235,684,107,520,0,10,107,530,0.0157822643082604,0.20188679245283
2012,19047,41,210,30,132,17,42,47,174,0.0155997848305541,0.270114942528736
2012,19049,1369,2556,463,926,34,56,497,982,0.0225856160445272,0.506109979633401
2012,19051,28,186,1,88,0,5,1,93,0.016805204192266,0.010752688172043
2012,19053,48,158,27,55,0,0,27,55,0.010482180293501,0.490909090909091
2012,19055,34,440,31,49,0,0,31,49,0.0040495867768595,0.63265306122449
2012,19057,110,550,126,571,0,19,126,590,0.0211310483148884,0.213559322033898
2012,19059,53,201,63,204,0,0,63,204,0.0161891913340211,0.308823529411765
2012,19061,223,731,467,1530,75,89,542,1619,0.026201650752549,0.334774552192712
2012,19063,59,177,14,146,10,15,24,161,0.023357028869868,0.149068322981366
2012,19065,69,396,76,204,0,13,76,217,0.0154108372984873,0.350230414746544
2012,19067,27,262,39,130,2,35,41,165,0.0146967132804845,0.248484848484848
2012,19069,7,128,24,108,0,0,24,108,0.0145278450363196,0.222222222222222
2012,19071,25,103,7,35,0,11,7,46,0.00884615384615385,0.152173913043478
2012,19073,17,332,12,54,4,13,16,67,0.0102134146341463,0.238805970149254
2012,19075,63,260,4,31,0,12,4,43,0.00497397339502603,0.0930232558139535
2012,19077,31,183,26,74,0,7,26,81,0.010407297957086,0.320987654320988
2012,19079,36,369,9,120,0,1,9,121,0.0112265726479866,0.0743801652892562
2012,19081,0,255,49,111,9,14,58,125,0.0155627490039841,0.464
2012,19083,66,202,30,108,3,7,33,115,0.00956420492348636,0.28695652173913
2012,19085,12,157,27,127,0,24,27,151,0.0147130468673877,0.178807947019868
2012,19087,44,387,22,154,0,46,22,200,0.014447735317489,0.11
2012,19089,27,127,29,48,0,0,29,48,0.00742229781970002,0.604166666666667
2012,19091,27,231,5,143,0,12,5,155,0.0226442658875091,0.032258064516129
2012,19093,25,139,34,63,2,8,36,71,0.0142770963201287,0.507042253521127
2012,19095,121,434,23,255,14,14,37,269,0.0237485653747683,0.137546468401487
2012,19097,39,280,34,110,3,3,37,113,0.00813886488043791,0.327433628318584
2012,19099,80,1030,113,418,12,28,125,446,0.0172413793103448,0.280269058295964
2012,19101,43,266,143,324,38,76,181,400,0.0340222845964106,0.4525
2012,19103,876,2224,2007,2936,512,731,2519,3667,0.0477486392874814,0.686937551131715
2012,19105,100,630,136,180,0,2,136,182,0.0124215124215124,0.747252747252747
2012,19107,15,287,27,52,0,7,27,59,0.00806010928961749,0.457627118644068
2012,19109,47,327,7,65,1,8,8,73,0.00658369408369408,0.10958904109589
2012,19111,39,357,160,464,79,79,239,543,0.0217643993747244,0.440147329650092
2012,19113,670,2692,1104,2579,265,494,1369,3073,0.0220569763352258,0.445493003579564
2012,19115,4,161,13,107,0,16,13,123,0.0160700287431408,0.105691056910569
2012,19117,0,102,23,172,7,20,30,192,0.0311385014596173,0.15625
2012,19119,31,121,20,80,3,6,23,86,0.0113024050466553,0.267441860465116
2012,19121,50,423,3,49,0,64,3,113,0.010781413987215,0.0265486725663717
2012,19123,16,323,10,131,0,22,10,153,0.0103813271814357,0.065359477124183
2012,19125,226,596,105,288,4,15,109,303,0.0139824642362713,0.35973597359736
2012,19127,159,522,182,549,12,60,194,609,0.0225890207715134,0.318555008210181
2012,19129,81,204,78,189,0,6,78,195,0.0190058479532164,0.4
2012,19131,18,84,0,60,3,3,3,63,0.00847343644922663,0.0476190476190476
2012,19133,18,220,16,106,0,4,16,110,0.01655130905808,0.145454545454545
2012,19135,12,82,9,54,0,11,9,65,0.0117604487063506,0.138461538461538
2012,19137,12,121,27,109,0,9,27,118,0.0155447240152813,0.228813559322034
2012,19139,117,687,39,437,50,51,89,488,0.0173227787440985,0.182377049180328
2012,19141,66,251,39,191,0,8,39,199,0.0198701947079381,0.195979899497487
2012,19143,7,73,5,65,0,0,5,65,0.0145186508822872,0.0769230769230769
2012,19145,62,442,31,341,0,2,31,343,0.0302202643171806,0.0903790087463557
2012,19147,40,222,0,38,0,1,0,39,0.00602782071097372,0
2012,19149,86,387,52,242,17,32,69,274,0.0162034299231224,0.251824817518248
2012,19151,16,135,22,131,13,17,35,148,0.0281529389385581,0.236486486486486
2012,19153,2366,6721,2080,5552,470,1511,2550,7063,0.0250322516622011,0.361036386804474
2012,19155,144,916,465,1849,36,133,501,1982,0.0320820990951618,0.252774974772957
2012,19157,49,343,94,212,11,13,105,225,0.0182807929801755,0.466666666666667
2012,19159,33,102,3,3,0,13,3,16,0.00453257790368272,0.1875
2012,19161,31,234,7,20,0,8,7,28,0.0037817396002161,0.25
2012,19163,438,1227,1486,3662,136,420,1622,4082,0.0370885236368923,0.397354238118569
2012,19165,30,156,44,94,1,3,45,97,0.0113437024909367,0.463917525773196
2012,19167,4,187,60,275,0,14,60,289,0.0144168412650903,0.207612456747405
2012,19169,414,1530,902,1119,440,484,1342,1603,0.0339309527337383,0.837180286961946
2012,19171,50,281,22,79,4,16,26,95,0.00792194796531021,0.273684210526316
2012,19173,5,87,0,80,3,3,3,83,0.018580702932617,0.036144578313253
2012,19175,39,194,23,158,0,2,23,160,0.0188368259948199,0.14375
2012,19177,12,138,23,88,0,1,23,89,0.0167324685091183,0.258426966292135
2012,19179,50,491,84,217,40,61,124,278,0.0116147900564028,0.446043165467626
2012,19181,323,1282,215,451,50,67,265,518,0.0173423951253808,0.511583011583012
2012,19183,81,421,33,208,0,0,33,208,0.0139850736233443,0.158653846153846
2012,19185,14,148,4,41,0,0,4,41,0.00930971843778383,0.0975609756097561
2012,19187,181,931,145,475,0,57,145,532,0.0209251101321586,0.272556390977444
2012,19189,10,97,39,219,0,0,39,219,0.0292467948717949,0.178082191780822
2012,19191,61,198,46,108,12,34,58,142,0.0106319257262653,0.408450704225352
2012,19193,211,908,397,1548,56,163,453,1711,0.0266461097614153,0.264757451782583
2012,19195,18,153,10,32,0,1,10,33,0.00616016427104723,0.303030303030303
2012,19197,4,175,26,73,0,54,26,127,0.0137609708527468,0.204724409448819
2012,20001,105,305,0,24,0,0,0,24,0.00267857142857143,0
2012,20003,47,352,7,65,0,0,7,65,0.0118483412322275,0.107692307692308
2012,20005,27,100,14,68,0,0,14,68,0.00658978583196046,0.205882352941176
2012,20007,31,124,8,83,0,3,8,86,0.02479815455594,0.0930232558139535
2012,20009,145,467,100,402,11,17,111,419,0.0227853608135298,0.26491646778043
2012,20011,40,209,27,106,0,5,27,111,0.0112314074673682,0.243243243243243
2012,20013,50,236,4,128,1,13,5,141,0.0208271787296898,0.0354609929078014
2012,20015,557,2194,127,788,30,30,157,818,0.0194831487435989,0.191931540342298
2012,20017,34,175,0,35,0,4,0,39,0.0198878123406425,0
2012,20019,13,75,15,99,0,3,15,102,0.0381879445900412,0.147058823529412
2012,20021,27,110,101,536,0,13,101,549,0.0376879247614471,0.183970856102004
2012,20023,2,42,13,74,8,8,21,82,0.0396902226524685,0.25609756097561
2012,20025,16,31,9,90,0,0,9,90,0.0589777195281782,0.1
2012,20027,21,200,0,107,68,118,68,225,0.0378532974427995,0.302222222222222
2012,20029,12,162,13,76,0,22,13,98,0.0152933832709114,0.13265306122449
2012,20031,53,367,25,137,2,2,27,139,0.0232519237203078,0.194244604316547
2012,20033,10,29,0,8,0,3,0,11,0.00827689992475546,0
2012,20035,133,1131,115,545,9,19,124,564,0.0240173742707491,0.219858156028369
2012,20037,41,316,162,452,34,49,196,501,0.021076101131631,0.391217564870259
2012,20039,4,62,21,60,0,0,21,60,0.0257731958762887,0.35
2012,20041,40,416,64,351,0,39,64,390,0.0290502793296089,0.164102564102564
2012,20043,27,72,27,205,0,7,27,212,0.0411890421604818,0.127358490566038
2012,20045,739,2107,979,1572,389,517,1368,2089,0.0336198017252478,0.654858784107228
2012,20047,14,57,1,24,2,5,3,29,0.0135072193758733,0.103448275862069
2012,20049,57,170,3,12,0,0,3,12,0.00568720379146919,0.25
2012,20051,151,751,121,454,3,35,124,489,0.0282055718982523,0.253578732106339
2012,20053,61,276,3,40,0,17,3,57,0.0121302404766972,0.0526315789473684
2012,20055,144,593,152,520,25,60,177,580,0.0275862068965517,0.305172413793103
2012,20057,146,667,87,637,28,95,115,732,0.0371121476373961,0.157103825136612
2012,20059,152,503,114,439,20,40,134,479,0.0281218810544238,0.279749478079332
2012,20061,141,444,340,1612,166,636,506,2248,0.118210022611348,0.22508896797153
2012,20063,6,63,3,20,0,0,3,20,0.0100553041729512,0.15
2012,20065,0,22,6,75,0,2,6,77,0.0393660531697341,0.0779220779220779
2012,20067,16,71,0,23,0,2,0,25,0.00536250536250536,0
2012,20069,37,140,36,122,0,0,36,122,0.0328310010764263,0.295081967213115
2012,20071,0,11,0,20,0,0,0,20,0.0221483942414175,0
2012,20073,13,129,6,35,0,2,6,37,0.00782241014799154,0.162162162162162
2012,20075,7,54,0,28,0,17,0,45,0.0261475886112725,0
2012,20077,26,114,2,79,0,4,2,83,0.019889767553319,0.0240963855421687
2012,20079,297,997,70,414,9,17,79,431,0.0190362616492204,0.183294663573086
2012,20081,0,115,0,41,5,13,5,54,0.0209221232080589,0.0925925925925926
2012,20083,12,45,10,35,0,0,10,35,0.0255661066471877,0.285714285714286
2012,20085,74,324,3,112,0,0,3,112,0.0125279642058166,0.0267857142857143
2012,20087,172,402,41,141,0,18,41,159,0.0120719763115937,0.257861635220126
2012,20089,5,36,0,26,0,4,0,30,0.0127822752449936,0
2012,20091,2615,6101,7507,13912,958,1972,8465,15884,0.0436958238082269,0.532926215059179
2012,20093,12,113,0,39,0,31,0,70,0.0281350482315113,0
2012,20095,10,55,15,123,0,0,15,123,0.0225068618481244,0.121951219512195
2012,20097,12,46,7,37,0,0,7,37,0.0215492137449039,0.189189189189189
2012,20099,35,402,57,319,0,13,57,332,0.0231423393280357,0.171686746987952
2012,20101,1,6,0,18,0,3,0,21,0.0177815410668925,0
2012,20103,459,1917,1440,3766,553,831,1993,4597,0.0897465932607083,0.433543615401349
2012,20105,7,76,3,42,0,2,3,44,0.0188436830835118,0.0681818181818182
2012,20107,18,87,41,122,0,0,41,122,0.0179914466892789,0.336065573770492
2012,20109,6,38,3,63,1,23,4,86,0.0439672801635992,0.0465116279069767
2012,20111,117,614,83,487,31,61,114,548,0.027081788979491,0.208029197080292
2012,20113,69,335,71,400,17,32,88,432,0.0217752910933011,0.203703703703704
2012,20115,9,389,54,120,0,11,54,131,0.0153323970037453,0.412213740458015
2012,20117,13,170,25,85,5,5,30,90,0.01255930784259,0.333333333333333
2012,20119,43,142,8,64,3,5,11,69,0.023318688746198,0.159420289855072
2012,20121,159,806,58,361,5,5,63,366,0.0170129689025241,0.172131147540984
2012,20123,65,137,8,24,0,2,8,26,0.00585849481748535,0.307692307692308
2012,20125,47,554,145,663,8,39,153,702,0.0300796983460451,0.217948717948718
2012,20127,26,130,5,44,5,7,10,51,0.0120481927710843,0.196078431372549
2012,20129,39,85,11,69,0,0,11,69,0.0323943661971831,0.159420289855072
2012,20131,40,160,21,66,0,7,21,73,0.0105157015269375,0.287671232876712
2012,20133,89,417,9,137,0,6,9,143,0.0130760790051207,0.0629370629370629
2012,20135,15,55,0,20,0,0,0,20,0.00848536274925753,0
2012,20137,12,385,2,123,11,11,13,134,0.0323906212231085,0.0970149253731343
2012,20139,16,442,49,136,23,36,72,172,0.0154163305548086,0.418604651162791
2012,20141,45,76,1,54,0,3,1,57,0.0202846975088968,0.0175438596491228
2012,20143,33,177,12,49,0,0,12,49,0.0115647864054756,0.244897959183673
2012,20145,1,348,0,49,0,5,0,54,0.0111824394284531,0
2012,20147,30,78,1,24,0,0,1,24,0.00610687022900763,0.0416666666666667
2012,20149,248,546,116,235,0,30,116,265,0.0194281524926686,0.437735849056604
2012,20151,29,190,72,100,0,0,72,100,0.0155690487311225,0.72
2012,20153,6,19,7,23,0,0,7,23,0.0119170984455959,0.304347826086957
2012,20155,292,1557,159,738,88,247,247,985,0.0227898475278221,0.250761421319797
2012,20157,5,58,8,69,0,0,8,69,0.0184541321208879,0.115942028985507
2012,20159,28,264,38,170,0,3,38,173,0.0263117870722433,0.219653179190751
2012,20161,394,810,881,1963,483,901,1364,2864,0.0829808193776439,0.476256983240223
2012,20163,24,149,21,50,0,6,21,56,0.015233949945593,0.375
2012,20165,37,97,5,56,0,0,5,56,0.0229696472518458,0.0892857142857143
2012,20167,30,190,2,62,0,0,2,62,0.0121164744967755,0.032258064516129
2012,20169,145,688,404,696,0,22,404,718,0.0197090310183914,0.562674094707521
2012,20171,0,3,24,82,0,0,24,82,0.0238372093023256,0.292682926829268
2012,20173,1608,5269,2109,6337,343,944,2452,7281,0.0231356586560918,0.336766927619832
2012,20175,105,210,109,718,15,17,124,735,0.05701652315569,0.168707482993197
2012,20177,569,2489,642,2367,161,334,803,2701,0.0228200167284832,0.297297297297297
2012,20179,2,22,4,37,0,0,4,37,0.020868584320361,0.108108108108108
2012,20181,26,78,0,100,0,0,0,100,0.0234246896228625,0
2012,20183,9,41,0,16,0,0,0,16,0.00539993250084374,0
2012,20185,26,93,3,20,3,3,6,23,0.00748454279205988,0.260869565217391
2012,20187,0,109,1,14,0,0,1,14,0.0103703703703704,0.0714285714285714
2012,20189,13,139,4,143,0,11,4,154,0.0420535226652103,0.025974025974026
2012,20191,70,789,46,143,3,13,49,156,0.00982739070177649,0.314102564102564
2012,20193,40,187,67,175,15,15,82,190,0.0385551948051948,0.431578947368421
2012,20195,18,141,17,21,0,0,17,21,0.0100190839694656,0.80952380952381
2012,20197,30,124,11,22,0,2,11,24,0.00496791554543573,0.458333333333333
2012,20199,2,19,2,4,0,0,2,4,0.00378787878787879,0.5
2012,20201,9,48,6,49,0,6,6,55,0.0132116262310834,0.109090909090909
2012,20203,3,24,24,60,0,0,24,60,0.0397350993377483,0.4
2012,20205,18,181,3,48,0,0,3,48,0.00744532340623546,0.0625
2012,20207,0,90,6,24,0,4,6,28,0.011517893870835,0.214285714285714
2012,20209,538,2724,594,3432,173,561,767,3993,0.0408182041216879,0.192086150763837
2012,21001,34,446,21,143,0,0,21,143,0.011558357581636,0.146853146853147
2012,21003,58,490,37,312,14,14,51,326,0.0242758209844367,0.156441717791411
2012,21005,141,1072,30,46,0,5,30,51,0.00352477710968277,0.588235294117647
2012,21007,4,152,27,78,0,1,27,79,0.013458262350937,0.341772151898734
2012,21009,69,642,82,277,0,55,82,332,0.0115269772932435,0.246987951807229
2012,21011,71,366,0,77,0,33,0,110,0.0139381652306133,0
2012,21013,13,296,78,437,0,0,78,437,0.0221232217890953,0.178489702517162
2012,21015,704,2955,901,2432,239,440,1140,2872,0.0373802582257393,0.396935933147632
2012,21017,40,484,24,173,0,38,24,211,0.0154172146719275,0.113744075829384
2012,21019,95,705,119,1067,8,75,127,1142,0.0325069027354758,0.111208406304729
2012,21021,140,1113,105,557,12,40,117,597,0.0311131957473421,0.195979899497487
2012,21023,5,112,18,47,0,24,18,71,0.0125953521376619,0.253521126760563
2012,21025,5,203,9,34,5,12,14,46,0.00482281400712938,0.304347826086957
2012,21027,17,428,39,216,0,18,39,234,0.0170442129798237,0.166666666666667
2012,21029,215,1728,208,1016,26,44,234,1060,0.0212941200104462,0.220754716981132
2012,21031,10,168,7,139,0,0,7,139,0.0159057100354732,0.0503597122302158
2012,21033,58,206,31,151,0,4,31,155,0.017087421452982,0.2
2012,21035,30,177,303,558,55,100,358,658,0.0293095768374165,0.544072948328267
2012,21037,613,1785,498,1493,18,50,516,1543,0.0259323372716425,0.334413480233312
2012,21039,0,50,0,4,0,0,0,4,0.00112296462661426,0
2012,21041,3,347,13,222,0,2,13,224,0.0313418217433888,0.0580357142857143
2012,21043,8,307,0,281,0,0,0,281,0.0151580537274787,0
2012,21045,80,409,25,56,0,22,25,78,0.0071454745327959,0.320512820512821
2012,21047,194,835,331,3105,166,1211,497,4316,0.101852507374631,0.115152919369787
2012,21049,190,906,163,529,0,6,163,535,0.0217038539553753,0.304672897196262
2012,21051,0,201,0,324,0,0,0,324,0.021608643457383,0
2012,21053,0,131,0,78,0,7,0,85,0.0121654501216545,0
2012,21055,0,117,0,126,5,5,5,131,0.0200152788388082,0.0381679389312977
2012,21057,4,30,10,80,0,13,10,93,0.0194276164612492,0.10752688172043
2012,21059,212,1385,111,644,18,52,129,696,0.0107500308908934,0.185344827586207
2012,21061,25,329,0,101,0,22,0,123,0.0149416909620991,0
2012,21063,32,492,0,6,0,0,0,6,0.00111090538789113,0
2012,21065,27,208,4,5,0,0,4,5,0.000485578323783626,0.8
2012,21067,1474,6677,3030,5349,825,1828,3855,7177,0.0374389016113803,0.537132506618364
2012,21069,26,77,0,226,0,49,0,275,0.0282195997947665,0
2012,21071,94,842,25,294,15,20,40,314,0.0115001464986815,0.127388535031847
2012,21073,399,1459,113,567,19,45,132,612,0.0181596985252663,0.215686274509804
2012,21075,56,196,36,155,0,4,36,159,0.0329124404885117,0.226415094339623
2012,21077,30,205,51,135,0,11,51,146,0.0265406289765497,0.349315068493151
2012,21079,92,559,0,98,0,3,0,101,0.00857021637675011,0
2012,21081,53,594,78,112,0,4,78,116,0.00738806445449334,0.672413793103448
2012,21083,32,305,12,233,19,101,31,334,0.0132555462951939,0.092814371257485
2012,21085,66,481,0,411,7,30,7,441,0.0252997533130629,0.0158730158730159
2012,21087,6,229,0,73,0,6,0,79,0.0099408581854788,0
2012,21089,45,503,90,472,0,7,90,479,0.0184884977613092,0.187891440501044
2012,21091,41,242,0,122,0,9,0,131,0.0227746870653686,0
2012,21093,234,1501,1115,4120,317,1023,1432,5143,0.0763951812955838,0.278436710091386
2012,21095,28,316,17,131,0,5,17,136,0.00679354613117538,0.125
2012,21097,84,581,27,144,0,2,27,146,0.0112671708597006,0.184931506849315
2012,21099,0,292,0,86,16,30,16,116,0.00946861480695453,0.137931034482759
2012,21101,120,609,133,465,23,28,156,493,0.0156032409165717,0.316430020283976
2012,21103,75,541,0,36,13,33,13,69,0.00657769304099142,0.188405797101449
2012,21105,38,236,7,66,0,0,7,66,0.0188733199885616,0.106060606060606
2012,21107,36,731,59,358,0,28,59,386,0.0118430337802596,0.152849740932642
2012,21109,15,175,2,161,0,0,2,161,0.0173866090712743,0.0124223602484472
2012,21111,1583,6745,4850,11374,823,2447,5673,13821,0.027515374247712,0.410462339917517
2012,21113,434,1857,409,615,30,47,439,662,0.0213259454932028,0.663141993957704
2012,21115,45,373,20,145,0,0,20,145,0.00895061728395062,0.137931034482759
2012,21117,749,3414,1120,2907,95,256,1215,3163,0.0297980178618533,0.3841289914638
2012,21119,0,253,77,143,0,12,77,155,0.0137912625678441,0.496774193548387
2012,21121,75,762,31,269,32,68,63,337,0.015962485790072,0.186943620178042
2012,21123,19,225,9,74,0,24,9,98,0.0101291989664083,0.0918367346938776
2012,21125,190,998,74,625,0,28,74,653,0.0164136336215564,0.113323124042879
2012,21127,44,395,6,203,24,24,30,227,0.0209641669745105,0.13215859030837
2012,21129,9,272,0,106,0,0,0,106,0.0187544232130219,0
2012,21131,24,164,0,104,0,0,0,104,0.0132113821138211,0
2012,21133,18,258,28,58,0,15,28,73,0.00427876443350331,0.383561643835616
2012,21135,59,272,46,298,0,36,46,334,0.034886149989555,0.137724550898204
2012,21137,80,655,34,142,0,0,34,142,0.00854340894049696,0.23943661971831
2012,21139,20,163,4,104,0,0,4,104,0.0152559777028018,0.0384615384615385
2012,21141,13,344,46,493,0,19,46,512,0.0280979036329711,0.08984375
2012,21143,28,424,9,51,0,0,9,51,0.00767609873570138,0.176470588235294
2012,21145,104,1281,347,1221,0,73,347,1294,0.0281396107426335,0.268160741885626
2012,21147,5,400,25,547,0,37,25,584,0.0470664087685364,0.0428082191780822
2012,21149,0,136,25,55,0,0,25,55,0.00838798230898277,0.454545454545455
2012,21151,372,1570,201,1019,23,104,224,1123,0.0219344505644752,0.19946571682992
2012,21153,23,156,22,109,0,0,22,109,0.0121367331032179,0.201834862385321
2012,21155,31,553,17,46,0,7,17,53,0.0039505068574836,0.320754716981132
2012,21157,173,393,95,411,0,18,95,429,0.0189873417721519,0.221445221445221
2012,21159,0,228,42,311,8,23,50,334,0.0372975991066443,0.149700598802395
2012,21161,62,443,29,310,15,22,44,332,0.0280856103544539,0.132530120481928
2012,21163,144,806,53,823,23,139,76,962,0.0517788901447871,0.079002079002079
2012,21165,1,119,0,39,0,45,0,84,0.0192043895747599,0
2012,21167,131,605,29,220,0,5,29,225,0.0152511353622992,0.128888888888889
2012,21169,33,286,7,61,0,14,7,75,0.0108256351039261,0.0933333333333333
2012,21171,57,227,9,72,11,11,20,83,0.0109715796430932,0.240963855421687
2012,21173,29,573,13,323,12,26,25,349,0.0195540116539668,0.0716332378223496
2012,21175,44,606,84,188,0,0,84,188,0.0191504532953041,0.446808510638298
2012,21177,9,657,42,170,0,42,42,212,0.0096671226630187,0.19811320754717
2012,21179,110,1101,43,336,0,9,43,345,0.0119704382221297,0.12463768115942
2012,21181,60,189,39,85,0,0,39,85,0.0173221927858162,0.458823529411765
2012,21183,5,327,6,111,8,9,14,120,0.0074234457160532,0.116666666666667
2012,21185,574,2035,340,930,43,82,383,1012,0.0254220257234727,0.378458498023715
2012,21187,0,175,32,55,35,37,67,92,0.0123606072820099,0.728260869565217
2012,21189,0,54,0,1,0,0,0,1,0.000292654375182909,0
2012,21191,36,305,5,166,0,11,5,177,0.0180024410089504,0.0282485875706215
2012,21193,68,350,14,205,0,12,14,217,0.0109862292426083,0.0645161290322581
2012,21195,81,559,186,769,0,31,186,800,0.0176401843399264,0.2325
2012,21197,52,210,0,80,0,0,0,80,0.0094944220270591,0
2012,21199,155,696,138,719,0,37,138,756,0.0172256653299307,0.182539682539683
2012,21201,0,50,0,12,0,0,0,12,0.00846859562455893,0
2012,21203,44,226,15,115,0,22,15,137,0.0116476789661622,0.109489051094891
2012,21205,122,817,44,301,0,0,44,301,0.0221290986619615,0.146179401993355
2012,21207,13,184,0,68,0,10,0,78,0.00635541432412613,0
2012,21209,534,2142,188,519,6,29,194,548,0.0181103142866585,0.354014598540146
2012,21211,263,1231,88,477,0,19,88,496,0.0174383855430159,0.17741935483871
2012,21213,23,414,144,684,0,0,144,684,0.0588893671975893,0.210526315789474
2012,21215,93,382,94,162,0,0,94,162,0.0140247597610596,0.580246913580247
2012,21217,28,348,6,157,0,20,6,177,0.0110040410320174,0.0338983050847458
2012,21219,13,217,36,202,0,2,36,204,0.0256636054849667,0.176470588235294
2012,21221,29,191,64,190,0,20,64,210,0.0207059751528298,0.304761904761905
2012,21223,2,168,17,321,37,37,54,358,0.0593206296603148,0.150837988826816
2012,21225,0,160,29,130,0,15,29,145,0.0156115417743325,0.2
2012,21227,340,1901,531,1978,164,294,695,2272,0.0327821545032176,0.305897887323944
2012,21229,38,227,33,102,0,10,33,112,0.0143479374839867,0.294642857142857
2012,21231,46,315,0,279,0,1,0,280,0.0193731405244586,0
2012,21233,2,339,6,137,13,13,19,150,0.0161082474226804,0.126666666666667
2012,21235,45,725,104,501,0,24,104,525,0.0227203877612845,0.198095238095238
2012,21237,29,76,0,22,0,0,0,22,0.00447427293064877,0
2012,21239,219,629,140,288,9,46,149,334,0.0194945426953832,0.446107784431138
2012,22001,42,790,156,595,27,133,183,728,0.0186336993524278,0.251373626373626
2012,22003,15,824,22,476,0,63,22,539,0.0301977701832035,0.0408163265306122
2012,22005,315,1753,359,1356,36,350,395,1706,0.0250908181724589,0.231535756154748
2012,22007,41,461,0,46,0,7,0,53,0.00340398201669878,0
2012,22009,96,1109,80,311,1,62,81,373,0.0132863147396167,0.2171581769437
2012,22011,68,959,81,746,58,142,139,888,0.0379341278995258,0.156531531531532
2012,22013,36,390,0,174,0,0,0,174,0.0180629087511679,0
2012,22015,655,2774,965,2761,91,202,1056,2963,0.0390886783989868,0.356395545055687
2012,22017,1008,4313,1018,3006,118,454,1136,3460,0.0207537323728234,0.328323699421965
2012,22019,395,2382,637,2883,230,435,867,3318,0.0267546123080893,0.26130198915009
2012,22021,89,300,3,49,0,0,3,49,0.0070973348783314,0.0612244897959184
2012,22023,0,37,20,102,0,0,20,102,0.0220827018835246,0.196078431372549
2012,22025,15,581,15,48,0,1,15,49,0.0069365798414496,0.306122448979592
2012,22027,64,501,7,193,13,15,20,208,0.0175868774837237,0.0961538461538462
2012,22029,58,580,82,415,0,22,82,437,0.0319958998389222,0.187643020594966
2012,22031,22,322,33,200,0,68,33,268,0.0150561797752809,0.123134328358209
2012,22033,1551,4621,2179,4829,583,954,2762,5783,0.0211865648675977,0.477606778488674
2012,22035,5,329,5,106,0,19,5,125,0.0252270433905146,0.04
2012,22037,109,932,23,72,0,0,23,72,0.00507757404795487,0.319444444444444
2012,22039,104,997,0,192,0,116,0,308,0.0143409228476975,0
2012,22041,74,722,17,265,0,12,17,277,0.0201469197759837,0.0613718411552347
2012,22043,50,762,5,553,0,31,5,584,0.0388065652202804,0.00856164383561644
2012,22045,166,801,92,336,12,69,104,405,0.00870219166308552,0.25679012345679
2012,22047,135,2047,31,282,0,0,31,282,0.012478980440747,0.109929078014184
2012,22049,41,324,0,268,1,25,1,293,0.0264512051999639,0.00341296928327645
2012,22051,1704,7371,1896,5570,514,1444,2410,7014,0.0236880232624899,0.343598517251212
2012,22053,94,829,44,310,8,43,52,353,0.0172144738125427,0.147308781869688
2012,22055,1187,4004,789,2566,150,409,939,2975,0.0212090967419976,0.31563025210084
2012,22057,199,1710,37,264,11,150,48,414,0.00659477197062618,0.115942028985507
2012,22059,32,319,7,249,0,28,7,277,0.0275265825300606,0.0252707581227437
2012,22061,280,816,207,627,114,149,321,776,0.0304875653164656,0.413659793814433
2012,22063,678,2749,107,984,34,81,141,1065,0.0129783085547161,0.132394366197183
2012,22065,15,524,39,123,0,11,39,134,0.0170591979630808,0.291044776119403
2012,22067,86,324,0,107,0,0,0,107,0.0057477438762355,0
2012,22069,96,833,54,299,24,47,78,346,0.0146207479399958,0.225433526011561
2012,22071,2407,7076,4239,9041,713,1133,4952,10174,0.0449717324327789,0.486730882642029
2012,22073,293,2733,385,1277,43,82,428,1359,0.0140754627088275,0.314937454010302
2012,22075,111,587,89,438,23,24,112,462,0.0311299777643016,0.242424242424242
2012,22077,13,162,19,79,0,45,19,124,0.0079701761151819,0.153225806451613
2012,22079,422,2355,256,970,58,233,314,1203,0.0140072656140841,0.261014131338321
2012,22081,10,119,10,30,0,0,10,30,0.0050744248985115,0.333333333333333
2012,22083,125,806,14,72,0,0,14,72,0.00528169014084507,0.194444444444444
2012,22085,43,186,32,162,2,20,34,182,0.0111793611793612,0.186813186813187
2012,22087,137,1022,73,570,10,99,83,669,0.0292050464923386,0.12406576980568
2012,22089,197,1002,36,433,0,0,36,433,0.0128061043416539,0.0831408775981524
2012,22091,10,338,18,86,0,0,18,86,0.0118932374498686,0.209302325581395
2012,22093,56,238,57,143,15,16,72,159,0.011137573550014,0.452830188679245
2012,22095,196,1113,54,294,0,13,54,307,0.0106143899318881,0.175895765472313
2012,22097,148,1061,75,422,16,69,91,491,0.00918787425149701,0.185336048879837
2012,22099,40,1051,16,242,18,51,34,293,0.00867325794801966,0.116040955631399
2012,22101,136,709,118,622,0,99,118,721,0.020387965162312,0.163661581137309
2012,22103,1457,3968,1473,4319,199,425,1672,4744,0.0302027095854131,0.352445193929174
2012,22105,141,1508,321,1326,69,155,390,1481,0.0196252517756811,0.263335584064821
2012,22107,0,126,6,9,0,0,6,9,0.00251889168765743,0.666666666666667
2012,22109,184,1681,136,883,17,36,153,919,0.0128706076775486,0.166485310119695
2012,22111,14,226,65,128,0,12,65,140,0.00908559932506976,0.464285714285714
2012,22113,159,898,29,282,15,28,44,310,0.00825917834496723,0.141935483870968
2012,22115,86,499,638,2282,125,504,763,2786,0.091335278497197,0.273869346733668
2012,22117,68,780,48,597,0,14,48,611,0.0194685189905684,0.0785597381342062
2012,22119,50,811,28,472,7,25,35,497,0.0178302360622803,0.0704225352112676
2012,22121,148,1048,30,227,0,18,30,245,0.0158987670343932,0.122448979591837
2012,22123,0,162,3,170,0,5,3,175,0.0224935732647815,0.0171428571428571
2012,22125,133,418,13,119,0,20,13,139,0.0118328083766068,0.0935251798561151
2012,22127,48,573,33,256,0,0,33,256,0.024214907302308,0.12890625
2012,23001,390,2162,282,827,25,105,307,932,0.0126750985992112,0.329399141630901
2012,23003,124,455,118,738,8,65,126,803,0.0155346191793542,0.156911581569116
2012,23005,1683,4758,3125,5271,328,668,3453,5939,0.0300236083938709,0.581411011954875
2012,23007,92,363,79,249,0,8,79,257,0.0122136679022907,0.307392996108949
2012,23009,249,752,267,744,32,115,299,859,0.0213851822346146,0.348079161816065
2012,23011,495,1876,497,1216,105,186,602,1402,0.0163192140703752,0.429386590584879
2012,23013,149,780,158,388,15,18,173,406,0.0137213153536787,0.426108374384236
2012,23015,147,492,232,316,36,65,268,381,0.0147274835717047,0.703412073490814
2012,23017,149,1199,155,638,0,23,155,661,0.0159739004349927,0.234493192133132
2012,23019,436,2075,660,1553,60,170,720,1723,0.0166589318173029,0.417875798026698
2012,23021,76,319,27,192,20,34,47,226,0.0172584956090111,0.207964601769911
2012,23023,312,1134,185,371,0,21,185,392,0.0153322642468807,0.471938775510204
2012,23025,91,832,71,502,7,7,78,509,0.0136034422855921,0.153241650294695
2012,23027,190,690,215,453,7,16,222,469,0.0169295744143234,0.473347547974414
2012,23029,53,435,167,386,54,60,221,446,0.0187080536912752,0.495515695067265
2012,23031,590,2371,1258,3515,117,233,1375,3748,0.0266605966624461,0.366862326574173
2012,24001,107,816,202,1107,13,52,215,1159,0.0224238671980807,0.185504745470233
2012,24003,4332,11719,4975,9318,1005,2005,5980,11323,0.03103382119169,0.52812858783008
2012,24005,4355,14774,3708,7265,1519,2786,5227,10051,0.0183207470475545,0.520047756442145
2012,24009,425,1348,659,1307,94,157,753,1464,0.0250294917166744,0.514344262295082
2012,24011,72,751,62,329,4,30,66,359,0.0164211874485408,0.183844011142061
2012,24013,970,2524,465,1160,76,202,541,1362,0.012169297986973,0.397209985315712
2012,24015,209,1136,585,2071,13,150,598,2221,0.0332300971019046,0.269248086447546
2012,24017,534,2342,742,2432,139,298,881,2730,0.0285810004397077,0.322710622710623
2012,24019,125,539,95,238,25,64,120,302,0.0131310056958998,0.397350993377483
2012,24021,1225,3358,1570,3399,211,672,1781,4071,0.0261969111969112,0.437484647506755
2012,24023,70,237,164,565,0,14,164,579,0.0274498648840848,0.283246977547496
2012,24025,1408,3621,1096,2267,139,390,1235,2657,0.0161105485590245,0.464809936018065
2012,24027,3758,6810,3314,4525,871,1341,4185,5866,0.0303977199119057,0.713433344698261
2012,24029,86,235,223,373,6,8,229,381,0.0270596590909091,0.601049868766404
2012,24031,4213,9356,16640,23504,5318,9606,21958,33110,0.0495930404982371,0.663183328299607
2012,24033,3690,9417,5741,17605,1731,4225,7472,21830,0.0390296056454367,0.342281264315163
2012,24035,322,1216,70,392,30,63,100,455,0.0137628554143981,0.21978021978022
2012,24037,318,1057,860,2324,148,506,1008,2830,0.0419812790197445,0.356183745583039
2012,24039,54,1589,146,266,25,31,171,297,0.0174234424498416,0.575757575757576
2012,24041,169,806,278,495,48,82,326,577,0.0206403147916294,0.564991334488735
2012,24043,263,3047,703,2314,68,325,771,2639,0.0259432571125224,0.292156119742327
2012,24045,281,1345,418,1624,256,364,674,1988,0.0319039671331365,0.339034205231388
2012,24047,160,910,175,854,36,58,211,912,0.0238450074515648,0.231359649122807
2012,24510,3791,11806,4907,7979,1334,2487,6241,10466,0.0255693617187615,0.596311866997898
2012,25001,1169,2767,1249,2734,106,395,1355,3129,0.0190645049260634,0.433045701502077
2012,25003,353,858,683,1870,105,266,788,2136,0.0229472621209028,0.368913857677903
2012,25005,1268,5315,1803,5162,301,998,2104,6160,0.0164520686606788,0.341558441558442
2012,25007,139,253,105,127,7,153,112,280,0.0225933994997176,0.4
2012,25009,3546,8552,3417,7566,815,2578,4232,10144,0.0199883348834277,0.417192429022082
2012,25011,474,1341,367,860,62,279,429,1139,0.0220552640241659,0.376646180860404
2012,25013,1057,3274,1177,3787,474,2297,1651,6084,0.0199251333745984,0.271367521367521
2012,25015,1266,2888,1337,1935,422,606,1759,2541,0.0260652811685781,0.692247146792601
2012,25017,14364,25526,16052,21989,7435,11443,23487,33432,0.0320261788530658,0.702530509691314
2012,25019,54,61,105,169,0,23,105,192,0.0261366730193302,0.546875
2012,25021,9264,16562,5092,7326,1778,3152,6870,10478,0.0224958885639817,0.655659476999427
2012,25023,3102,9356,1320,2929,319,1095,1639,4024,0.0119646175574221,0.407306163021869
2012,25025,9502,17599,9214,12651,3401,6745,12615,19396,0.0411970858732822,0.650391833367705
2012,25027,3980,9222,3064,6649,1408,2658,4472,9307,0.0173717464139392,0.480498549478887
2012,26001,46,330,18,103,2,14,20,117,0.013265306122449,0.170940170940171
2012,26003,56,471,20,118,0,0,20,118,0.0162132453970871,0.169491525423729
2012,26005,395,2476,185,495,12,127,197,622,0.00841325019274729,0.316720257234727
2012,26007,73,431,49,180,0,54,49,234,0.0109972741799041,0.209401709401709
2012,26009,61,522,25,101,12,55,37,156,0.00901265237737593,0.237179487179487
2012,26011,61,499,28,90,0,20,28,110,0.00938086303939963,0.254545454545455
2012,26013,14,574,3,22,0,4,3,26,0.0040086339808819,0.115384615384615
2012,26015,174,1062,36,275,21,74,57,349,0.00864567592340278,0.163323782234957
2012,26017,348,2008,82,609,106,124,188,733,0.00982837221775275,0.256480218281037
2012,26019,86,347,43,89,2,11,45,100,0.00777363184079602,0.45
2012,26021,235,1005,824,1773,219,385,1043,2158,0.0201967262211158,0.483317886932345
2012,26023,132,1182,40,264,0,31,40,295,0.00969884271436086,0.135593220338983
2012,26025,480,2562,335,1249,77,343,412,1592,0.0175698046573226,0.258793969849246
2012,26027,96,491,130,712,8,42,138,754,0.0207936901905629,0.183023872679045
2012,26029,134,485,30,187,6,32,36,219,0.0117495573796878,0.164383561643836
2012,26031,88,716,36,165,0,8,36,173,0.00901793160967473,0.208092485549133
2012,26033,133,1450,61,402,0,58,61,460,0.0170118343195266,0.132608695652174
2012,26035,114,912,13,165,4,24,17,189,0.008559007336292,0.0899470899470899
2012,26037,532,1745,235,520,7,60,242,580,0.0118614258251871,0.417241379310345
2012,26039,113,646,0,74,0,2,0,76,0.00724983306305447,0
2012,26041,89,451,34,339,15,56,49,395,0.0148306675677705,0.124050632911392
2012,26043,88,379,93,374,0,46,93,420,0.0222563722113296,0.221428571428571
2012,26045,946,3548,308,743,144,229,452,972,0.013289763327363,0.465020576131687
2012,26047,335,844,82,279,14,63,96,342,0.0149156090540364,0.280701754385965
2012,26049,1284,5584,688,2152,214,501,902,2653,0.00943584125877608,0.339992461364493
2012,26051,119,746,32,121,6,39,38,160,0.00849166755121537,0.2375
2012,26053,34,437,55,385,33,33,88,418,0.0340585024036503,0.210526315789474
2012,26055,787,2895,293,789,61,176,354,965,0.0158012804768221,0.366839378238342
2012,26057,115,1672,25,160,15,45,40,205,0.00724049023416805,0.195121951219512
2012,26059,62,581,79,366,4,88,83,454,0.0146107553181218,0.182819383259912
2012,26061,153,513,136,302,140,175,276,477,0.0222056701270891,0.578616352201258
2012,26063,141,584,30,111,13,41,43,152,0.00631753948462178,0.282894736842105
2012,26065,1676,5859,1462,2341,1063,1762,2525,4103,0.0245406478778889,0.61540336339264
2012,26067,289,2498,41,363,26,91,67,454,0.0107166462090454,0.147577092511013
2012,26069,42,762,26,152,29,70,55,222,0.0112839280268375,0.247747747747748
2012,26071,17,120,22,169,0,10,22,179,0.0195137904720375,0.122905027932961
2012,26073,330,1569,163,451,87,99,250,550,0.0155525393055084,0.454545454545455
2012,26075,536,4701,291,999,50,191,341,1190,0.0109721914877923,0.286554621848739
2012,26077,1446,4430,778,2039,166,478,944,2517,0.0162137091839035,0.375049662296385
2012,26079,99,409,11,143,3,12,14,155,0.0127635046113307,0.0903225806451613
2012,26081,2556,8399,2001,4558,680,1604,2681,6162,0.0160694726959787,0.435086011035378
2012,26083,5,61,24,45,0,0,24,45,0.0265957446808511,0.533333333333333
2012,26085,18,437,4,105,0,3,4,108,0.012302084519877,0.037037037037037
2012,26087,356,2177,146,472,0,102,146,574,0.0095159151193634,0.254355400696864
2012,26089,236,530,141,237,0,3,141,240,0.0147556102059637,0.5875
2012,26091,234,1825,473,981,3,199,476,1180,0.017566320302498,0.403389830508475
2012,26093,1422,4361,331,1102,83,224,414,1326,0.0108144257588856,0.312217194570136
2012,26095,20,325,5,31,0,12,5,43,0.00863107185869129,0.116279069767442
2012,26097,54,206,50,191,6,14,56,205,0.0241973559962229,0.273170731707317
2012,26099,3311,15632,930,3407,712,2574,1642,5981,0.0103393970615437,0.274536030764086
2012,26101,81,768,66,177,16,45,82,222,0.012179733362594,0.369369369369369
2012,26103,120,943,240,568,40,187,280,755,0.0169328070332825,0.370860927152318
2012,26105,159,615,101,281,5,31,106,312,0.0153061224489796,0.33974358974359
2012,26107,167,815,70,188,13,66,83,254,0.00998623943385099,0.326771653543307
2012,26109,31,164,61,345,3,3,64,348,0.0198970840480274,0.183908045977011
2012,26111,224,1610,360,1258,110,144,470,1402,0.0249014244609428,0.335235378031384
2012,26113,35,360,30,79,0,15,30,94,0.00920936612128931,0.319148936170213
2012,26115,492,2386,282,1565,44,195,326,1760,0.0171583442197828,0.185227272727273
2012,26117,197,1586,32,322,16,54,48,376,0.00885080740078151,0.127659574468085
2012,26119,15,322,7,176,0,17,7,193,0.0254852766406972,0.0362694300518135
2012,26121,447,3505,167,1275,20,112,187,1387,0.0122278056951424,0.134823359769286
2012,26123,106,1325,87,338,0,21,87,359,0.0110322362558004,0.242339832869081
2012,26125,9705,27563,5672,9972,3752,6154,9424,16126,0.0193671507853868,0.584397866798958
2012,26127,139,583,9,318,3,54,12,372,0.0206059934636902,0.032258064516129
2012,26129,83,765,21,137,0,9,21,146,0.00921833564844046,0.143835616438356
2012,26131,11,52,11,48,0,3,11,51,0.00947427085268438,0.215686274509804
2012,26133,83,640,19,103,14,20,33,123,0.00772758685681975,0.268292682926829
2012,26135,11,186,9,81,0,3,9,84,0.0131682081831008,0.107142857142857
2012,26137,140,758,34,271,8,11,42,282,0.0167697431018078,0.148936170212766
2012,26139,1204,5114,571,1496,275,442,846,1938,0.0119378345581215,0.436532507739938
2012,26141,32,257,30,120,0,8,30,128,0.0123635661161016,0.234375
2012,26143,45,816,11,195,0,46,11,241,0.0125934054449496,0.045643153526971
2012,26145,506,2911,375,1346,79,201,454,1547,0.0116988694369872,0.293471234647705
2012,26147,379,2585,315,1010,39,105,354,1115,0.0100127516657986,0.317488789237668
2012,26149,58,479,99,486,0,19,99,505,0.0124885624551772,0.196039603960396
2012,26151,111,684,12,151,0,21,12,172,0.00578910167951264,0.0697674418604651
2012,26153,10,103,5,55,0,4,5,59,0.00943245403677058,0.0847457627118644
2012,26155,171,1565,100,580,43,108,143,688,0.0144903117101938,0.207848837209302
2012,26157,84,1207,117,392,27,53,144,445,0.011656538139145,0.323595505617978
2012,26159,196,1116,157,889,56,115,213,1004,0.0197813023347453,0.212151394422311
2012,26161,2766,7012,3523,5298,2066,2556,5589,7854,0.0366269959707506,0.71161191749427
2012,26163,4865,18611,3027,10022,1807,4587,4834,14609,0.0123335469268286,0.330891915942227
2012,26165,108,785,64,253,0,24,64,277,0.0124159569699686,0.231046931407942
2012,27001,100,461,6,64,0,16,6,80,0.00640102416386622,0.075
2012,27003,2256,9631,683,2260,215,864,898,3124,0.0142812734287856,0.287451984635083
2012,27005,112,534,109,439,1,18,110,457,0.0204090746695248,0.240700218818381
2012,27007,282,749,131,359,16,53,147,412,0.0152411956200059,0.356796116504854
2012,27009,309,1471,26,166,0,13,26,179,0.00715484850907347,0.145251396648045
2012,27011,16,128,4,16,2,2,6,18,0.0046801872074883,0.333333333333333
2012,27013,309,1149,225,419,30,50,255,469,0.0126729355814959,0.543710021321962
2012,27015,113,339,14,104,0,25,14,129,0.00731873368886872,0.108527131782946
2012,27017,277,890,84,231,10,34,94,265,0.0108539832070448,0.354716981132075
2012,27019,1077,2783,492,818,52,164,544,982,0.0168992754994923,0.553971486761711
2012,27021,112,643,60,156,5,14,65,170,0.00828217870018513,0.382352941176471
2012,27023,14,293,19,91,2,4,21,95,0.0111150111150111,0.221052631578947
2012,27025,349,2308,112,276,0,117,112,393,0.0109605087014726,0.28498727735369
2012,27027,102,584,533,1251,31,116,564,1367,0.0387900456854232,0.412582297000732
2012,27029,30,172,4,36,2,2,6,38,0.00638870208473436,0.157894736842105
2012,27031,15,96,33,38,17,42,50,80,0.0197677291821102,0.625
2012,27033,45,208,5,52,0,5,5,57,0.00707898658718331,0.087719298245614
2012,27035,212,1251,152,368,12,51,164,419,0.00964881980426022,0.391408114558473
2012,27037,2942,9024,1850,3886,438,1180,2288,5066,0.0192249309329366,0.451638373470193
2012,27039,93,346,31,72,0,10,31,82,0.00639226691612099,0.378048780487805
2012,27041,149,634,5,96,0,18,5,114,0.00447884335834676,0.043859649122807
2012,27043,23,198,10,72,0,2,10,74,0.00714285714285714,0.135135135135135
2012,27045,76,352,40,117,20,49,60,166,0.0115062036459416,0.36144578313253
2012,27047,42,437,63,177,3,66,66,243,0.0110404361653794,0.271604938271605
2012,27049,201,851,232,558,33,56,265,614,0.0192019014260696,0.431596091205212
2012,27051,28,134,10,35,0,3,10,38,0.00875576036866359,0.263157894736842
2012,27053,9119,20002,9009,15591,3040,5261,12049,20852,0.0266392761966084,0.57783426050259
2012,27055,20,110,116,405,41,48,157,453,0.0337958818263205,0.346578366445916
2012,27057,80,444,51,194,9,16,60,210,0.0142392188771359,0.285714285714286
2012,27059,245,1387,39,290,0,40,39,330,0.0131568455466071,0.118181818181818
2012,27061,183,762,72,398,10,57,82,455,0.0141872719902716,0.18021978021978
2012,27063,44,214,11,94,2,3,13,97,0.013351686166552,0.134020618556701
2012,27065,87,437,38,158,21,23,59,181,0.0159569778718152,0.325966850828729
2012,27067,114,684,83,296,5,18,88,314,0.0111871170015676,0.280254777070064
2012,27069,7,53,25,48,0,0,25,48,0.0146207736826074,0.520833333333333
2012,27071,55,299,31,117,0,13,31,130,0.0134519867549669,0.238461538461538
2012,27073,40,119,7,35,0,2,7,37,0.00692883895131086,0.189189189189189
2012,27075,19,241,14,132,27,31,41,163,0.0200073646741132,0.251533742331288
2012,27077,0,80,28,53,13,13,41,66,0.0220073357785929,0.621212121212121
2012,27079,163,605,23,168,6,28,29,196,0.0104183277520863,0.147959183673469
2012,27081,35,112,25,62,0,4,25,66,0.0155917788802268,0.378787878787879
2012,27083,80,386,121,321,17,27,138,348,0.0215894286246045,0.396551724137931
2012,27085,189,744,41,65,6,16,47,81,0.00329081010806858,0.580246913580247
2012,27087,11,77,21,36,0,0,21,36,0.0105664807748753,0.583333333333333
2012,27089,40,170,10,45,2,5,12,50,0.00746937556020317,0.24
2012,27091,25,121,46,150,3,21,49,171,0.0115830115830116,0.286549707602339
2012,27093,93,459,10,66,3,29,13,95,0.00601418080526716,0.136842105263158
2012,27095,153,905,39,138,3,17,42,155,0.00884854712564937,0.270967741935484
2012,27097,118,717,37,166,44,68,81,234,0.0103484875287458,0.346153846153846
2012,27099,100,696,84,355,26,79,110,434,0.0167982659854467,0.253456221198157
2012,27101,23,135,17,62,2,7,19,69,0.0109697933227345,0.27536231884058
2012,27103,232,1097,134,319,31,46,165,365,0.0179944784066259,0.452054794520548
2012,27105,32,211,95,253,5,109,100,362,0.0261522901314839,0.276243093922652
2012,27107,6,65,3,66,0,10,3,76,0.0158730158730159,0.0394736842105263
2012,27109,638,1970,1516,2698,328,550,1844,3248,0.0334935137253284,0.567733990147783
2012,27111,170,962,120,420,12,70,132,490,0.0119442277691108,0.269387755102041
2012,27113,43,347,9,100,6,9,15,109,0.0116093300670998,0.137614678899083
2012,27115,112,784,16,264,4,39,20,303,0.0143888308481337,0.066006600660066
2012,27117,81,187,19,110,0,17,19,127,0.0194665849172287,0.149606299212598
2012,27119,94,515,107,594,0,15,107,609,0.0292521254623181,0.175697865353038
2012,27121,26,212,44,80,1,28,45,108,0.013583197082128,0.416666666666667
2012,27123,5184,13094,3163,5925,1058,2316,4221,8241,0.0248975066239271,0.51219512195122
2012,27125,16,85,2,23,0,3,2,26,0.00918403391027905,0.0769230769230769
2012,27127,34,292,29,119,9,18,38,137,0.0125274323335772,0.277372262773723
2012,27129,34,319,39,124,1,10,40,134,0.0122006737685514,0.298507462686567
2012,27131,435,2641,275,777,8,138,283,915,0.0230984777724484,0.309289617486339
2012,27133,29,98,19,121,12,25,31,146,0.022245924120067,0.212328767123288
2012,27135,63,230,8,65,2,22,10,87,0.00825583602201556,0.114942528735632
2012,27137,828,2631,576,1418,123,327,699,1745,0.0128994581488354,0.400573065902579
2012,27139,1340,4106,452,920,69,217,521,1137,0.0137449982471198,0.458223394898857
2012,27141,802,3488,147,570,32,144,179,714,0.0128825057736721,0.250700280112045
2012,27143,26,250,11,103,2,7,13,110,0.0106331561140648,0.118181818181818
2012,27145,671,3208,263,1016,113,292,376,1308,0.0142477451962877,0.287461773700306
2012,27147,86,689,172,400,0,13,172,413,0.0170196983433611,0.416464891041162
2012,27149,25,141,8,116,10,37,18,153,0.0260869565217391,0.117647058823529
2012,27151,25,212,17,22,0,9,17,31,0.00444890929965557,0.548387096774194
2012,27153,60,367,25,76,4,10,29,86,0.00514754294607051,0.337209302325581
2012,27155,3,46,4,63,9,19,13,82,0.0314537782892213,0.158536585365854
2012,27157,75,348,33,117,22,51,55,168,0.0111613074674462,0.327380952380952
2012,27159,52,319,20,81,0,10,20,91,0.00961132234896494,0.21978021978022
2012,27161,135,327,25,345,11,13,36,358,0.0270433600241728,0.100558659217877
2012,27163,2419,6378,1341,2337,224,404,1565,2741,0.0173597476788225,0.570959503830719
2012,27165,41,186,7,35,0,13,7,48,0.00630086636912575,0.145833333333333
2012,27167,56,90,12,150,10,13,22,163,0.0358241758241758,0.134969325153374
2012,27169,131,474,152,407,18,18,170,425,0.0139453996587479,0.4
2012,27171,895,2870,270,764,82,236,352,1000,0.0126296113868576,0.352
2012,27173,55,213,15,108,7,24,22,132,0.018397212543554,0.166666666666667
2012,28001,86,162,46,708,9,46,55,754,0.0334724318565214,0.0729442970822281
2012,28003,196,632,150,569,0,0,150,569,0.0227827827827828,0.263620386643234
2012,28005,16,152,0,72,0,0,0,72,0.00797695546199867,0
2012,28007,47,322,10,217,0,7,10,224,0.0175644946287148,0.0446428571428571
2012,28009,3,75,92,223,0,2,92,225,0.039198606271777,0.408888888888889
2012,28011,24,509,106,562,0,8,106,570,0.0268210050818746,0.185964912280702
2012,28013,19,402,16,105,13,49,29,154,0.0154602951510892,0.188311688311688
2012,28015,32,194,0,50,0,0,0,50,0.00679255535932618,0
2012,28017,43,256,16,94,0,17,16,111,0.00978318350079323,0.144144144144144
2012,28019,0,185,9,135,0,0,9,135,0.023239800309864,0.0666666666666667
2012,28021,11,83,3,50,0,0,3,50,0.00849473326537547,0.06
2012,28023,13,153,43,78,6,12,49,90,0.00799786723540389,0.544444444444444
2012,28025,34,566,9,57,0,8,9,65,0.00482338972989018,0.138461538461538
2012,28027,53,385,28,266,0,12,28,278,0.0177806204029421,0.100719424460432
2012,28029,116,427,24,118,0,0,24,118,0.00628964340919994,0.203389830508475
2012,28031,63,448,11,80,0,4,11,84,0.0066193853427896,0.130952380952381
2012,28033,333,1826,917,4596,70,241,987,4837,0.0468451890949591,0.204052098408104
2012,28035,604,2030,353,1033,37,210,390,1243,0.0275952402095729,0.313757039420756
2012,28037,17,44,0,16,0,0,0,16,0.00295584703491594,0
2012,28039,75,594,35,272,0,148,35,420,0.0289315974374871,0.0833333333333333
2012,28041,41,1270,43,186,16,43,59,229,0.0231383247448722,0.25764192139738
2012,28043,103,386,14,208,0,60,14,268,0.0186694531522118,0.0522388059701493
2012,28045,456,1589,126,823,0,41,126,864,0.0285742633197738,0.145833333333333
2012,28047,566,3250,1346,5187,207,818,1553,6005,0.0492402810918961,0.258617818484596
2012,28049,1059,3706,738,1798,60,252,798,2050,0.0134825844470167,0.389268292682927
2012,28051,11,181,47,150,0,30,47,180,0.0159179342058719,0.261111111111111
2012,28053,28,81,12,29,0,18,12,47,0.00804106073567151,0.25531914893617
2012,28055,7,117,0,56,0,0,0,56,0.0506787330316742,0
2012,28057,180,524,26,258,0,15,26,273,0.0176916596461668,0.0952380952380952
2012,28059,520,2461,612,2522,30,211,642,2733,0.0298858367596886,0.234906695938529
2012,28061,70,244,7,37,0,0,7,37,0.00323144104803493,0.189189189189189
2012,28063,0,154,0,33,0,0,0,33,0.00656455142231947,0
2012,28065,18,194,26,50,0,0,26,50,0.00592697961119014,0.52
2012,28067,135,842,191,665,14,61,205,726,0.0165515354626906,0.28236914600551
2012,28069,0,357,0,31,0,0,0,31,0.00443554156531693,0
2012,28071,158,686,548,1036,45,45,593,1081,0.0420083161698986,0.548566142460685
2012,28073,796,2427,298,1049,30,114,328,1163,0.0334051414620135,0.282029234737747
2012,28075,208,1565,479,1305,7,115,486,1420,0.027160399372633,0.342253521126761
2012,28077,27,139,23,102,0,0,23,102,0.0119340119340119,0.225490196078431
2012,28079,43,384,3,210,0,21,3,231,0.0162790697674419,0.012987012987013
2012,28081,370,1662,247,867,33,106,280,973,0.018039230227298,0.287769784172662
2012,28083,99,768,0,189,19,23,19,212,0.0108701225452494,0.089622641509434
2012,28085,95,326,71,295,0,0,71,295,0.0129142406864247,0.240677966101695
2012,28087,69,904,264,883,28,183,292,1066,0.0279430653490262,0.273921200750469
2012,28089,1149,2135,612,1170,114,188,726,1358,0.0220518982819655,0.53460972017673
2012,28091,61,535,14,326,8,65,22,391,0.0221957311534968,0.0562659846547315
2012,28093,0,881,0,290,0,0,0,290,0.0117737810076733,0
2012,28095,45,530,23,141,0,0,23,141,0.00568800677719956,0.163120567375887
2012,28097,2,80,0,11,6,6,6,17,0.00242822453935152,0.352941176470588
2012,28099,112,602,14,129,0,4,14,133,0.00716363244640741,0.105263157894737
2012,28101,73,357,0,180,0,0,0,180,0.0128214260274948,0
2012,28103,27,80,24,43,0,0,24,43,0.00586470267321331,0.558139534883721
2012,28105,414,818,138,462,69,104,207,566,0.0235676215856096,0.365724381625442
2012,28107,114,384,47,361,50,110,97,471,0.0213218650973291,0.205944798301486
2012,28109,106,583,188,1220,14,65,202,1285,0.034741936356017,0.157198443579767
2012,28111,0,93,0,108,0,15,0,123,0.0151702022693636,0
2012,28113,119,518,63,472,17,17,80,489,0.0189168278529981,0.16359918200409
2012,28115,13,388,11,233,43,64,54,297,0.0153377401363355,0.181818181818182
2012,28117,12,582,77,205,29,29,106,234,0.0141108363987216,0.452991452991453
2012,28119,43,167,0,82,0,4,0,86,0.0165799113167534,0
2012,28121,1296,4452,568,1786,43,210,611,1996,0.0210302283191622,0.306112224448898
2012,28123,16,467,12,127,15,176,27,303,0.017059850233658,0.0891089108910891
2012,28125,13,98,0,22,0,0,0,22,0.00718015665796345,0
2012,28127,25,547,26,144,0,0,26,144,0.00808126157472361,0.180555555555556
2012,28129,9,203,38,49,0,22,38,71,0.00660219453226706,0.535211267605634
2012,28131,51,514,133,265,0,0,133,265,0.0236396074933095,0.50188679245283
2012,28133,80,1436,56,259,9,10,65,269,0.0144857296715132,0.241635687732342
2012,28135,12,252,22,529,0,21,22,550,0.0547045951859956,0.04
2012,28137,90,450,19,148,0,13,19,161,0.00894245723172628,0.118012422360248
2012,28139,7,508,0,155,0,0,0,155,0.0106992476012977,0
2012,28141,48,284,17,178,0,16,17,194,0.0143416869963776,0.0876288659793814
2012,28143,33,233,27,210,0,36,27,246,0.0378403322565759,0.109756097560976
2012,28145,72,477,4,104,19,19,23,123,0.00687688695068769,0.186991869918699
2012,28147,89,209,1,77,0,0,1,77,0.00762376237623762,0.012987012987013
2012,28149,35,590,278,790,6,41,284,831,0.0260150893779545,0.341756919374248
2012,28151,121,584,173,467,22,85,195,552,0.0173902085564867,0.353260869565217
2012,28153,14,222,44,154,0,0,44,154,0.0114694272734043,0.285714285714286
2012,28155,96,249,5,94,0,0,5,94,0.0138622622032149,0.0531914893617021
2012,28157,2,385,53,139,0,0,53,139,0.0210160266102207,0.381294964028777
2012,28159,93,346,40,202,0,0,40,202,0.0158642896410901,0.198019801980198
2012,28161,0,188,0,9,0,18,0,27,0.00320056899004267,0
2012,28163,84,303,42,641,14,87,56,728,0.0389034361139315,0.0769230769230769
2012,29001,42,310,145,423,10,10,155,433,0.0311107917804282,0.35796766743649
2012,29003,47,445,19,66,11,16,30,82,0.00696272395346862,0.365853658536585
2012,29005,2,38,10,70,0,0,10,70,0.0172159370388588,0.142857142857143
2012,29007,90,1308,78,384,0,8,78,392,0.0226262626262626,0.198979591836735
2012,29009,103,760,51,472,3,3,54,475,0.0196118909991742,0.113684210526316
2012,29011,7,131,11,194,2,2,13,196,0.0235945588058264,0.0663265306122449
2012,29013,27,356,10,150,0,15,10,165,0.0142560912389839,0.0606060606060606
2012,29015,23,483,85,393,0,3,85,396,0.0273103448275862,0.214646464646465
2012,29017,15,230,0,58,0,10,0,68,0.00805496327884388,0
2012,29019,988,2608,1308,2344,404,653,1712,2997,0.0317593200941017,0.571237904571238
2012,29021,310,2719,448,2041,47,186,495,2227,0.0381100691354644,0.222272114952851
2012,29023,74,591,70,599,0,19,70,618,0.0210691395063412,0.113268608414239
2012,29025,7,201,0,62,2,2,2,64,0.0100850929719508,0.03125
2012,29027,157,1785,78,414,48,73,126,487,0.0167405726857104,0.258726899383984
2012,29029,181,1174,156,891,23,65,179,956,0.0294870608556183,0.187238493723849
2012,29031,304,1500,284,913,48,118,332,1031,0.0212153013560508,0.322017458777886
2012,29033,15,89,0,57,0,0,0,57,0.0088785046728972,0
2012,29035,20,116,82,84,0,0,82,84,0.020066889632107,0.976190476190476
2012,29037,650,2588,277,1255,26,116,303,1371,0.0209060827399015,0.221006564551422
2012,29039,0,189,7,116,0,0,7,116,0.0118682218129732,0.0603448275862069
2012,29041,25,181,4,15,0,10,4,25,0.0045421511627907,0.16
2012,29043,814,2797,394,1418,3,79,397,1497,0.0295861496501838,0.265197060788243
2012,29045,8,131,0,104,0,13,0,117,0.0237274386534172,0
2012,29047,1581,5710,1142,3233,102,330,1244,3563,0.0242451873677334,0.34914397979231
2012,29049,48,768,76,279,0,0,76,279,0.0198491747296528,0.272401433691756
2012,29051,580,2797,197,615,25,25,222,640,0.0125073285128005,0.346875
2012,29053,72,978,32,179,0,3,32,182,0.0154893617021277,0.175824175824176
2012,29055,155,705,15,102,0,0,15,102,0.00607323608216731,0.147058823529412
2012,29057,0,280,8,25,0,8,8,33,0.00591397849462366,0.242424242424242
2012,29059,69,307,76,294,6,42,82,336,0.0293193717277487,0.244047619047619
2012,29061,8,167,14,107,0,9,14,116,0.0209613299602458,0.120689655172414
2012,29063,50,1172,66,212,0,2,66,214,0.0223685585868088,0.308411214953271
2012,29065,64,395,0,79,0,6,0,85,0.00784567103562858,0
2012,29067,64,233,0,87,26,33,26,120,0.0125378748302163,0.216666666666667
2012,29069,19,629,59,554,0,34,59,588,0.0277515574853691,0.100340136054422
2012,29071,213,1589,385,863,0,33,385,896,0.0131768581428866,0.4296875
2012,29073,26,307,0,90,0,0,0,90,0.00836198086035492,0
2012,29075,48,214,14,101,0,0,14,101,0.0220331588132635,0.138613861386139
2012,29077,1138,4944,1191,4426,228,567,1419,4993,0.0279125670840787,0.284197877027839
2012,29079,48,430,1,81,0,50,1,131,0.0189772562653919,0.00763358778625954
2012,29081,10,108,6,131,0,0,6,131,0.021489501312336,0.0458015267175573
2012,29083,64,566,20,176,0,3,20,179,0.0113643578185512,0.111731843575419
2012,29085,0,197,2,54,0,3,2,57,0.00774772325676227,0.0350877192982456
2012,29087,17,119,21,59,0,4,21,63,0.0176767676767677,0.333333333333333
2012,29089,80,326,24,38,0,0,24,38,0.00578122622851057,0.631578947368421
2012,29091,14,392,122,488,17,51,139,539,0.0199888744669015,0.257884972170686
2012,29093,6,382,0,95,0,4,0,99,0.0134346587053874,0
2012,29095,1920,7855,4548,11659,491,1291,5039,12950,0.0290578958941978,0.389111969111969
2012,29097,299,1519,336,1828,29,58,365,1886,0.0253740178667528,0.193531283138918
2012,29099,960,4377,294,1275,38,165,332,1440,0.0098917403967687,0.230555555555556
2012,29101,235,1005,252,1069,126,336,378,1405,0.0464063945038975,0.269039145907473
2012,29103,55,127,3,65,0,0,3,65,0.023197715917202,0.0461538461538462
2012,29105,148,887,243,478,34,34,277,512,0.0214801141131062,0.541015625
2012,29107,81,1000,40,141,24,34,64,175,0.00776845563102055,0.365714285714286
2012,29109,215,1048,38,485,3,27,41,512,0.0200918259231645,0.080078125
2012,29111,35,149,0,167,0,0,0,167,0.0252800484408114,0
2012,29113,211,975,51,470,19,35,70,505,0.0149183185134856,0.138613861386139
2012,29115,48,298,0,51,0,0,0,51,0.00588235294117647,0
2012,29117,72,502,0,100,2,7,2,107,0.0101364153088291,0.0186915887850467
2012,29119,71,552,22,700,20,35,42,735,0.0503735179220067,0.0571428571428571
2012,29121,41,199,8,83,10,27,18,110,0.0102976970604756,0.163636363636364
2012,29123,17,189,119,350,0,1,119,351,0.0418355184743743,0.339031339031339
2012,29125,39,395,22,36,0,0,22,36,0.00573796620975454,0.611111111111111
2012,29127,135,636,37,224,15,52,52,276,0.0143869891576314,0.188405797101449
2012,29129,8,66,2,42,0,0,2,42,0.0161476355247982,0.0476190476190476
2012,29131,22,440,67,200,0,0,67,200,0.0119040533301589,0.335
2012,29133,21,490,43,471,0,33,43,504,0.0510379746835443,0.0853174603174603
2012,29135,105,898,41,159,12,14,53,173,0.0166811300742455,0.30635838150289
2012,29137,45,286,40,113,0,0,40,113,0.0183292781832928,0.353982300884956
2012,29139,86,457,6,124,0,0,6,124,0.0145848035756293,0.0483870967741935
2012,29141,82,482,34,173,0,0,34,173,0.0118509384847239,0.196531791907514
2012,29143,82,460,9,186,0,5,9,191,0.0150310852286141,0.0471204188481675
2012,29145,294,1581,215,843,5,74,220,917,0.0239525650402257,0.239912758996728
2012,29147,74,696,71,254,22,64,93,318,0.0253063823014484,0.292452830188679
2012,29149,2,258,13,235,0,0,13,235,0.0307350248495946,0.0553191489361702
2012,29151,87,359,4,44,0,0,4,44,0.00482932718691691,0.0909090909090909
2012,29153,20,151,6,186,0,0,6,186,0.0257190265486726,0.032258064516129
2012,29155,34,298,84,271,0,10,84,281,0.0241036198318751,0.298932384341637
2012,29157,74,434,34,186,8,22,42,208,0.0163624921334172,0.201923076923077
2012,29159,100,884,171,556,0,46,171,602,0.0219515752625438,0.284053156146179
2012,29161,244,1106,298,580,214,310,512,890,0.032593569178935,0.575280898876405
2012,29163,91,1112,7,231,22,50,29,281,0.02195655571183,0.103202846975089
2012,29165,1071,3217,908,2614,190,271,1098,2885,0.0477688550376687,0.380589254766031
2012,29167,111,864,19,176,2,16,21,192,0.00966426737806413,0.109375
2012,29169,260,1327,1092,3526,386,1253,1478,4779,0.174741306811949,0.3092697216991
2012,29171,3,90,3,54,0,0,3,54,0.0153104621491352,0.0555555555555556
2012,29173,31,221,17,61,0,4,17,65,0.00900526461623719,0.261538461538462
2012,29175,61,1409,17,238,0,10,17,248,0.0144102266124346,0.0685483870967742
2012,29177,48,468,30,62,0,0,30,62,0.00391167192429022,0.483870967741935
2012,29179,18,105,3,36,0,0,3,36,0.00763358778625954,0.0833333333333333
2012,29181,10,134,7,215,0,0,7,215,0.0221992772328343,0.0325581395348837
2012,29183,2403,6946,1641,3768,417,598,2058,4366,0.0184032270981829,0.471369674759505
2012,29185,17,307,15,97,0,3,15,100,0.0139140114094894,0.15
2012,29186,98,581,0,21,8,8,8,29,0.0023261410122724,0.275862068965517
2012,29187,362,3718,154,435,0,109,154,544,0.0120165227187383,0.283088235294118
2012,29189,5367,17900,6833,12260,1903,2809,8736,15069,0.0221892053469668,0.579733227155087
2012,29195,115,429,77,205,0,29,77,234,0.0154160353119441,0.329059829059829
2012,29197,8,96,7,54,0,0,7,54,0.0184994861253854,0.12962962962963
2012,29199,16,66,0,60,0,0,0,60,0.019280205655527,0
2012,29201,115,634,23,373,70,79,93,452,0.0173027600199058,0.205752212389381
2012,29203,4,87,41,90,0,0,41,90,0.015552099533437,0.455555555555556
2012,29205,0,92,2,63,0,3,2,66,0.0151098901098901,0.0303030303030303
2012,29207,68,720,27,270,0,12,27,282,0.0136489037316684,0.0957446808510638
2012,29209,134,923,85,833,7,37,92,870,0.0360950918972742,0.105747126436782
2012,29211,23,160,21,111,0,0,21,111,0.0243474446150472,0.189189189189189
2012,29213,259,1484,351,1779,28,113,379,1892,0.053852503344434,0.200317124735729
2012,29215,28,575,105,545,0,64,105,609,0.0342173277896393,0.172413793103448
2012,29217,59,425,51,253,3,28,54,281,0.0203064026593438,0.192170818505338
2012,29219,48,887,47,371,2,26,49,397,0.0180668062255393,0.123425692695214
2012,29221,85,831,58,117,0,7,58,124,0.00726718630955869,0.467741935483871
2012,29223,9,210,6,79,8,8,14,87,0.009009942004971,0.160919540229885
2012,29225,87,1176,20,255,0,0,20,255,0.0108997649070314,0.0784313725490196
2012,29227,0,30,1,1,0,0,1,1,0.000647668393782383,1
2012,29229,36,400,28,218,0,7,28,225,0.0180926342875523,0.124444444444444
2012,29510,3071,9960,2936,5547,741,1467,3677,7014,0.0330470262859081,0.524237239806102
2012,30001,36,236,20,170,0,6,20,176,0.0281284960843855,0.113636363636364
2012,30003,18,65,5,116,5,20,10,136,0.0187534473248759,0.0735294117647059
2012,30005,10,40,2,41,0,0,2,41,0.0103015075376884,0.0487804878048781
2012,30007,37,221,61,223,0,0,61,223,0.055007400098668,0.273542600896861
2012,30009,50,224,62,199,0,11,62,210,0.0277814525730917,0.295238095238095
2012,30011,6,27,0,7,0,0,0,7,0.0070778564206269,0
2012,30013,185,1275,484,1961,38,150,522,2111,0.0388744636576248,0.247276172430128
2012,30015,10,48,25,51,0,2,25,53,0.0137590861889927,0.471698113207547
2012,30017,23,223,29,319,0,3,29,322,0.0398860398860399,0.0900621118012422
2012,30019,0,6,26,46,0,0,26,46,0.0334302325581395,0.565217391304348
2012,30021,25,231,0,125,0,7,0,132,0.0207547169811321,0
2012,30023,83,285,26,120,0,4,26,124,0.0186718867640416,0.209677419354839
2012,30025,0,33,32,125,0,0,32,125,0.0603573153066152,0.256
2012,30027,93,304,43,140,11,24,54,164,0.0191588785046729,0.329268292682927
2012,30029,144,418,496,1468,15,94,511,1562,0.0249261948456076,0.327144686299616
2012,30031,460,1187,1476,2674,165,205,1641,2879,0.0507804921068877,0.569989579715179
2012,30033,6,6,0,1,0,0,0,1,0.0012453300124533,0
2012,30035,36,230,23,108,0,0,23,108,0.0138390568939006,0.212962962962963
2012,30037,2,19,2,2,0,10,2,12,0.0227272727272727,0.166666666666667
2012,30039,15,122,36,61,0,0,36,61,0.0251442704039571,0.590163934426229
2012,30041,62,334,15,169,18,29,33,198,0.0196117274167987,0.166666666666667
2012,30043,65,399,70,198,0,12,70,210,0.0257605495583906,0.333333333333333
2012,30045,4,44,20,32,0,2,20,34,0.0211706102117061,0.588235294117647
2012,30047,115,565,176,561,0,16,176,577,0.0300708776318532,0.305025996533795
2012,30049,436,1046,397,857,37,119,434,976,0.0223750573131591,0.444672131147541
2012,30051,0,17,0,11,14,14,14,25,0.0150240384615385,0.56
2012,30053,60,92,66,411,24,35,90,446,0.0303483941208492,0.201793721973094
2012,30055,2,24,0,5,0,0,0,5,0.00385208012326656,0
2012,30057,54,125,53,187,0,4,53,191,0.0322962461954684,0.277486910994764
2012,30059,3,53,7,42,0,0,7,42,0.0300429184549356,0.166666666666667
2012,30061,0,66,21,31,0,0,21,31,0.0101043024771838,0.67741935483871
2012,30063,527,2102,1072,2408,75,257,1147,2665,0.0377030162412993,0.430393996247655
2012,30065,0,119,6,11,0,1,6,12,0.00357142857142857,0.5
2012,30067,48,91,71,372,71,77,142,449,0.0381478334749363,0.316258351893096
2012,30069,0,6,0,20,0,0,0,20,0.0492610837438424,0
2012,30071,4,39,6,21,0,3,6,24,0.00781504395962227,0.25
2012,30073,5,132,8,70,5,17,13,87,0.0206749049429658,0.149425287356322
2012,30075,2,53,6,35,0,0,6,35,0.0290697674418605,0.171428571428571
2012,30077,96,526,93,193,0,0,93,193,0.0357672349888807,0.481865284974093
2012,30079,15,35,5,5,0,0,5,5,0.0053475935828877,1
2012,30081,175,573,135,728,4,104,139,832,0.0286511243500121,0.167067307692308
2012,30083,49,170,59,251,0,0,59,251,0.0365942557224085,0.235059760956175
2012,30085,6,62,12,130,0,0,12,130,0.0212696335078534,0.0923076923076923
2012,30087,62,158,45,139,0,7,45,146,0.0252726328544227,0.308219178082192
2012,30089,11,105,16,197,0,0,16,197,0.0232860520094563,0.0812182741116751
2012,30091,12,43,7,49,0,13,7,62,0.024770275669197,0.112903225806452
2012,30093,129,807,213,575,50,61,263,636,0.0271969211032713,0.413522012578616
2012,30095,43,190,49,77,0,12,49,89,0.0135588056063376,0.550561797752809
2012,30097,0,21,1,61,0,0,1,61,0.0243124750896772,0.0163934426229508
2012,30099,26,158,14,30,3,5,17,35,0.00818521983161834,0.485714285714286
2012,30101,12,374,26,120,0,1,26,121,0.0317835566062516,0.214876033057851
2012,30103,0,2,13,16,0,0,13,16,0.0295748613678373,0.8125
2012,30105,18,44,0,33,0,3,0,36,0.00682852807283763,0
2012,30107,3,35,0,11,0,0,0,11,0.00732356857523302,0
2012,30109,0,0,3,15,0,0,3,15,0.0219619326500732,0.2
2012,30111,523,2450,860,2836,38,174,898,3010,0.0300801471029121,0.298338870431894
2012,31001,108,666,142,439,0,17,142,456,0.0227306714520712,0.31140350877193
2012,31003,35,109,5,52,0,2,5,54,0.0115015974440895,0.0925925925925926
2012,31005,7,18,0,0,0,0,0,0,0,NA
2012,31007,0,23,7,30,0,5,7,35,0.0680933852140078,0.2
2012,31009,6,17,5,9,0,0,5,9,0.0223880597014925,0.555555555555556
2012,31011,27,78,11,34,0,2,11,36,0.00945378151260504,0.305555555555556
2012,31013,39,171,40,263,23,23,63,286,0.0377059986816084,0.22027972027972
2012,31015,11,24,0,9,0,2,0,11,0.0074424898511502,0
2012,31017,7,32,0,37,0,0,0,37,0.0163427561837456,0
2012,31019,334,911,205,441,14,81,219,522,0.0188047119853021,0.419540229885057
2012,31021,20,123,28,60,0,0,28,60,0.0121679172581626,0.466666666666667
2012,31023,29,240,26,80,5,15,31,95,0.0164104335809293,0.326315789473684
2012,31025,117,352,73,256,0,11,73,267,0.0155576273161636,0.273408239700375
2012,31027,44,217,4,126,6,14,10,140,0.0232403718459495,0.0714285714285714
2012,31029,6,25,47,84,0,26,47,110,0.0391877449234058,0.427272727272727
2012,31031,23,67,35,76,0,17,35,93,0.0224420849420849,0.376344086021505
2012,31033,104,249,16,251,31,82,47,333,0.0473751600512164,0.141141141141141
2012,31035,21,70,11,57,0,0,11,57,0.0129398410896708,0.192982456140351
2012,31037,12,177,8,140,4,81,12,221,0.0342211210901208,0.0542986425339367
2012,31039,24,52,19,72,0,9,19,81,0.012924844423169,0.234567901234568
2012,31041,38,174,27,64,21,23,48,87,0.0114008648931988,0.551724137931034
2012,31043,20,122,42,275,9,62,51,337,0.0261625650182439,0.1513353115727
2012,31045,17,150,43,138,0,0,43,138,0.0246252676659529,0.311594202898551
2012,31047,95,278,47,381,0,76,47,457,0.0297255106023156,0.102844638949672
2012,31049,10,29,0,33,2,4,2,37,0.0258379888268156,0.0540540540540541
2012,31051,5,90,17,91,0,5,17,96,0.0235756385068762,0.177083333333333
2012,31053,195,701,90,359,0,50,90,409,0.0164085693653214,0.220048899755501
2012,31055,2142,5570,3484,8197,997,1670,4481,9867,0.0298469989654734,0.454140062835715
2012,31057,0,5,0,47,0,0,0,47,0.031929347826087,0
2012,31059,11,144,4,16,4,5,8,21,0.00504443910641364,0.380952380952381
2012,31061,26,96,1,62,0,10,1,72,0.0307429547395389,0.0138888888888889
2012,31063,8,52,10,15,0,5,10,20,0.0108813928182807,0.5
2012,31065,23,132,15,88,0,8,15,96,0.0272417707150965,0.15625
2012,31067,131,520,21,303,0,15,21,318,0.020530699205888,0.0660377358490566
2012,31069,10,32,3,115,0,6,3,121,0.0750620347394541,0.0247933884297521
2012,31071,1,51,11,19,0,9,11,28,0.0177103099304238,0.392857142857143
2012,31073,26,73,0,10,0,0,0,10,0.00713775874375446,0
2012,31075,0,4,0,7,0,0,0,7,0.0170731707317073,0
2012,31077,10,46,0,17,0,0,0,17,0.00962627406568516,0
2012,31079,128,1127,37,967,5,40,42,1007,0.02669034429749,0.041708043694141
2012,31081,6,239,33,48,0,5,33,53,0.00849495111396057,0.622641509433962
2012,31083,9,100,21,68,0,4,21,72,0.0280373831775701,0.291666666666667
2012,31085,0,16,0,12,0,0,0,12,0.0169014084507042,0
2012,31087,4,46,0,42,0,0,0,42,0.0196998123827392,0
2012,31089,11,139,48,123,0,0,48,123,0.0167096861839424,0.390243902439024
2012,31091,2,5,8,8,0,2,8,10,0.01953125,0.8
2012,31093,10,186,4,24,0,7,4,31,0.00707439525330899,0.129032258064516
2012,31095,8,132,3,46,0,27,3,73,0.0133382057372556,0.0410958904109589
2012,31097,21,286,3,59,0,11,3,70,0.018018018018018,0.0428571428571429
2012,31099,11,271,75,93,0,0,75,93,0.0204575450945887,0.806451612903226
2012,31101,55,180,21,267,0,1,21,268,0.0435064935064935,0.0783582089552239
2012,31103,0,1,0,12,0,0,0,12,0.0200333889816361,0
2012,31105,42,95,29,100,0,0,29,100,0.0362713093942691,0.29
2012,31107,31,101,15,99,0,8,15,107,0.0174808037902304,0.14018691588785
2012,31109,711,3804,1847,4272,514,1033,2361,5305,0.0298891762306396,0.445051837888784
2012,31111,191,397,19,485,11,25,30,510,0.0208699922249049,0.0588235294117647
2012,31113,2,6,0,0,0,0,0,0,0,NA
2012,31115,0,11,0,1,0,0,0,1,0.0026525198938992,0
2012,31117,0,10,1,3,3,3,4,6,0.0210526315789474,0.666666666666667
2012,31119,140,571,169,500,22,40,191,540,0.0240867121637896,0.353703703703704
2012,31121,51,241,22,90,0,11,22,101,0.0187418816106884,0.217821782178218
2012,31123,0,41,67,108,0,0,67,108,0.0310612597066437,0.62037037037037
2012,31125,2,58,5,30,1,6,6,36,0.0137247426610751,0.166666666666667
2012,31127,80,168,41,135,0,0,41,135,0.0284210526315789,0.303703703703704
2012,31129,17,73,2,38,3,3,5,41,0.0123160108140583,0.121951219512195
2012,31131,179,457,15,114,2,22,17,136,0.0125728020708145,0.125
2012,31133,11,63,0,5,0,3,0,8,0.00393313667649951,0
2012,31135,6,63,16,29,0,0,16,29,0.0139423076923077,0.551724137931034
2012,31137,17,119,54,138,9,22,63,160,0.0251809883537929,0.39375
2012,31139,24,142,2,41,0,3,2,44,0.00898142478056746,0.0454545454545455
2012,31141,167,458,42,352,0,35,42,387,0.0185691665467108,0.108527131782946
2012,31143,23,134,11,30,0,5,11,35,0.00923726576933228,0.314285714285714
2012,31145,61,180,11,122,0,0,11,122,0.0163538873994638,0.0901639344262295
2012,31147,47,59,19,219,0,0,19,219,0.0359842260926717,0.0867579908675799
2012,31149,0,13,3,56,2,2,5,58,0.0499139414802065,0.0862068965517241
2012,31151,46,288,0,51,0,9,0,60,0.00691244239631336,0
2012,31153,1238,4286,1219,3019,124,404,1343,3423,0.0344089264173703,0.39234589541338
2012,31155,72,499,40,126,12,28,52,154,0.0109921484653819,0.337662337662338
2012,31157,189,486,184,874,9,25,193,899,0.0367568893613542,0.2146829810901
2012,31159,113,380,44,93,19,34,63,127,0.0120322122216959,0.496062992125984
2012,31161,32,81,24,85,1,1,25,86,0.0219948849104859,0.290697674418605
2012,31163,11,46,0,27,0,5,0,32,0.0140105078809107,0
2012,31165,4,10,0,12,0,0,0,12,0.0131291028446389,0
2012,31167,15,112,7,22,0,12,7,34,0.00837851158206013,0.205882352941176
2012,31169,30,105,0,37,0,0,0,37,0.00970364542355101,0
2012,31171,3,11,0,0,0,0,0,0,0,NA
2012,31173,19,65,22,106,0,0,22,106,0.0283044058744993,0.207547169811321
2012,31175,18,44,0,51,0,0,0,51,0.0163513946777813,0
2012,31177,102,313,49,164,0,4,49,168,0.01246660730187,0.291666666666667
2012,31179,60,204,123,156,0,0,123,156,0.0297880465915601,0.788461538461538
2012,31181,7,94,7,54,0,0,7,54,0.0200371057513915,0.12962962962963
2012,31183,3,7,0,2,0,0,0,2,0.00396039603960396,0
2012,31185,26,449,48,128,1,1,49,129,0.013764404609475,0.37984496124031
2012,32001,0,410,167,722,42,115,209,837,0.0510396975425331,0.249701314217443
2012,32003,389,2901,14526,53633,2526,7960,17052,61593,0.0478411926859902,0.276849642004773
2012,32005,130,776,316,1300,0,40,316,1340,0.0387428802729349,0.235820895522388
2012,32007,53,440,190,1231,36,36,226,1267,0.0420622800610849,0.17837411207577
2012,32009,5,29,0,27,0,0,0,27,0.0356200527704486,0
2012,32011,10,21,14,32,0,0,14,32,0.0262725779967159,0.4375
2012,32013,25,233,63,394,12,21,75,415,0.039139866075639,0.180722891566265
2012,32015,0,75,19,146,0,0,19,146,0.0415599202960433,0.13013698630137
2012,32017,0,192,25,44,0,3,25,47,0.0141566265060241,0.531914893617021
2012,32019,141,1675,180,1313,8,50,188,1363,0.0387689507068294,0.137931034482759
2012,32021,0,98,22,130,0,0,22,130,0.0363229952500699,0.169230769230769
2012,32023,111,1254,286,1423,0,166,286,1589,0.0495277873016862,0.17998741346759
2012,32027,14,674,7,209,0,1,7,210,0.0421263791374122,0.0333333333333333
2012,32029,59,146,0,82,0,0,0,82,0.0256651017214398,0
2012,32031,717,3571,2901,10272,778,1665,3679,11937,0.0428609899283675,0.308201390634163
2012,32033,15,178,16,237,0,0,16,237,0.0342584562012142,0.0675105485232067
2012,32510,282,2009,301,1202,7,79,308,1281,0.0331521739130435,0.240437158469945
2012,33001,323,1086,373,777,52,120,425,897,0.0206311237867427,0.473801560758082
2012,33003,270,660,372,1112,17,21,389,1133,0.0313789569889495,0.34333627537511
2012,33005,152,524,631,1645,98,181,729,1826,0.035448739104269,0.399233296823658
2012,33007,94,483,136,560,2,6,138,566,0.0230568681766335,0.243816254416961
2012,33009,313,1001,1363,2216,439,559,1802,2775,0.0461884154460719,0.649369369369369
2012,33011,1112,4169,2947,6759,415,1084,3362,7843,0.0287377801228217,0.428662501593778
2012,33013,981,3231,987,1982,58,182,1045,2164,0.0212977452340882,0.482902033271719
2012,33015,793,3060,2913,6096,204,409,3117,6505,0.0314462368450312,0.479169869331284
2012,33017,505,1944,761,2292,184,271,945,2563,0.0325266190337196,0.36870854467421
2012,33019,316,960,285,663,31,49,316,712,0.0226513536728915,0.443820224719101
2012,34001,759,2818,860,2818,269,1058,1129,3876,0.0209153994754962,0.291279669762642
2012,34003,4216,7908,5495,9076,2593,4225,8088,13301,0.02093247973007,0.608074580858582
2012,34005,1989,6278,2214,5592,522,1260,2736,6852,0.0222651147374783,0.399299474605954
2012,34007,1838,6961,2270,5794,263,1443,2533,7237,0.0211250543670219,0.350006908940169
2012,34009,439,1215,767,1735,71,291,838,2026,0.0285063034669068,0.413622902270484
2012,34011,443,4212,168,1137,62,629,230,1766,0.0169246250419282,0.130237825594564
2012,34013,3283,8290,3141,6959,1045,3424,4186,10383,0.020151852153762,0.403159009920062
2012,34015,1099,4147,716,1603,168,595,884,2198,0.0114838035527691,0.402183803457689
2012,34017,4386,7933,7887,11369,3712,6119,11599,17488,0.0395716092710886,0.663254803293687
2012,34019,1296,2733,797,1378,158,181,955,1559,0.0175184286227976,0.612572161642078
2012,34021,2773,6528,2662,4727,1122,2159,3784,6886,0.0282691605052815,0.549520766773163
2012,34023,6187,11784,4433,7570,3629,5633,8062,13203,0.0242770485081282,0.610618798757858
2012,34025,3605,7997,2403,5852,698,1551,3101,7403,0.0172013179234805,0.418884236120492
2012,34027,4603,8718,2632,4504,1102,2084,3734,6588,0.0193201580100355,0.566788099574985
2012,34029,2442,8393,1423,4444,411,1262,1834,5706,0.014318479521011,0.321416053277252
2012,34031,1757,5331,935,2447,390,1528,1325,3975,0.0122376222992568,0.333333333333333
2012,34033,169,1092,114,629,31,100,145,729,0.0161615713747312,0.198902606310014
2012,34035,3382,6263,1535,2510,899,1427,2434,3937,0.0177371105224271,0.618237236474473
2012,34037,697,2196,478,1176,75,210,553,1386,0.013557796711305,0.398989898989899
2012,34039,2934,7814,1618,3942,733,2279,2351,6221,0.0172969876938647,0.377913518726893
2012,34041,515,1739,219,898,75,223,294,1121,0.0150696348873474,0.262265834076717
2012,35001,1816,7864,5238,12346,1080,2252,6318,14598,0.0335164746858548,0.432799013563502
2012,35003,5,99,0,132,1,1,1,133,0.04258725584374,0.0075187969924812
2012,35005,205,953,340,1351,34,198,374,1549,0.0383491780550604,0.241446094254358
2012,35006,144,629,48,313,0,68,48,381,0.0212350908482889,0.125984251968504
2012,35007,52,360,84,309,30,32,114,341,0.0346052364522021,0.334310850439883
2012,35009,71,338,403,1280,46,156,449,1436,0.0492861065348709,0.312674094707521
2012,35011,0,23,19,33,0,0,19,33,0.023371104815864,0.575757575757576
2012,35013,389,2295,1386,3854,396,785,1782,4639,0.0368607570797445,0.384134511748222
2012,35015,160,539,197,842,16,41,213,883,0.0252271298782927,0.241223103057758
2012,35017,66,218,129,609,53,60,182,669,0.0321588232466471,0.272047832585949
2012,35019,9,315,0,34,0,0,0,34,0.0108591504311721,0
2012,35021,0,7,9,22,0,0,9,22,0.0471092077087794,0.409090909090909
2012,35023,4,45,31,53,0,17,31,70,0.0214855739717618,0.442857142857143
2012,35025,96,1002,294,1308,8,153,302,1461,0.037351399718778,0.206707734428474
2012,35027,190,430,52,608,0,32,52,640,0.0419287211740042,0.08125
2012,35028,127,282,503,641,47,56,550,697,0.0547740667976424,0.78909612625538
2012,35029,31,285,128,679,5,130,133,809,0.0503391201543152,0.164400494437577
2012,35031,37,375,166,733,46,58,212,791,0.0193280390959071,0.268015170670038
2012,35033,31,84,0,81,0,0,0,81,0.0228361996053003,0
2012,35035,354,860,326,1734,78,605,404,2339,0.0566769245680777,0.17272338606242
2012,35037,25,104,23,200,0,0,23,200,0.032020493115594,0.115
2012,35039,67,715,41,270,28,64,69,334,0.0124664078829501,0.206586826347305
2012,35041,54,291,126,491,13,43,139,534,0.0474413646055437,0.260299625468165
2012,35043,719,2481,1010,2556,161,288,1171,2844,0.0330045259371011,0.411744022503516
2012,35045,225,787,435,1902,12,117,447,2019,0.0256488433248218,0.221396731054978
2012,35047,70,295,102,300,0,22,102,322,0.0164403145103645,0.316770186335404
2012,35049,676,2411,2227,3746,196,558,2423,4304,0.0418144193683147,0.56296468401487
2012,35051,0,145,29,79,0,6,29,85,0.00951528042091123,0.341176470588235
2012,35053,36,206,28,105,14,21,42,126,0.0113821138211382,0.333333333333333
2012,35055,55,338,282,632,2,7,284,639,0.0267599145692868,0.444444444444444
2012,35057,29,562,55,432,0,247,55,679,0.0617328848077098,0.0810014727540501
2012,35059,4,214,12,183,0,1,12,184,0.0578980490874764,0.0652173913043478
2012,35061,126,2109,124,822,73,135,197,957,0.0193983865082904,0.205851619644723
2012,36001,2073,5667,1372,2560,576,1328,1948,3888,0.0191549739870724,0.501028806584362
2012,36003,73,494,129,329,25,43,154,372,0.012178353957965,0.413978494623656
2012,36005,3887,22661,1945,7522,1898,8744,3843,16266,0.0189884943685911,0.236259682773884
2012,36007,434,2208,568,1485,139,300,707,1785,0.0133232817818117,0.396078431372549
2012,36009,207,1127,137,481,35,101,172,582,0.0108517303102625,0.29553264604811
2012,36011,265,2039,199,573,81,101,280,674,0.0121051024623287,0.415430267062315
2012,36013,279,1566,295,1098,79,243,374,1341,0.0149041400388997,0.27889634601044
2012,36015,268,1706,510,1395,25,49,535,1444,0.0237496093814246,0.370498614958449
2012,36017,101,667,81,364,3,17,84,381,0.0108238636363636,0.220472440944882
2012,36019,156,2342,111,551,56,252,167,803,0.0144883083140878,0.207970112079701
2012,36021,331,1194,123,392,26,91,149,483,0.0106707317073171,0.308488612836439
2012,36023,129,634,142,255,41,70,183,325,0.0107002930234089,0.563076923076923
2012,36025,214,1026,39,343,29,44,68,387,0.0115113477497843,0.175710594315245
2012,36027,1252,5705,997,2112,286,661,1283,2773,0.0139289338061703,0.462675802380094
2012,36029,2255,7094,2878,5998,929,2298,3807,8296,0.0132778701630444,0.458895853423337
2012,36031,368,1499,287,681,37,61,324,742,0.0257782101167315,0.436657681940701
2012,36033,248,2602,80,294,14,74,94,368,0.0103084120003361,0.255434782608696
2012,36035,247,1338,20,227,20,58,40,285,0.00735351033361715,0.140350877192982
2012,36037,285,1241,96,349,4,37,100,386,0.00934986919872105,0.259067357512953
2012,36039,212,1409,128,438,15,24,143,462,0.0132245598969515,0.30952380952381
2012,36041,0,61,11,42,0,0,11,42,0.0111376292760541,0.261904761904762
2012,36043,217,1033,83,305,4,35,87,340,0.0076294767076564,0.255882352941176
2012,36045,301,1752,1425,4046,256,1822,1681,5868,0.0808498325962055,0.286468984321745
2012,36047,14265,26580,10123,16851,4980,14210,15103,31061,0.0187749185801638,0.48623675992402
2012,36049,92,290,23,122,9,79,32,201,0.0110082698942987,0.159203980099502
2012,36051,478,2216,107,287,0,42,107,329,0.00776108136160978,0.325227963525836
2012,36053,277,1326,173,735,108,209,281,944,0.0199198143068158,0.297669491525424
2012,36055,2063,6673,2549,5259,1340,2569,3889,7828,0.0158797456157256,0.496806336228922
2012,36057,191,1330,19,202,17,105,36,307,0.00895696571845368,0.117263843648208
2012,36059,7843,16257,2439,4983,1513,3768,3952,8751,0.00956044460273518,0.45160553079648
2012,36061,15248,27211,28057,34077,14432,19200,42489,53277,0.0450143465961898,0.797511121121685
2012,36063,838,3211,277,1105,48,160,325,1265,0.00847156834513102,0.256916996047431
2012,36065,629,5003,341,1158,189,509,530,1667,0.0104334873008124,0.317936412717456
2012,36067,1869,5383,1681,3839,965,1758,2646,5597,0.0181872536499612,0.472753260675362
2012,36069,1081,2558,313,589,75,173,388,762,0.0103266025206668,0.509186351706037
2012,36071,1695,4728,1391,3269,163,541,1554,3810,0.0162045602439616,0.407874015748032
2012,36073,135,1737,42,311,0,40,42,351,0.0119245795821301,0.11965811965812
2012,36075,238,1499,192,690,54,168,246,858,0.0108829386471163,0.286713286713287
2012,36077,250,940,157,581,45,64,202,645,0.0160276321347812,0.313178294573643
2012,36079,662,2042,292,600,117,142,409,742,0.0107851972441059,0.551212938005391
2012,36081,11414,28143,6405,13186,5510,14933,11915,28119,0.0180516377372251,0.423734841210569
2012,36083,1307,4047,408,1003,85,181,493,1184,0.0110566372507821,0.416385135135135
2012,36085,1515,4973,1051,1905,225,691,1276,2596,0.00821880510730986,0.491525423728814
2012,36087,1222,2827,946,1933,424,1004,1370,2937,0.0149118843199277,0.466462376574736
2012,36089,269,1958,375,1139,43,188,418,1327,0.0186888247306528,0.314996232102487
2012,36091,1573,4259,1379,2324,351,628,1730,2952,0.0193464669104636,0.586043360433604
2012,36093,905,2924,536,1100,173,290,709,1390,0.0132690563696244,0.510071942446043
2012,36095,88,564,23,177,9,26,32,203,0.00911622058559368,0.157635467980296
2012,36097,57,353,11,200,0,45,11,245,0.0186595582635187,0.0448979591836735
2012,36099,143,1441,66,363,3,10,69,373,0.0151743216305276,0.184986595174263
2012,36101,242,1732,226,781,79,95,305,876,0.0128675930550251,0.348173515981735
2012,36103,4704,11437,2509,5277,1188,2718,3697,7995,0.00794557850171931,0.462414008755472
2012,36105,346,2065,122,733,34,185,156,918,0.0171383765215443,0.169934640522876
2012,36107,231,580,87,518,2,35,89,553,0.015625,0.160940325497288
2012,36109,860,1849,1434,1956,872,1098,2306,3054,0.0528666389696718,0.755075311067453
2012,36111,1166,4386,528,1283,53,250,581,1533,0.0120185334723605,0.378995433789954
2012,36113,197,1217,269,694,33,90,302,784,0.0166503844030073,0.385204081632653
2012,36115,287,2325,145,570,12,55,157,625,0.0140090554534451,0.2512
2012,36117,589,2136,110,816,0,109,110,925,0.0144013700762883,0.118918918918919
2012,36119,6002,11993,4095,6310,1948,4267,6043,10577,0.0163955009641677,0.571334026661624
2012,36121,142,2113,32,236,0,36,32,272,0.00905368971141364,0.117647058823529
2012,36123,135,455,89,213,11,38,100,251,0.015270426476851,0.398406374501992
2012,37001,671,2287,482,1427,202,390,684,1817,0.0181876420127524,0.376444689047881
2012,37003,131,827,32,430,0,59,32,489,0.0189925039810463,0.065439672801636
2012,37005,0,66,10,212,0,0,10,212,0.0261180239004558,0.0471698113207547
2012,37007,92,970,11,315,0,0,11,315,0.017120495679113,0.0349206349206349
2012,37009,90,473,32,121,3,96,35,217,0.0108505425271264,0.161290322580645
2012,37011,97,725,67,279,0,10,67,289,0.0222633079115631,0.231833910034602
2012,37013,144,535,190,627,11,71,201,698,0.0207176990887774,0.287965616045845
2012,37015,95,767,0,73,0,0,0,73,0.00490756302521008,0
2012,37017,89,632,0,137,0,22,0,159,0.0066655487549258,0
2012,37019,862,2249,993,2589,61,325,1054,2914,0.0358487316389046,0.361702127659574
2012,37021,1457,4158,2568,5596,145,573,2713,6169,0.0363652440462155,0.439779542875669
2012,37023,191,1585,139,845,2,64,141,909,0.0146031134030556,0.155115511551155
2012,37025,1015,3717,430,2315,23,326,453,2641,0.0227274683097682,0.171525937145021
2012,37027,137,1387,168,626,0,46,168,672,0.0117300005236607,0.25
2012,37029,91,233,28,235,10,11,38,246,0.0377532228360958,0.154471544715447
2012,37031,339,1705,455,1134,112,266,567,1400,0.0285988601311462,0.405
2012,37033,60,1205,38,195,0,30,38,225,0.0132166353383459,0.168888888888889
2012,37035,513,2617,505,1569,6,210,511,1779,0.016954483074108,0.287240022484542
2012,37037,657,1313,493,885,75,92,568,977,0.0211161061640875,0.581371545547595
2012,37039,175,331,72,574,0,0,72,574,0.0280931871574002,0.125435540069686
2012,37041,39,207,0,230,0,0,0,230,0.022535763276504,0
2012,37043,41,171,11,115,0,0,11,115,0.014792899408284,0.0956521739130435
2012,37045,227,1819,218,991,18,54,236,1045,0.0158278175787226,0.225837320574163
2012,37047,181,1574,51,390,0,64,51,454,0.0115783836168422,0.112334801762115
2012,37049,449,1984,674,2887,152,736,826,3623,0.0546315424400983,0.227987855368479
2012,37051,862,4016,2885,10515,1144,4003,4029,14518,0.0751986408511255,0.27751756440281
2012,37053,13,124,94,456,28,46,122,502,0.0307899901864573,0.243027888446215
2012,37055,273,502,380,870,55,110,435,980,0.0391123882503193,0.443877551020408
2012,37057,640,3033,349,1095,23,132,372,1227,0.0109717167562347,0.303178484107579
2012,37059,217,808,138,584,12,35,150,619,0.0215042556887268,0.24232633279483
2012,37061,122,1668,79,461,0,156,79,617,0.0159732829368059,0.128038897893031
2012,37063,3373,7384,4097,6801,1208,1892,5305,8693,0.0491496483253047,0.610261129644542
2012,37065,83,1776,64,639,20,61,84,700,0.0186925870540483,0.12
2012,37067,1682,5870,1650,4052,401,620,2051,4672,0.0202372856394107,0.438998287671233
2012,37069,138,1246,95,383,7,55,102,438,0.0107205795966321,0.232876712328767
2012,37071,492,3229,410,1786,156,443,566,2229,0.0159978755625094,0.253925527142216
2012,37073,0,101,26,254,0,17,26,271,0.032564287430906,0.0959409594095941
2012,37075,30,88,9,71,0,2,9,73,0.0121282605083901,0.123287671232877
2012,37077,206,1601,129,619,65,147,194,766,0.0186474511904182,0.253263707571802
2012,37079,28,1210,5,103,0,44,5,147,0.0101183920704846,0.0340136054421769
2012,37081,1936,6555,2642,6496,802,1450,3444,7946,0.0249453750910415,0.433425622954946
2012,37083,170,1002,76,380,15,61,91,441,0.0118031207344164,0.206349206349206
2012,37085,617,3269,667,2120,99,514,766,2634,0.0366990372424171,0.29081245254366
2012,37087,379,1022,402,1134,25,67,427,1201,0.0277482556258953,0.355537052456286
2012,37089,429,2059,635,2041,35,285,670,2326,0.0298010275332795,0.28804815133276
2012,37091,66,440,127,880,1,23,128,903,0.0536446266262698,0.141749723145072
2012,37093,419,2174,360,912,184,622,544,1534,0.0532638888888889,0.354628422425033
2012,37095,33,393,0,27,0,11,0,38,0.00918984280532044,0
2012,37097,560,2360,754,2692,109,253,863,2945,0.0276204231692677,0.293039049235993
2012,37099,108,738,189,454,20,69,209,523,0.0206214020976264,0.39961759082218
2012,37101,482,3229,286,1582,132,159,418,1741,0.0159044817568926,0.240091901206203
2012,37103,18,326,5,32,0,0,5,32,0.00445310325633176,0.15625
2012,37105,82,1081,370,985,44,67,414,1052,0.0275941664043647,0.393536121673004
2012,37107,110,854,79,497,11,84,90,581,0.014399365535701,0.154905335628227
2012,37109,370,1626,458,1415,0,108,458,1523,0.0281505304794647,0.300722258699934
2012,37111,126,1033,65,213,27,99,92,312,0.00979745642958078,0.294871794871795
2012,37113,33,254,229,758,54,101,283,859,0.0340791874950409,0.329452852153667
2012,37115,67,462,75,315,4,48,79,363,0.0249656121045392,0.21763085399449
2012,37117,54,432,19,178,0,19,19,197,0.0115407147041593,0.0964467005076142
2012,37119,4435,11361,10559,22606,2596,4564,13155,27170,0.0450077359634505,0.484173721015826
2012,37121,22,212,9,94,0,26,9,120,0.0105764145954521,0.075
2012,37123,32,614,37,120,11,16,48,136,0.00724290355221814,0.352941176470588
2012,37125,391,1285,904,1851,64,200,968,2051,0.0322712611124223,0.471964895173086
2012,37127,261,2362,76,695,58,142,134,837,0.0129432322513801,0.160095579450418
2012,37129,1527,4992,1426,4085,230,429,1656,4514,0.0329973172318511,0.366858661940629
2012,37131,56,703,12,291,0,13,12,304,0.0194809355975649,0.0394736842105263
2012,37133,165,1711,1562,6413,354,1738,1916,8151,0.0885872341350491,0.235063182431603
2012,37135,1724,3734,2072,2806,840,1234,2912,4040,0.0496717240022623,0.720792079207921
2012,37137,74,429,11,138,3,15,14,153,0.015476431317014,0.0915032679738562
2012,37139,94,1071,158,891,0,71,158,962,0.0365974282888229,0.164241164241164
2012,37141,295,2058,258,846,47,75,305,921,0.025383088964833,0.331161780673181
2012,37143,2,158,47,131,0,0,47,131,0.0134138849068196,0.358778625954198
2012,37145,96,520,72,389,25,72,97,461,0.0169541392372476,0.210412147505423
2012,37147,706,2414,796,2183,92,326,888,2509,0.0253424104076603,0.353925866879235
2012,37149,77,348,193,410,0,22,193,432,0.0281304942371557,0.446759259259259
2012,37151,445,2691,216,834,14,82,230,916,0.00957417898279574,0.251091703056769
2012,37153,36,610,110,422,0,57,110,479,0.0155848381324223,0.22964509394572
2012,37155,230,1758,272,978,16,94,288,1072,0.0128761035373251,0.26865671641791
2012,37157,247,1354,383,979,7,237,390,1216,0.0185428039891427,0.320723684210526
2012,37159,372,3201,294,1237,36,116,330,1353,0.014544008255579,0.24390243902439
2012,37161,229,875,197,1047,0,17,197,1064,0.0225500169549,0.18515037593985
2012,37163,288,1601,75,616,16,105,91,721,0.0171173523895444,0.12621359223301
2012,37165,100,800,120,471,0,0,120,471,0.0198549869319619,0.254777070063694
2012,37167,498,1386,95,367,34,122,129,489,0.0119009954002288,0.263803680981595
2012,37169,140,885,16,191,24,71,40,262,0.00785230474135347,0.152671755725191
2012,37171,143,904,127,390,82,178,209,568,0.0111431542189002,0.367957746478873
2012,37173,29,89,62,290,13,35,75,325,0.0336892298123769,0.230769230769231
2012,37175,18,539,113,315,0,54,113,369,0.0151533817913022,0.306233062330623
2012,37177,5,399,0,32,0,0,0,32,0.00941176470588235,0
2012,37179,1402,3798,1168,2758,59,446,1227,3204,0.0254346272922124,0.382958801498127
2012,37181,68,727,16,125,0,25,16,150,0.00508646998982706,0.106666666666667
2012,37183,6345,13988,9938,18596,2158,4677,12096,23273,0.0398589445848833,0.519743909251064
2012,37185,103,455,4,265,46,135,50,400,0.0269487300410968,0.125
2012,37187,20,128,26,104,0,2,26,106,0.011866114407254,0.245283018867925
2012,37189,385,1192,309,603,112,147,421,750,0.0268961807423346,0.561333333333333
2012,37191,386,2511,402,1640,155,716,557,2356,0.0295471362102913,0.23641765704584
2012,37193,91,726,151,288,0,24,151,312,0.00639213275968039,0.483974358974359
2012,37195,252,1627,291,1046,2,44,293,1090,0.020191541781672,0.268807339449541
2012,37197,106,529,48,253,0,30,48,283,0.0107359635811836,0.169611307420495
2012,37199,30,284,5,156,16,24,21,180,0.0137920465864685,0.116666666666667
2012,38001,5,49,8,38,0,0,8,38,0.0214326001128032,0.210526315789474
2012,38003,88,179,36,117,0,6,36,123,0.0157409777322754,0.292682926829268
2012,38005,11,58,6,49,0,2,6,51,0.0132433134250844,0.117647058823529
2012,38007,15,25,31,67,0,0,31,67,0.103076923076923,0.462686567164179
2012,38009,22,80,15,54,20,39,35,93,0.0199956998494947,0.376344086021505
2012,38011,20,42,10,45,0,0,10,45,0.0197976242850858,0.222222222222222
2012,38013,2,30,5,41,0,0,5,41,0.0273151232511659,0.121951219512195
2012,38015,648,1848,295,1481,81,148,376,1629,0.0296775368919657,0.230816451810927
2012,38017,485,1522,1728,3971,120,429,1848,4400,0.0472726882043899,0.42
2012,38019,5,42,4,13,0,2,4,15,0.00499666888740839,0.266666666666667
2012,38021,22,75,45,108,0,0,45,108,0.0300919476177208,0.416666666666667
2012,38023,17,41,0,20,6,6,6,26,0.0156156156156156,0.230769230769231
2012,38025,25,102,3,58,0,0,3,58,0.0222991157247213,0.0517241379310345
2012,38027,15,55,10,33,0,27,10,60,0.0340136054421769,0.166666666666667
2012,38029,26,61,15,56,0,9,15,65,0.0250674893945237,0.230769230769231
2012,38031,22,78,7,26,0,23,7,49,0.0203319502074689,0.142857142857143
2012,38033,0,8,15,49,0,1,15,50,0.0448028673835125,0.3
2012,38035,155,522,645,1541,183,424,828,1965,0.0508461419034311,0.421374045801527
2012,38037,11,57,4,36,5,5,9,41,0.0229434806939004,0.219512195121951
2012,38039,3,34,11,26,1,6,12,32,0.017139796464917,0.375
2012,38041,17,56,2,79,1,1,3,80,0.042350449973531,0.0375
2012,38043,9,60,3,50,0,0,3,50,0.0274423710208562,0.06
2012,38045,14,42,13,38,0,0,13,38,0.0123376623376623,0.342105263157895
2012,38047,5,29,0,20,0,0,0,20,0.0137646249139711,0
2012,38049,45,159,20,78,0,2,20,80,0.0201409869083585,0.25
2012,38051,13,35,0,4,0,6,0,10,0.0045475216007276,0
2012,38053,22,118,19,203,0,1,19,204,0.0468642315644383,0.0931372549019608
2012,38055,45,230,47,171,4,9,51,180,0.0265330188679245,0.283333333333333
2012,38057,136,333,36,126,0,0,36,126,0.020497803806735,0.285714285714286
2012,38059,158,767,133,402,0,42,133,444,0.0236635932420189,0.29954954954955
2012,38061,7,154,14,158,0,5,14,163,0.0320109976433621,0.0858895705521472
2012,38063,3,56,14,46,0,0,14,46,0.0193847450484619,0.304347826086957
2012,38065,0,10,0,7,0,1,0,8,0.00600600600600601,0
2012,38067,20,180,18,78,3,11,21,89,0.0165735567970205,0.235955056179775
2012,38069,0,105,0,43,0,1,0,44,0.0136858475894246,0
2012,38071,93,207,37,128,0,21,37,149,0.0189182326053834,0.248322147651007
2012,38073,7,141,8,69,12,12,20,81,0.0207745575788664,0.246913580246914
2012,38075,12,64,4,13,0,6,4,19,0.0106382978723404,0.210526315789474
2012,38077,124,322,19,274,3,32,22,306,0.0289471194778167,0.0718954248366013
2012,38079,18,74,24,43,0,9,24,52,0.00656648566738225,0.461538461538462
2012,38081,29,79,9,25,0,10,9,35,0.0126217093400649,0.257142857142857
2012,38083,2,2,3,16,0,0,3,16,0.0149672591206735,0.1875
2012,38085,0,45,17,47,0,9,17,56,0.0260707635009311,0.303571428571429
2012,38087,9,9,0,9,0,0,0,9,0.015817223198594,0
2012,38089,121,587,227,555,0,11,227,566,0.0345564442273643,0.401060070671378
2012,38091,16,44,0,20,0,2,0,22,0.0152354570637119,0
2012,38093,124,501,82,468,0,40,82,508,0.0349765904709446,0.161417322834646
2012,38095,23,92,0,14,0,5,0,19,0.0114526823387583,0
2012,38097,73,169,39,131,16,20,55,151,0.0275045537340619,0.364238410596026
2012,38099,36,124,11,149,18,24,29,173,0.0218131383179927,0.167630057803468
2012,38101,184,649,684,1700,184,291,868,1991,0.0518057868442964,0.435961828227022
2012,38103,4,49,59,79,2,6,61,85,0.0261216963736939,0.717647058823529
2012,38105,60,367,181,897,13,50,194,947,0.0603107884345943,0.204857444561774
2012,39001,36,378,26,136,0,19,26,155,0.00807291666666667,0.167741935483871
2012,39003,224,1679,233,782,0,31,233,813,0.011724665061075,0.286592865928659
2012,39005,153,745,148,471,0,0,148,471,0.0134486893952373,0.314225053078556
2012,39007,185,1368,183,979,21,202,204,1181,0.016983031348864,0.172734970364098
2012,39009,297,810,329,656,139,149,468,805,0.0239747446168508,0.581366459627329
2012,39011,117,801,67,258,0,7,67,265,0.00857771735612093,0.252830188679245
2012,39013,80,1466,101,376,6,44,107,420,0.00827276487620398,0.254761904761905
2012,39015,19,704,32,301,1,10,33,311,0.0103113291999602,0.106109324758842
2012,39017,1815,6496,900,3164,130,553,1030,3717,0.0158370365951863,0.27710519235943
2012,39019,44,464,7,142,19,27,26,169,0.00832266325224072,0.153846153846154
2012,39021,165,1237,64,234,0,34,64,268,0.0100224382946896,0.238805970149254
2012,39023,293,1812,269,1214,38,154,307,1368,0.0146793716198815,0.224415204678363
2012,39025,1018,3778,777,1879,83,292,860,2171,0.0165310022919538,0.396130815292492
2012,39027,129,902,37,145,9,83,46,228,0.00825070565245712,0.201754385964912
2012,39029,201,1166,178,1302,0,233,178,1535,0.0201947112222076,0.115960912052117
2012,39031,44,457,37,146,2,11,39,157,0.00625473088721565,0.248407643312102
2012,39033,74,872,9,224,0,25,9,249,0.0082202634445875,0.036144578313253
2012,39035,4104,12149,5697,10733,1656,3455,7353,14188,0.0161928164064685,0.518254863264731
2012,39037,127,747,27,418,0,15,27,433,0.0121169721561494,0.0623556581986143
2012,39039,39,449,114,416,0,11,114,427,0.0164041490587783,0.266978922716628
2012,39041,2867,5739,1100,1735,160,364,1260,2099,0.018562736566557,0.600285850404955
2012,39043,212,1513,111,470,0,94,111,564,0.0104041764282684,0.196808510638298
2012,39045,840,3966,533,1391,124,191,657,1582,0.0163871595935321,0.415297092288243
2012,39047,123,812,0,176,25,47,25,223,0.0114288642886429,0.112107623318386
2012,39049,5082,16193,7997,15569,2350,4509,10347,20078,0.026710123719569,0.515340173324036
2012,39051,214,781,6,314,0,29,6,343,0.0120220111457713,0.0174927113702624
2012,39053,40,224,75,307,0,32,75,339,0.016310623556582,0.221238938053097
2012,39055,302,1221,204,310,105,155,309,465,0.00737100737100737,0.664516129032258
2012,39057,1079,3061,1313,2362,349,786,1662,3148,0.0304888088250961,0.527954256670902
2012,39059,41,685,23,274,0,52,23,326,0.011929593442383,0.0705521472392638
2012,39061,2671,8126,4676,8954,1318,1963,5994,10917,0.0206375191875808,0.549051937345425
2012,39063,386,1600,257,743,51,63,308,806,0.0162000281390067,0.382133995037221
2012,39065,110,498,12,100,0,0,12,100,0.00512820512820513,0.12
2012,39067,40,290,20,130,0,0,20,130,0.0115606936416185,0.153846153846154
2012,39069,35,459,36,150,0,3,36,153,0.00804078200546563,0.235294117647059
2012,39071,118,1170,69,226,11,42,80,268,0.00924201669080626,0.298507462686567
2012,39073,131,802,0,85,0,0,0,85,0.00421899042040999,0
2012,39075,10,239,19,224,0,45,19,269,0.0112954020575268,0.0706319702602231
2012,39077,134,1131,33,571,11,35,44,606,0.0153491552898863,0.0726072607260726
2012,39079,74,503,18,170,0,11,18,181,0.00812314872991652,0.0994475138121547
2012,39081,80,668,101,594,12,82,113,676,0.0138303531241049,0.167159763313609
2012,39083,115,1356,156,420,0,27,156,447,0.0114536090398955,0.348993288590604
2012,39085,935,3528,597,1194,173,526,770,1720,0.0106248918979022,0.447674418604651
2012,39087,31,469,157,1022,0,0,157,1022,0.0238523117137723,0.153620352250489
2012,39089,750,3499,203,1002,111,229,314,1231,0.0111230584344589,0.255077173030057
2012,39091,36,800,26,335,12,33,38,368,0.0119507680316955,0.103260869565217
2012,39093,1181,5818,545,1831,157,605,702,2436,0.0119474430215849,0.288177339901478
2012,39095,1030,4217,1296,4258,324,546,1620,4804,0.0166818298620033,0.33721898417985
2012,39097,238,2287,21,241,29,63,50,304,0.0101577118417535,0.164473684210526
2012,39099,565,3333,438,2336,70,274,508,2610,0.0156165858912224,0.19463601532567
2012,39101,139,2640,144,483,0,68,144,551,0.0119777400982566,0.261343012704174
2012,39103,1086,3829,583,1356,68,217,651,1573,0.013440308964763,0.413858868404323
2012,39105,52,485,16,137,0,0,16,137,0.00831008128108698,0.116788321167883
2012,39107,122,571,60,231,39,78,99,309,0.0114431729807799,0.320388349514563
2012,39109,590,2126,352,997,38,160,390,1157,0.016457100591716,0.337078651685393
2012,39111,12,118,15,108,0,19,15,127,0.0120459072370293,0.118110236220472
2012,39113,2023,8454,2093,5841,917,1509,3010,7350,0.0203390393332116,0.40952380952381
2012,39115,0,255,27,118,0,0,27,118,0.0112573936271704,0.228813559322034
2012,39117,146,704,6,152,0,0,6,152,0.0064929517300299,0.0394736842105263
2012,39119,145,1253,68,560,55,64,123,624,0.0108595395137572,0.197115384615385
2012,39121,33,1097,0,75,0,0,0,75,0.00699365908243193,0
2012,39123,195,883,111,430,0,34,111,464,0.0153703458327812,0.239224137931034
2012,39125,29,282,47,155,0,31,47,186,0.0140727850495574,0.252688172043011
2012,39127,72,783,22,161,0,24,22,185,0.00775843992451248,0.118918918918919
2012,39129,322,3366,85,340,2,23,87,363,0.00965708052887813,0.239669421487603
2012,39131,117,926,38,253,0,15,38,268,0.0139794481247718,0.141791044776119
2012,39133,677,2938,445,1132,188,258,633,1390,0.0135856285552319,0.455395683453237
2012,39135,118,662,30,526,21,102,51,628,0.0218169185339587,0.0812101910828025
2012,39137,77,362,46,92,33,51,79,143,0.00630372492836676,0.552447552447552
2012,39139,272,3115,69,883,7,20,76,903,0.0104829347573717,0.0841638981173865
2012,39141,163,2128,83,565,0,3,83,568,0.010481638678723,0.14612676056338
2012,39143,176,1188,39,495,0,31,39,526,0.0127043934014443,0.0741444866920152
2012,39145,36,1067,112,691,0,89,112,780,0.0145952621533625,0.143589743589744
2012,39147,266,1170,34,292,35,99,69,391,0.010478640724661,0.176470588235294
2012,39149,44,728,85,270,0,31,85,301,0.00934086395233366,0.282392026578073
2012,39151,1011,4680,541,2376,183,469,724,2845,0.011076288178155,0.254481546572935
2012,39153,2564,7280,1762,3403,524,1275,2286,4678,0.0126682373331167,0.488670371953826
2012,39155,274,2160,272,1697,16,117,288,1814,0.0123497133831679,0.158765159867696
2012,39157,184,1291,126,434,6,58,132,492,0.00775181584710646,0.268292682926829
2012,39159,660,2503,60,330,98,134,158,464,0.0135150879645811,0.34051724137931
2012,39161,64,304,22,280,0,0,22,280,0.0143825765358537,0.0785714285714286
2012,39163,12,299,0,62,0,6,0,68,0.0075413108572696,0
2012,39165,1838,6294,1452,2793,277,456,1729,3249,0.0231217575097675,0.532163742690059
2012,39167,47,365,55,980,48,59,103,1039,0.0239881790686399,0.0991337824831569
2012,39169,366,1738,90,440,45,99,135,539,0.00727169704410237,0.250463821892393
2012,39171,131,821,101,479,0,2,101,481,0.0185121040680445,0.20997920997921
2012,39173,788,2609,629,1171,440,557,1069,1728,0.0222156512348457,0.618634259259259
2012,39175,105,520,67,160,9,17,76,177,0.0114200916188141,0.429378531073446
2012,40001,46,181,21,132,0,6,21,138,0.00964293201034169,0.152173913043478
2012,40003,49,397,8,107,0,0,8,107,0.0247570569180935,0.0747663551401869
2012,40005,75,771,0,172,3,3,3,175,0.0181009515928837,0.0171428571428571
2012,40007,16,82,16,205,2,8,18,213,0.0567394778902504,0.0845070422535211
2012,40009,79,398,103,590,0,26,103,616,0.0420190995907231,0.167207792207792
2012,40011,29,468,34,321,0,51,34,372,0.0495867768595041,0.0913978494623656
2012,40013,161,489,137,1104,0,103,137,1207,0.0436717562775888,0.113504556752278
2012,40015,64,883,54,539,0,67,54,606,0.0312403340550572,0.0891089108910891
2012,40017,1341,3823,319,1643,51,173,370,1816,0.0238934792905637,0.20374449339207
2012,40019,80,618,98,469,20,91,118,560,0.0177490412348262,0.210714285714286
2012,40021,145,615,233,566,26,40,259,606,0.0207833184717745,0.427392739273927
2012,40023,11,172,29,238,0,0,29,238,0.0233173312432644,0.121848739495798
2012,40025,5,29,2,38,0,0,2,38,0.0221187427240978,0.0526315789473684
2012,40027,1552,7635,1206,3612,378,627,1584,4239,0.0265005407635707,0.373673036093418
2012,40029,20,122,10,49,0,0,10,49,0.0125448028673835,0.204081632653061
2012,40031,209,1877,1166,5172,289,1326,1455,6498,0.0860286232507646,0.223915050784857
2012,40033,7,109,3,164,0,20,3,184,0.043632914394119,0.016304347826087
2012,40035,30,722,9,241,0,7,9,248,0.0239544093499469,0.0362903225806452
2012,40037,244,1927,97,681,0,5,97,686,0.014587364705382,0.141399416909621
2012,40039,126,782,95,365,0,41,95,406,0.0250339129362437,0.233990147783251
2012,40041,65,668,80,881,37,84,117,965,0.0331615120274914,0.121243523316062
2012,40043,62,126,7,27,0,0,7,27,0.0082091821222256,0.259259259259259
2012,40045,25,75,2,20,4,6,6,26,0.00895933838731909,0.230769230769231
2012,40047,122,970,422,1172,85,217,507,1389,0.034908268409148,0.365010799136069
2012,40049,49,564,12,199,0,4,12,203,0.0109428063177187,0.0591133004926108
2012,40051,297,1648,33,442,24,98,57,540,0.0155970192363237,0.105555555555556
2012,40053,12,141,23,85,0,0,23,85,0.0265459088069956,0.270588235294118
2012,40055,14,595,6,113,0,0,6,113,0.0249228054697839,0.0530973451327434
2012,40057,5,76,10,70,0,0,10,70,0.0361197110423117,0.142857142857143
2012,40059,26,62,10,42,0,19,10,61,0.0243318707618668,0.163934426229508
2012,40061,42,204,27,173,0,19,27,192,0.0224220483475417,0.140625
2012,40063,15,475,12,94,0,6,12,100,0.0103982530934803,0.12
2012,40065,32,462,221,544,42,105,263,649,0.0393261831182209,0.405238828967643
2012,40067,24,279,2,120,0,0,2,120,0.0271616115889543,0.0166666666666667
2012,40069,60,371,4,149,0,0,4,149,0.0205375603032391,0.0268456375838926
2012,40071,138,710,148,850,35,150,183,1000,0.0326455993732045,0.183
2012,40073,44,395,36,137,0,7,36,144,0.0145926226185651,0.25
2012,40075,58,338,9,145,0,7,9,152,0.0235366986683184,0.0592105263157895
2012,40077,11,240,38,137,7,7,45,144,0.0198511166253102,0.3125
2012,40079,39,1005,60,620,9,87,69,707,0.0212503757138563,0.0975954738330976
2012,40081,75,870,54,386,15,44,69,430,0.0187740132727908,0.16046511627907
2012,40083,574,1589,57,339,55,75,112,414,0.015127155802397,0.270531400966184
2012,40085,16,74,16,172,0,7,16,179,0.0277004023522129,0.0893854748603352
2012,40087,289,1295,57,243,5,5,62,248,0.0108910456282113,0.25
2012,40089,25,433,58,383,4,11,62,394,0.0181341188383118,0.157360406091371
2012,40091,48,453,39,196,0,6,39,202,0.0138025281858558,0.193069306930693
2012,40093,34,91,0,110,0,3,0,113,0.0215361158757385,0
2012,40095,35,359,47,339,0,0,47,339,0.0314909428704134,0.138643067846608
2012,40097,57,650,59,641,1,13,60,654,0.0240070479406798,0.0917431192660551
2012,40099,37,377,17,273,6,6,23,279,0.0305552513415836,0.0824372759856631
2012,40101,145,1778,107,877,19,68,126,945,0.0203142801865904,0.133333333333333
2012,40103,38,334,20,142,0,0,20,142,0.0181516042438962,0.140845070422535
2012,40105,51,280,24,129,0,96,24,225,0.0309448494017329,0.106666666666667
2012,40107,60,673,27,126,0,0,27,126,0.015025041736227,0.214285714285714
2012,40109,2837,12331,4520,12612,902,2744,5422,15356,0.0330535106978346,0.35308674133889
2012,40111,148,808,79,357,0,28,79,385,0.0146856881293866,0.205194805194805
2012,40113,170,1677,14,327,11,58,25,385,0.0118174284048006,0.0649350649350649
2012,40115,73,430,47,652,0,6,47,658,0.0313961255845023,0.0714285714285714
2012,40117,88,620,44,134,0,6,44,140,0.0124146492861577,0.314285714285714
2012,40119,427,1937,588,1552,224,312,812,1864,0.0448227768960708,0.435622317596566
2012,40121,79,1136,113,803,0,15,113,818,0.0255920908550512,0.138141809290954
2012,40123,91,720,55,286,11,40,66,326,0.0136859781696054,0.202453987730061
2012,40125,253,1813,45,501,31,82,76,583,0.0129113699782965,0.130360205831904
2012,40127,11,358,27,182,7,9,34,191,0.0239108662994492,0.178010471204188
2012,40129,30,104,0,44,0,0,0,44,0.0173844330304228,0
2012,40131,639,2619,345,1163,31,69,376,1232,0.0216577305089215,0.305194805194805
2012,40133,76,591,25,168,12,12,37,180,0.0108244632870287,0.205555555555556
2012,40135,81,661,22,753,0,12,22,765,0.0274144418562982,0.0287581699346405
2012,40137,150,1305,80,500,0,162,80,662,0.0216304525404346,0.120845921450151
2012,40139,28,279,89,612,56,205,145,817,0.0664065675038608,0.177478580171359
2012,40141,4,185,36,166,0,14,36,180,0.0344299923488906,0.2
2012,40143,2073,9522,3122,9955,385,1205,3507,11160,0.0285688686369629,0.314247311827957
2012,40145,549,2617,337,1261,5,120,342,1381,0.0286383808220314,0.247646632874728
2012,40147,250,1020,343,1063,86,165,429,1228,0.0352407736899501,0.349348534201954
2012,40149,31,333,32,99,7,8,39,107,0.0139141742522757,0.364485981308411
2012,40151,72,403,31,111,0,0,31,111,0.0198355968548964,0.279279279279279
2012,40153,53,451,46,293,0,34,46,327,0.0242276061346966,0.140672782874618
2012,41001,155,462,36,279,0,18,36,297,0.0251417929399814,0.121212121212121
2012,41003,521,1611,870,1435,384,489,1254,1924,0.0380515396633902,0.651767151767152
2012,41005,2979,9708,2289,5534,385,868,2674,6402,0.0247239697380464,0.417681974383005
2012,41007,327,1051,405,980,7,44,412,1024,0.0390020948390783,0.40234375
2012,41009,170,1021,111,846,39,74,150,920,0.0271731104350651,0.16304347826087
2012,41011,190,1166,305,1311,58,101,363,1412,0.0305740207435636,0.257082152974504
2012,41013,93,659,8,322,0,0,8,322,0.0211369305500853,0.0248447204968944
2012,41015,0,163,115,652,51,51,166,703,0.0402611534276387,0.236130867709815
2012,41017,638,2485,1313,3368,109,190,1422,3558,0.0320870082787728,0.399662731871838
2012,41019,244,1796,555,1993,49,163,604,2156,0.0278412686114232,0.280148423005566
2012,41021,0,65,13,29,0,0,13,29,0.0198358413132695,0.448275862068966
2012,41023,27,179,27,104,0,8,27,112,0.0203045685279188,0.241071428571429
2012,41025,14,139,42,234,5,5,47,239,0.0467985118464852,0.196652719665272
2012,41027,124,339,141,392,0,31,141,423,0.0284178703392677,0.333333333333333
2012,41029,380,2818,1353,4483,97,405,1450,4888,0.0344484928784366,0.296644844517185
2012,41031,145,1100,30,275,0,13,30,288,0.020009726950601,0.104166666666667
2012,41033,135,816,179,1518,2,107,181,1625,0.0271870974218266,0.111384615384615
2012,41035,179,992,290,1543,43,177,333,1720,0.0378487809171728,0.193604651162791
2012,41037,16,326,86,251,0,0,86,251,0.0424129773572153,0.342629482071713
2012,41039,947,4445,2267,6268,626,1338,2893,7606,0.0321375755271052,0.380357612411254
2012,41041,153,739,267,813,22,50,289,863,0.0246543252199749,0.334878331402086
2012,41043,404,2236,250,1096,36,231,286,1327,0.0168287826715534,0.215523737754333
2012,41045,43,800,91,537,0,12,91,549,0.0272740821700035,0.165755919854281
2012,41047,1084,5682,828,3084,164,778,992,3862,0.0191674897139766,0.256861729673744
2012,41049,24,361,1,185,3,11,4,196,0.0276718904419031,0.0204081632653061
2012,41051,4745,13154,9817,18094,1914,3976,11731,22070,0.0427777013236471,0.531536021748981
2012,41053,437,2012,353,1093,38,76,391,1169,0.0243394615752983,0.334473909324209
2012,41055,4,39,11,48,0,4,11,52,0.0393939393939394,0.211538461538462
2012,41057,44,630,58,300,12,31,70,331,0.0176929655762241,0.211480362537764
2012,41059,213,1501,302,1704,12,167,314,1871,0.0384852723383248,0.167824692677712
2012,41061,65,379,74,397,5,12,79,409,0.023971398429258,0.193154034229829
2012,41063,44,166,17,39,0,11,17,50,0.00958588957055215,0.34
2012,41065,37,489,222,708,23,89,245,797,0.0457730300941879,0.307402760351317
2012,41067,3700,10680,5454,11924,1460,2494,6914,14418,0.040918611185215,0.479539464558191
2012,41069,3,75,0,5,0,0,0,5,0.00478927203065134,0
2012,41071,547,2377,494,1649,24,144,518,1793,0.0279671195270702,0.288901282766313
2012,42001,157,1545,318,1315,14,93,332,1408,0.0204078674648153,0.235795454545455
2012,42003,3914,8981,8312,14664,2616,3624,10928,18288,0.0212343758164053,0.597550306211724
2012,42005,119,922,22,223,65,135,87,358,0.00716644980482434,0.243016759776536
2012,42007,713,2614,291,1431,27,162,318,1593,0.0130093915884034,0.199623352165725
2012,42009,69,298,61,337,0,22,61,359,0.0101269393511989,0.16991643454039
2012,42011,1018,4815,593,3040,170,967,763,4007,0.0147119836394811,0.19041677065136
2012,42013,286,1550,210,1041,16,61,226,1102,0.0124377828692678,0.20508166969147
2012,42015,57,502,111,616,12,42,123,658,0.0150341581556881,0.18693009118541
2012,42017,2376,6724,3159,6379,262,642,3421,7021,0.0161456860134344,0.487252528129896
2012,42019,1423,3155,604,1692,166,303,770,1995,0.0158466646543918,0.385964912280702
2012,42021,363,1864,299,1121,31,129,330,1250,0.0122894811872622,0.264
2012,42023,27,74,0,12,0,0,0,12,0.0031754432389521,0
2012,42025,188,1201,67,578,0,28,67,606,0.0129029510709875,0.110561056105611
2012,42027,804,2512,1260,1989,500,754,1760,2743,0.0322793226402438,0.641633248268319
2012,42029,3724,7116,3458,5894,1005,1659,4463,7553,0.0227684479291956,0.590891036674169
2012,42031,55,429,49,224,13,21,62,245,0.00947958986264268,0.253061224489796
2012,42033,198,2089,160,672,13,137,173,809,0.0137510198531411,0.213844252163164
2012,42035,243,853,68,188,20,72,88,260,0.0103289369140315,0.338461538461538
2012,42037,242,759,76,394,48,128,124,522,0.0119314285714286,0.237547892720307
2012,42039,176,1202,299,805,27,127,326,932,0.0155268638067472,0.349785407725322
2012,42041,1339,5715,1197,2570,490,761,1687,3331,0.0206059931210254,0.506454518162714
2012,42043,1703,5784,1300,2971,413,932,1713,3903,0.0213027246528687,0.438893159108378
2012,42045,2876,8580,2255,4384,495,1095,2750,5479,0.0147980294502123,0.501916408103669
2012,42047,1,204,52,89,1,2,53,91,0.00388905508782427,0.582417582417582
2012,42049,438,1981,1142,2568,147,570,1289,3138,0.0170314849088452,0.410771191841938
2012,42051,308,1683,132,793,22,174,154,967,0.00980084123042619,0.159255429162358
2012,42053,84,622,2,70,12,49,14,119,0.0204889807162534,0.117647058823529
2012,42055,239,1557,587,1924,139,309,726,2233,0.0218915129947158,0.32512315270936
2012,42057,23,202,23,103,3,9,26,112,0.0107993443255231,0.232142857142857
2012,42059,148,1204,130,568,0,32,130,600,0.0221459417561732,0.216666666666667
2012,42061,128,1536,65,378,38,109,103,487,0.0150262264733107,0.211498973305955
2012,42063,347,1081,222,659,131,169,353,828,0.0147341447789878,0.426328502415459
2012,42065,69,574,35,205,0,15,35,220,0.00694597922520759,0.159090909090909
2012,42067,37,272,5,75,0,46,5,121,0.00714285714285714,0.0413223140495868
2012,42069,629,2245,614,1609,195,395,809,2004,0.0134351472569908,0.403692614770459
2012,42071,1426,4582,1435,3297,332,1131,1767,4428,0.0130050927802351,0.399051490514905
2012,42073,156,632,101,475,13,92,114,567,0.00884500187195807,0.201058201058201
2012,42075,523,2302,200,844,56,202,256,1046,0.0114244522597698,0.244741873804971
2012,42077,1754,6225,1393,4103,428,1437,1821,5540,0.0233976416528702,0.32870036101083
2012,42079,733,3734,616,2671,73,514,689,3185,0.0140821406622364,0.216326530612245
2012,42081,227,1462,195,1019,24,100,219,1119,0.0140747635339102,0.195710455764075
2012,42083,58,440,87,558,0,53,87,611,0.0201690103650888,0.142389525368249
2012,42085,222,1442,275,1161,17,102,292,1263,0.0157459700041141,0.231195566112431
2012,42087,48,430,42,189,0,124,42,313,0.00964560862865948,0.134185303514377
2012,42089,372,1754,648,2489,47,213,695,2702,0.0241908769416715,0.257216876387861
2012,42091,7302,16094,4725,7793,1536,2510,6261,10303,0.0185550709029546,0.607687081432592
2012,42093,91,336,81,185,12,47,93,232,0.0178269555862917,0.400862068965517
2012,42095,1482,4719,1303,3797,231,566,1534,4363,0.0214630066902794,0.351592940637176
2012,42097,438,2306,61,327,9,121,70,448,0.00659288909818696,0.15625
2012,42099,162,774,29,200,4,40,33,240,0.0075922938217709,0.1375
2012,42101,4486,10773,9562,15795,3154,7274,12716,23069,0.023491279235538,0.551215917464996
2012,42103,139,673,263,1160,18,33,281,1193,0.0297691827822832,0.235540653813915
2012,42105,54,151,24,235,0,2,24,237,0.0192276488723024,0.10126582278481
2012,42107,252,2552,128,963,65,395,193,1358,0.0126273897195566,0.142120765832106
2012,42109,163,572,48,223,8,49,56,272,0.0105520425185243,0.205882352941176
2012,42111,222,1382,60,400,4,38,64,438,0.00771248965505098,0.146118721461187
2012,42113,8,78,13,36,0,6,13,42,0.00871007880547491,0.30952380952381
2012,42115,85,449,58,437,17,28,75,465,0.0150295743236692,0.161290322580645
2012,42117,55,489,140,551,17,39,157,590,0.0205231668289968,0.266101694915254
2012,42119,244,1030,287,1435,18,138,305,1573,0.0515534871525957,0.19389701207883
2012,42121,249,965,127,423,0,29,127,452,0.0115992609320468,0.280973451327434
2012,42123,73,524,111,348,0,18,111,366,0.0121522013413905,0.30327868852459
2012,42125,884,2877,617,2046,44,209,661,2255,0.0153705634964453,0.293126385809313
2012,42127,150,1660,230,1003,50,62,280,1065,0.0275835275835276,0.262910798122066
2012,42129,1350,5141,583,1607,109,366,692,1973,0.00745667907556832,0.350734921439432
2012,42131,68,439,41,147,0,0,41,147,0.00748624974536565,0.27891156462585
2012,42133,1359,5130,1576,5176,194,926,1770,6102,0.0205550745972021,0.290068829891839
2012,44001,373,763,339,692,99,132,438,824,0.0243830265727644,0.531553398058252
2012,44003,770,3437,756,1664,153,344,909,2008,0.0168247477963602,0.452689243027888
2012,44005,250,732,2236,3040,296,520,2532,3560,0.0607000971883579,0.71123595505618
2012,44007,1199,3711,3348,6925,1031,2721,4379,9646,0.0233257160820729,0.453970557744143
2012,44009,790,1467,655,1423,44,169,699,1592,0.01887217421198,0.439070351758794
2012,45001,72,541,23,79,13,15,36,94,0.0054912957121159,0.382978723404255
2012,45003,252,1251,971,2986,121,303,1092,3289,0.0301494179118159,0.33201581027668
2012,45005,49,340,0,119,0,0,0,119,0.0167794698251551,0
2012,45007,596,2461,630,2300,129,559,759,2859,0.0225779448463215,0.265477439664218
2012,45009,19,216,70,107,0,4,70,111,0.0108536227632737,0.630630630630631
2012,45011,2,166,0,190,0,9,0,199,0.0136236051208325,0
2012,45013,428,1386,2587,6496,214,804,2801,7300,0.0653665001164061,0.383698630136986
2012,45015,1154,4589,1313,4007,294,669,1607,4676,0.0405016803520078,0.343669803250642
2012,45017,45,268,7,156,0,7,7,163,0.0153512902618196,0.0429447852760736
2012,45019,1936,6296,4743,9230,497,936,5240,10166,0.0429099043960914,0.515443635648239
2012,45021,44,811,96,455,0,13,96,468,0.0128833342509497,0.205128205128205
2012,45023,33,374,95,272,0,66,95,338,0.0151787318124663,0.281065088757396
2012,45025,115,443,46,497,0,40,46,537,0.0173797656806266,0.0856610800744879
2012,45027,133,779,41,497,0,42,41,539,0.0229948805460751,0.0760667903525046
2012,45029,213,751,43,155,0,16,43,171,0.00655901192896322,0.251461988304094
2012,45031,176,960,80,501,75,99,155,600,0.0130798744332054,0.258333333333333
2012,45033,7,400,18,187,0,13,18,200,0.00981498748589095,0.09
2012,45035,739,4187,977,2786,83,265,1060,3051,0.0345385799673972,0.34742707309079
2012,45037,133,705,39,530,54,201,93,731,0.0386690647482014,0.127222982216142
2012,45039,139,483,9,104,0,1,9,105,0.00637561479142632,0.0857142857142857
2012,45041,430,1972,451,1853,11,33,462,1886,0.0209982520012915,0.244962884411453
2012,45043,274,1267,338,694,95,208,433,902,0.0209533543950939,0.480044345898004
2012,45045,1988,6952,3626,8726,547,1230,4173,9956,0.0331033565526758,0.419144234632382
2012,45047,337,1362,188,623,0,88,188,711,0.0155986046817753,0.264416315049226
2012,45049,29,288,20,381,0,0,20,381,0.0270904436860068,0.05249343832021
2012,45051,542,2356,1862,7857,140,918,2002,8775,0.0460424482514364,0.228148148148148
2012,45053,50,993,36,437,0,168,36,605,0.037647790914748,0.059504132231405
2012,45055,296,1435,125,547,39,109,164,656,0.0157703680553886,0.25
2012,45057,67,684,232,1401,42,90,274,1491,0.0283422358241299,0.183769282360832
2012,45059,264,1484,182,561,0,37,182,598,0.0134246267819059,0.304347826086957
2012,45061,17,375,0,100,0,13,0,113,0.00880954237155999,0
2012,45063,1987,5433,1157,3839,180,443,1337,4282,0.0243759428457575,0.312237272302662
2012,45065,27,393,104,149,8,8,112,157,0.0195736192494701,0.713375796178344
2012,45067,27,278,77,314,0,0,77,314,0.0142081447963801,0.245222929936306
2012,45069,27,760,113,583,0,38,113,621,0.03105,0.181964573268921
2012,45071,153,926,94,405,28,112,122,517,0.0205403257846643,0.235976789168279
2012,45073,295,1316,445,1282,12,78,457,1360,0.0260137719969396,0.336029411764706
2012,45075,133,775,128,525,21,59,149,584,0.0097863426895685,0.25513698630137
2012,45077,437,1873,608,1627,237,351,845,1978,0.027118179325473,0.427199191102123
2012,45079,2464,9571,3352,8836,640,1217,3992,10053,0.0420522044674977,0.397095394409629
2012,45081,47,340,30,206,0,15,30,221,0.016483926307153,0.135746606334842
2012,45083,819,3971,1082,3341,304,815,1386,4156,0.0221852112826426,0.333493743984601
2012,45085,103,878,377,1240,91,283,468,1523,0.022244942671438,0.307288246881156
2012,45087,18,531,74,388,0,14,74,402,0.0201544169256994,0.18407960199005
2012,45089,40,474,0,422,0,42,0,464,0.0198749250406922,0
2012,45091,326,1378,1981,5649,83,238,2064,5887,0.0396789021743526,0.350603023611347
2012,46003,11,78,4,8,0,15,4,23,0.0124796527400977,0.173913043478261
2012,46005,15,155,48,364,30,63,78,427,0.0358944182918628,0.182669789227166
2012,46007,1,59,7,16,0,0,7,16,0.00888888888888889,0.4375
2012,46009,26,308,17,104,5,5,22,109,0.0211527265670483,0.201834862385321
2012,46011,307,601,205,649,31,73,236,722,0.0434939759036145,0.326869806094183
2012,46013,202,457,205,448,20,35,225,483,0.0199175257731959,0.46583850931677
2012,46015,20,36,38,65,0,10,38,75,0.0205817782656422,0.506666666666667
2012,46017,0,28,19,19,0,0,19,19,0.0189054726368159,1
2012,46019,133,352,23,114,0,0,23,114,0.016821602478973,0.201754385964912
2012,46021,0,29,14,35,0,0,14,35,0.032618825722274,0.4
2012,46023,63,238,61,154,5,5,66,159,0.0276521739130435,0.415094339622642
2012,46025,1,90,56,107,0,0,56,107,0.0416342412451362,0.523364485981308
2012,46027,10,110,175,405,0,57,175,462,0.0646606018194542,0.378787878787879
2012,46029,60,422,80,221,0,16,80,237,0.0131739855475264,0.337552742616034
2012,46031,9,56,6,84,0,0,6,84,0.0368421052631579,0.0714285714285714
2012,46033,7,84,42,199,4,4,46,203,0.0327102803738318,0.226600985221675
2012,46035,154,705,111,170,0,57,111,227,0.0176708703098241,0.488986784140969
2012,46037,11,118,5,177,0,6,5,183,0.0447323392813493,0.0273224043715847
2012,46039,7,50,16,81,0,7,16,88,0.0286644951140065,0.181818181818182
2012,46041,21,73,5,14,0,0,5,14,0.00474094141550965,0.357142857142857
2012,46043,4,80,20,20,0,1,20,21,0.00988700564971751,0.952380952380952
2012,46045,13,83,7,37,0,2,7,39,0.0136794107330761,0.179487179487179
2012,46047,32,125,25,303,0,5,25,308,0.0576563084986896,0.0811688311688312
2012,46049,15,38,4,30,0,3,4,33,0.0201465201465201,0.121212121212121
2012,46051,0,85,2,62,0,0,2,62,0.0120271580989331,0.032258064516129
2012,46053,3,54,42,87,0,0,42,87,0.0280645161290323,0.482758620689655
2012,46055,1,13,4,4,3,6,7,10,0.00712758374910905,0.7
2012,46057,21,90,3,77,7,19,10,96,0.0261509125578861,0.104166666666667
2012,46059,21,63,12,33,0,0,12,33,0.013142174432497,0.363636363636364
2012,46061,6,33,0,29,0,0,0,29,0.0138955438428366,0
2012,46063,4,6,24,27,0,0,24,27,0.0300333704115684,0.888888888888889
2012,46065,173,568,101,174,43,62,144,236,0.0199459093982421,0.610169491525424
2012,46067,81,184,26,110,0,0,26,110,0.0211091920936481,0.236363636363636
2012,46069,0,11,7,15,0,0,7,15,0.0152594099694812,0.466666666666667
2012,46071,0,10,0,31,0,0,0,31,0.0170987313844457,0
2012,46073,19,90,2,11,0,0,2,11,0.00718954248366013,0.181818181818182
2012,46075,0,16,0,11,0,0,0,11,0.0160349854227405,0
2012,46077,24,74,27,94,0,16,27,110,0.0290160907412292,0.245454545454545
2012,46079,113,244,88,186,0,6,88,192,0.0256410256410256,0.458333333333333
2012,46081,56,309,286,487,34,46,320,533,0.0329541239025597,0.600375234521576
2012,46083,756,2163,257,666,12,46,269,712,0.0247919495804171,0.377808988764045
2012,46085,15,54,31,43,0,0,31,43,0.0185025817555938,0.720930232558139
2012,46087,14,150,9,48,0,25,9,73,0.018951194184839,0.123287671232877
2012,46089,0,49,2,52,0,0,2,52,0.028169014084507,0.0384615384615385
2012,46091,38,105,0,47,6,14,6,61,0.0195889531149647,0.0983606557377049
2012,46093,74,498,59,653,0,67,59,720,0.043731778425656,0.0819444444444444
2012,46095,0,7,0,5,0,0,0,5,0.00427350427350427,0
2012,46097,24,77,1,5,0,2,1,7,0.00403923831506059,0.142857142857143
2012,46099,800,2678,849,2518,62,393,911,2911,0.0262756460595557,0.312950875987633
2012,46101,18,96,21,59,0,6,21,65,0.0150254276467869,0.323076923076923
2012,46103,374,1572,760,2297,104,331,864,2628,0.0394079805659274,0.328767123287671
2012,46105,4,15,13,101,0,2,13,103,0.0476631189264229,0.12621359223301
2012,46107,8,12,10,32,0,3,10,35,0.0198863636363636,0.285714285714286
2012,46109,5,30,33,166,0,0,33,166,0.0255306059673946,0.198795180722892
2012,46111,0,14,7,46,0,0,7,46,0.0280146163215591,0.152173913043478
2012,46113,0,46,36,81,0,0,36,81,0.012546468401487,0.444444444444444
2012,46115,36,145,11,40,6,18,17,58,0.0130132376037694,0.293103448275862
2012,46117,54,220,13,22,0,0,13,22,0.0103480714957667,0.590909090909091
2012,46119,31,39,7,21,0,5,7,26,0.0262096774193548,0.269230769230769
2012,46121,0,132,52,92,0,0,52,92,0.0199869650228112,0.565217391304348
2012,46123,11,72,86,103,0,0,86,103,0.0255393007686586,0.83495145631068
2012,46125,40,133,7,45,0,0,7,45,0.00770284149263951,0.155555555555556
2012,46127,74,189,336,715,0,0,336,715,0.0724858069748581,0.46993006993007
2012,46129,29,97,61,95,6,9,67,104,0.0266120777891505,0.644230769230769
2012,46135,55,556,61,613,0,3,61,616,0.0391982182628062,0.099025974025974
2012,46137,13,60,0,33,0,0,0,33,0.0226182316655243,0
2012,47001,382,2105,267,868,135,221,402,1089,0.0206492472221169,0.369146005509642
2012,47003,85,729,56,347,19,41,75,388,0.0133673258457934,0.193298969072165
2012,47005,0,191,156,292,0,0,156,292,0.0243536280233528,0.534246575342466
2012,47007,3,409,0,114,0,0,0,114,0.012548156301596,0
2012,47009,459,2483,609,2200,35,99,644,2299,0.0267521556489056,0.280121792083515
2012,47011,245,977,268,1357,28,72,296,1429,0.0216613612247992,0.207137858642407
2012,47013,21,320,55,530,0,17,55,547,0.0191031640706852,0.10054844606947
2012,47015,40,538,4,62,0,0,4,62,0.00644758735440932,0.0645161290322581
2012,47017,79,574,10,331,0,6,10,337,0.0172263967694116,0.029673590504451
2012,47019,175,1358,68,416,35,64,103,480,0.0118386977432482,0.214583333333333
2012,47021,223,1142,117,272,0,2,117,274,0.0103823273085522,0.427007299270073
2012,47023,85,503,11,210,7,58,18,268,0.0249255952380952,0.0671641791044776
2012,47025,117,241,100,585,13,51,113,636,0.0284398336538032,0.177672955974843
2012,47027,10,125,0,56,3,8,3,64,0.0115336096593981,0.046875
2012,47029,63,599,31,559,14,43,45,602,0.023702653752264,0.0747508305647841
2012,47031,210,1360,120,525,0,0,120,525,0.0147046466683472,0.228571428571429
2012,47033,62,359,43,109,0,12,43,121,0.0122905027932961,0.355371900826446
2012,47035,126,680,311,1123,19,44,330,1167,0.0279193282135936,0.282776349614396
2012,47037,3844,11738,6166,13027,1140,2679,7306,15706,0.0374124299975941,0.465172545524004
2012,47039,27,241,3,129,0,0,3,129,0.0154583582983823,0.0232558139534884
2012,47041,68,497,41,126,0,18,41,144,0.0111008325624422,0.284722222222222
2012,47043,180,1178,207,565,0,54,207,619,0.0185763159474221,0.334410339256866
2012,47045,166,631,116,477,27,28,143,505,0.0196582194713691,0.283168316831683
2012,47047,177,669,55,310,11,68,66,378,0.0140593617496095,0.174603174603175
2012,47049,79,335,26,219,7,17,33,236,0.01888,0.139830508474576
2012,47051,123,661,134,405,29,115,163,520,0.0186889016676251,0.313461538461538
2012,47053,185,927,70,430,8,15,78,445,0.0132456244791047,0.175280898876404
2012,47055,55,338,116,462,0,0,116,462,0.0226859808494967,0.251082251082251
2012,47057,33,579,53,214,0,4,53,218,0.0136891679748823,0.243119266055046
2012,47059,100,909,137,679,11,85,148,764,0.0157224291564629,0.193717277486911
2012,47061,12,176,25,55,0,1,25,56,0.00585896631094371,0.446428571428571
2012,47063,264,1309,110,900,0,132,110,1032,0.0240980735551664,0.106589147286822
2012,47065,727,2913,2576,7206,347,661,2923,7867,0.0341596432494865,0.371552052879115
2012,47067,17,133,0,59,0,0,0,59,0.0122508305647841,0
2012,47069,47,932,23,174,8,26,31,200,0.0105730598435187,0.155
2012,47071,19,261,63,365,0,8,63,373,0.0203424956369983,0.168900804289544
2012,47073,164,1400,266,840,14,44,280,884,0.0220360953235617,0.316742081447964
2012,47075,71,246,0,83,0,23,0,106,0.00853393446582401,0
2012,47077,65,551,122,427,16,48,138,475,0.024957965531736,0.290526315789474
2012,47079,26,438,84,414,48,48,132,462,0.0201702685003274,0.285714285714286
2012,47081,91,1025,45,189,0,0,45,189,0.0111294311624073,0.238095238095238
2012,47083,19,174,9,60,2,6,11,66,0.0114603229727383,0.166666666666667
2012,47085,131,545,16,122,0,13,16,135,0.0105733082706767,0.118518518518519
2012,47087,9,214,27,133,0,6,27,139,0.016644713207999,0.194244604316547
2012,47089,205,1218,91,454,14,23,105,477,0.0135920670200034,0.220125786163522
2012,47091,28,528,48,236,0,3,48,239,0.0177273401572467,0.200836820083682
2012,47093,1450,5186,2871,6204,421,758,3292,6962,0.0242124519193985,0.472852628555013
2012,47095,14,718,2,55,12,12,14,67,0.011678577653826,0.208955223880597
2012,47097,90,1214,29,264,8,69,37,333,0.018090943662737,0.111111111111111
2012,47099,45,467,12,358,9,34,21,392,0.0140396117617564,0.0535714285714286
2012,47101,0,297,0,161,25,106,25,267,0.0323205423072267,0.0936329588014981
2012,47103,0,133,100,566,0,55,100,621,0.0270765206017005,0.161030595813205
2012,47105,180,1206,153,654,20,115,173,769,0.0216980333512034,0.224967490247074
2012,47107,224,1062,30,496,0,68,30,564,0.0156332289270172,0.0531914893617021
2012,47109,10,124,53,295,3,61,56,356,0.0197186219120417,0.157303370786517
2012,47111,22,350,0,86,0,173,0,259,0.0175153851355921,0
2012,47113,369,1324,287,854,127,184,414,1038,0.0163771477256591,0.398843930635838
2012,47115,61,469,146,336,0,11,146,347,0.0175341081354219,0.420749279538905
2012,47117,73,623,83,319,0,18,83,337,0.0162975142663701,0.246290801186944
2012,47119,558,2139,198,1172,0,99,198,1271,0.0232103725346969,0.155782848151062
2012,47121,13,271,49,259,0,0,49,259,0.0307564422277639,0.189189189189189
2012,47123,91,1091,138,823,3,24,141,847,0.0273861872736679,0.166469893742621
2012,47125,369,1664,1817,7677,665,1771,2482,9448,0.0911309380274898,0.262701100762066
2012,47127,18,153,0,104,0,0,0,104,0.0235827664399093,0
2012,47129,101,1399,0,139,0,2,0,141,0.00910323455355413,0
2012,47131,49,511,35,530,0,29,35,559,0.0253388332351208,0.0626118067978533
2012,47133,8,339,6,18,0,46,6,64,0.00420499342969777,0.09375
2012,47135,13,126,0,131,2,5,2,136,0.024664490388103,0.0147058823529412
2012,47137,20,169,7,11,0,28,7,39,0.0103229221810482,0.179487179487179
2012,47139,12,427,62,302,0,4,62,306,0.0258031874525677,0.202614379084967
2012,47141,170,937,159,840,50,135,209,975,0.0213801723570818,0.214358974358974
2012,47143,66,742,40,488,45,103,85,591,0.0278091473743648,0.143824027072758
2012,47145,146,1030,79,650,57,97,136,747,0.0191494270552949,0.182061579651941
2012,47147,199,1447,113,680,22,98,135,778,0.0177293651155371,0.173521850899743
2012,47149,1234,5735,1076,4131,324,633,1400,4764,0.0292399096533438,0.293870696893367
2012,47151,26,203,37,212,0,6,37,218,0.014748663825181,0.169724770642202
2012,47153,1,346,87,179,0,0,87,179,0.0183891514279844,0.486033519553073
2012,47155,213,1629,503,2080,12,62,515,2142,0.0341872157050515,0.240429505135387
2012,47157,1218,4191,5064,14226,1058,2082,6122,16308,0.0276690504670043,0.375398577385332
2012,47159,43,358,19,53,0,0,19,53,0.00406068035550107,0.358490566037736
2012,47161,26,132,53,209,0,0,53,209,0.0227792915531335,0.253588516746411
2012,47163,410,2374,405,2607,15,127,420,2734,0.0242528541901374,0.153621068032187
2012,47165,919,4389,803,2918,69,305,872,3223,0.0298163652342847,0.27055538318337
2012,47167,138,1621,125,1036,13,13,138,1049,0.0267383768352365,0.131553860819828
2012,47169,1,282,5,56,0,13,5,69,0.0131629149179702,0.072463768115942
2012,47171,27,452,56,333,0,15,56,348,0.0261496844003607,0.160919540229885
2012,47173,23,317,15,132,0,0,15,132,0.0101624451458927,0.113636363636364
2012,47175,0,75,0,103,0,0,0,103,0.0258793969849246,0
2012,47177,114,529,95,332,0,83,95,415,0.0153772046835631,0.228915662650602
2012,47179,438,2153,745,1881,114,317,859,2198,0.0261349313928325,0.39080982711556
2012,47181,33,690,3,124,0,1,3,125,0.0101634279209692,0.024
2012,47183,100,721,54,441,0,8,54,449,0.0205144606387353,0.120267260579065
2012,47185,23,659,36,225,0,0,36,225,0.0125327243357656,0.16
2012,47187,2274,4391,2100,3853,198,281,2298,4134,0.0345822772103295,0.555878084179971
2012,47189,730,2623,445,1634,41,190,486,1824,0.0235151546405043,0.266447368421053
2012,48001,182,3760,60,477,7,38,67,515,0.0123241121853164,0.130097087378641
2012,48003,19,540,36,209,10,25,46,234,0.0256297918948521,0.196581196581197
2012,48005,254,1975,143,647,53,146,196,793,0.0143192488262911,0.247162673392182
2012,48007,219,1057,35,338,2,12,37,350,0.0205146239962488,0.105714285714286
2012,48009,15,152,0,32,0,11,0,43,0.00701811653337686,0
2012,48011,25,63,10,30,0,0,10,30,0.0234558248631744,0.333333333333333
2012,48013,119,882,57,385,17,35,74,420,0.0148709414722232,0.176190476190476
2012,48015,112,737,38,109,13,14,51,123,0.00650587115201523,0.414634146341463
2012,48017,49,268,0,34,24,24,24,58,0.0144422310756972,0.413793103448276
2012,48019,141,427,25,100,0,16,25,116,0.00755011715699037,0.21551724137931
2012,48021,455,2313,92,824,16,76,108,900,0.0183019827147941,0.12
2012,48023,86,122,7,72,0,0,7,72,0.0256045519203414,0.0972222222222222
2012,48025,210,3409,16,304,46,123,62,427,0.0196312813203991,0.14519906323185
2012,48027,1498,5407,2459,8865,1030,4509,3489,13374,0.0730424524437599,0.260879318079856
2012,48029,6872,22074,9406,22195,3423,7582,12829,29777,0.0279457171548431,0.430835880041643
2012,48031,80,193,3,60,0,0,3,60,0.00791034937376401,0.05
2012,48033,7,35,0,0,0,0,0,0,0,NA
2012,48035,56,555,52,185,0,13,52,198,0.0154229630783611,0.262626262626263
2012,48037,250,1654,561,2268,19,100,580,2368,0.0383035165475074,0.244932432432432
2012,48039,2312,9468,974,2864,328,775,1302,3639,0.0180902574095984,0.357790601813685
2012,48041,1085,5194,1421,2153,873,1417,2294,3570,0.0377873745713197,0.642577030812325
2012,48043,176,394,34,132,0,7,34,139,0.0223832528180354,0.244604316546763
2012,48045,0,19,0,16,0,0,0,16,0.0140597539543058,0
2012,48047,0,56,20,81,0,2,20,83,0.0181818181818182,0.240963855421687
2012,48049,176,1015,12,129,0,24,12,153,0.00603098269541566,0.0784313725490196
2012,48051,91,438,0,87,0,10,0,97,0.00819325956584171,0
2012,48053,434,1526,57,456,0,42,57,498,0.0165850734339095,0.114457831325301
2012,48055,144,2033,34,325,69,83,103,408,0.0171601615074024,0.252450980392157
2012,48057,110,533,1,124,18,56,19,180,0.0128681727194738,0.105555555555556
2012,48059,174,535,0,69,0,34,0,103,0.0109737907521841,0
2012,48061,440,2342,673,2099,329,1690,1002,3789,0.0163569254678495,0.264449722882027
2012,48063,40,283,0,54,0,78,0,132,0.0161388922851204,0
2012,48065,47,255,7,7,0,0,7,7,0.00164512338425382,1
2012,48067,79,528,94,431,4,70,98,501,0.0236242750035366,0.19560878243513
2012,48069,20,116,21,84,0,12,21,96,0.0198798923172499,0.21875
2012,48071,212,929,19,198,9,13,28,211,0.00955572664281509,0.132701421800948
2012,48073,198,1476,30,261,0,80,30,341,0.010412213740458,0.0879765395894428
2012,48075,36,389,32,95,0,2,32,97,0.0197114407640723,0.329896907216495
2012,48077,34,304,27,73,0,11,27,84,0.0110993657505285,0.321428571428571
2012,48079,12,106,0,27,0,34,0,61,0.0320883745397159,0
2012,48081,25,169,0,0,0,0,0,0,0,NA
2012,48083,0,89,12,72,0,3,12,75,0.0123456790123457,0.16
2012,48085,9844,22444,5948,12423,2742,4191,8690,16614,0.0328137591050578,0.523052846996509
2012,48087,17,47,0,44,1,1,1,45,0.0221674876847291,0.0222222222222222
2012,48089,112,584,81,138,0,0,81,138,0.00967334922192626,0.58695652173913
2012,48091,1312,4398,513,1272,109,372,622,1644,0.0217745460325029,0.378345498783455
2012,48093,104,264,31,77,10,44,41,121,0.0127529510961214,0.338842975206612
2012,48095,12,203,0,233,32,157,32,390,0.117222723174031,0.0820512820512821
2012,48097,157,1116,129,637,10,63,139,700,0.0279151379805392,0.198571428571429
2012,48099,348,2601,297,2059,121,1093,418,3152,0.0697129207767506,0.13261421319797
2012,48101,8,15,0,8,0,0,0,8,0.00677966101694915,0
2012,48103,8,115,17,70,0,0,17,70,0.0250089317613433,0.242857142857143
2012,48105,0,127,0,8,0,11,0,19,0.00753968253968254,0
2012,48107,12,180,13,53,0,17,13,70,0.0179717586649551,0.185714285714286
2012,48109,0,7,0,12,0,6,0,18,0.0121212121212121,0
2012,48111,49,298,0,119,7,96,7,215,0.0552131484334874,0.0325581395348837
2012,48113,14231,41920,11639,24577,4764,11518,16403,36095,0.0242822948803679,0.454439673084915
2012,48115,13,615,0,59,0,10,0,69,0.00771380659586361,0
2012,48117,36,366,3,79,0,41,3,120,0.0107123727905731,0.025
2012,48119,10,206,0,7,0,0,0,7,0.00195040401225968,0
2012,48121,8656,22763,5040,11271,1131,2129,6171,13400,0.0322332339074377,0.460522388059701
2012,48123,127,912,38,90,16,31,54,121,0.00847754501506341,0.446280991735537
2012,48125,0,226,0,35,0,30,0,65,0.0365785030951041,0
2012,48127,25,250,2,11,0,0,2,11,0.00181608056793792,0.181818181818182
2012,48129,43,149,0,14,0,0,0,14,0.00585284280936455,0
2012,48131,0,577,0,35,0,13,0,48,0.00632411067193676,0
2012,48133,49,390,0,188,16,33,16,221,0.0177852889103493,0.0723981900452489
2012,48135,631,3130,166,1342,5,479,171,1821,0.0220925436148788,0.0939044481054366
2012,48137,30,78,32,50,0,0,32,50,0.0355618776671408,0.64
2012,48139,849,3933,344,1090,30,209,374,1299,0.0139474955709454,0.287913779830639
2012,48141,1011,3622,3370,11581,1889,6233,5259,17814,0.0378350710336786,0.29521724486359
2012,48143,145,852,72,327,16,50,88,377,0.0170858826195332,0.23342175066313
2012,48145,196,827,0,55,0,3,0,58,0.0048053024026512,0
2012,48147,238,2008,49,317,5,119,54,436,0.0185943364039577,0.123853211009174
2012,48149,44,485,65,166,7,125,72,291,0.0164984692141966,0.247422680412371
2012,48151,26,98,0,17,0,0,0,17,0.00635514018691589,0
2012,48153,13,102,0,26,0,0,0,26,0.00637254901960784,0
2012,48155,0,59,0,8,0,0,0,8,0.00858369098712446,0
2012,48157,5738,14769,2482,5311,1604,3152,4086,8463,0.023008349124443,0.48280751506558
2012,48159,136,362,0,35,0,0,0,35,0.00486719510499235,0
2012,48161,175,1192,4,118,0,48,4,166,0.0120744835612453,0.0240963855421687
2012,48163,176,920,0,30,0,400,0,430,0.0398627978121813,0
2012,48165,181,405,0,122,0,136,0,258,0.0263668880940215,0
2012,48167,2337,8122,1299,3769,413,648,1712,4417,0.0228671716047401,0.387593389178175
2012,48169,33,315,76,669,0,132,76,801,0.166666666666667,0.0948813982521848
2012,48171,212,723,18,220,0,35,18,255,0.0138677398303241,0.0705882352941176
2012,48173,1,32,0,0,0,0,0,0,0,NA
2012,48175,26,358,4,99,0,0,4,99,0.0187784522003035,0.0404040404040404
2012,48177,172,387,0,92,0,39,0,131,0.0102963137624774,0
2012,48179,194,1172,1,206,0,0,1,206,0.0134280685744084,0.00485436893203883
2012,48181,487,2476,296,1090,54,87,350,1177,0.0146356627704551,0.297366185216652
2012,48183,650,3557,217,1240,128,436,345,1676,0.0215818074119859,0.205847255369928
2012,48185,141,1771,36,168,0,28,36,196,0.0106382978723404,0.183673469387755
2012,48187,1010,3594,404,1584,141,235,545,1819,0.0215332528351919,0.299615173172073
2012,48189,123,2138,37,410,10,26,47,436,0.0201144122531832,0.107798165137615
2012,48191,24,111,0,4,0,0,0,4,0.00178015131286159,0
2012,48193,34,321,2,84,0,0,2,84,0.0138636738735765,0.0238095238095238
2012,48195,12,138,0,77,0,0,0,77,0.0228486646884273,0
2012,48197,5,163,0,11,0,0,0,11,0.00378527185134205,0
2012,48199,157,1272,36,333,0,52,36,385,0.0107149814923047,0.0935064935064935
2012,48201,15913,48466,17454,44015,10341,22935,27795,66950,0.0263324121905499,0.415160567587752
2012,48203,248,1411,149,737,34,101,183,838,0.0196510646280837,0.218377088305489
2012,48205,0,538,38,190,0,28,38,218,0.0486715784773387,0.174311926605505
2012,48207,18,156,0,0,0,0,0,0,0,NA
2012,48209,2001,6502,668,1633,122,231,790,1864,0.0204323234094795,0.42381974248927
2012,48211,0,94,0,89,0,0,0,89,0.0358581788879936,0
2012,48213,313,2335,115,829,18,171,133,1000,0.0183968946041908,0.133
2012,48215,1040,6520,869,4815,1003,4639,1872,9454,0.0223233365525156,0.198011423735985
2012,48217,185,1140,46,308,0,67,46,375,0.0158824276820126,0.122666666666667
2012,48219,247,867,0,174,35,45,35,219,0.015747465305242,0.159817351598174
2012,48221,374,1581,152,612,26,268,178,880,0.0239514438910209,0.202272727272727
2012,48223,154,952,116,316,0,42,116,358,0.0153233745666224,0.324022346368715
2012,48225,78,723,47,200,0,0,47,200,0.011883541295306,0.235
2012,48227,158,1675,77,775,0,117,77,892,0.0377454299255247,0.086322869955157
2012,48229,13,139,3,43,0,4,3,47,0.021901211556384,0.0638297872340425
2012,48231,444,2720,155,650,37,296,192,946,0.0169091624066064,0.202959830866808
2012,48233,71,294,44,365,2,10,46,375,0.0258709899965505,0.122666666666667
2012,48235,5,23,0,35,0,0,0,35,0.0317316409791478,0
2012,48237,51,840,0,169,0,0,0,169,0.027377288190507,0
2012,48239,14,313,0,124,0,10,0,134,0.0143638117697502,0
2012,48241,103,919,6,144,11,31,17,175,0.00723319831363148,0.0971428571428571
2012,48243,31,105,0,4,0,0,0,4,0.0023296447291788,0
2012,48245,952,6800,946,2647,105,549,1051,3196,0.0194151165757469,0.328848560700876
2012,48247,4,100,0,63,0,1,0,64,0.020598648213711,0
2012,48249,131,913,0,246,0,26,0,272,0.0107484391053505,0
2012,48251,575,4575,66,575,25,436,91,1011,0.0104120536771748,0.0900098911968348
2012,48253,73,2331,15,286,0,34,15,320,0.0219840615553724,0.046875
2012,48255,63,962,0,79,0,147,0,226,0.0217286799346217,0
2012,48257,749,4057,112,931,116,267,228,1198,0.0182934278035671,0.190317195325543
2012,48259,388,1292,195,489,0,134,195,623,0.0267657673139715,0.313001605136437
2012,48261,0,0,0,0,0,0,0,0,0,NA
2012,48263,19,46,0,29,0,0,0,29,0.0492359932088285,0
2012,48265,588,1865,189,461,16,85,205,546,0.0153984996333691,0.375457875457875
2012,48267,55,354,0,21,0,0,0,21,0.00607463118310674,0
2012,48269,0,22,0,1,0,0,0,1,0.00510204081632653,0
2012,48271,14,71,66,74,0,74,66,148,0.0584287406237663,0.445945945945946
2012,48273,398,1017,82,249,38,38,120,287,0.015921446799068,0.418118466898955
2012,48275,8,164,0,11,0,0,0,11,0.00422427035330261,0
2012,48277,186,1039,120,772,28,95,148,867,0.0262171152101603,0.170703575547866
2012,48279,22,381,29,101,0,54,29,155,0.0178694950426562,0.187096774193548
2012,48281,73,709,23,103,44,86,67,189,0.0141913200180207,0.354497354497354
2012,48283,11,476,0,25,0,101,0,126,0.0295012877546242,0
2012,48285,108,450,3,19,0,0,3,19,0.0013965453877251,0.157894736842105
2012,48287,36,477,15,188,0,0,15,188,0.0172192709287415,0.0797872340425532
2012,48289,74,355,0,127,0,17,0,144,0.0120653540008379,0
2012,48291,509,5433,49,561,59,167,108,728,0.0148157193153835,0.148351648351648
2012,48293,50,1062,17,219,0,109,17,328,0.0205991333291465,0.0518292682926829
2012,48295,12,108,17,115,0,0,17,115,0.054476551397442,0.147826086956522
2012,48297,60,651,6,177,0,34,6,211,0.0254308786308304,0.028436018957346
2012,48299,264,666,0,160,0,0,0,160,0.0106773440106773,0
2012,48301,0,2,0,0,0,0,0,0,0,NA
2012,48303,1324,6016,1027,3016,365,637,1392,3653,0.0223704193611601,0.381056665754175
2012,48305,25,142,13,24,1,8,14,32,0.00836164097204076,0.4375
2012,48307,95,338,0,37,0,0,0,37,0.00655679603048024,0
2012,48309,1233,4235,599,2199,152,439,751,2638,0.0186780897086416,0.284685367702805
2012,48311,3,8,0,9,0,0,0,9,0.0170454545454545,0
2012,48313,103,534,0,10,0,27,0,37,0.00421556340435228,0
2012,48315,33,370,0,132,0,10,0,142,0.0178683780042783,0
2012,48317,45,207,0,27,0,16,0,43,0.0145812139708376,0
2012,48319,19,66,5,5,0,0,5,5,0.00172294968986906,1
2012,48321,81,778,39,196,0,81,39,277,0.0118401367813635,0.140794223826715
2012,48323,63,503,16,244,45,285,61,529,0.017449531600475,0.11531190926276
2012,48325,150,1482,7,137,12,28,19,165,0.00550183394464822,0.115151515151515
2012,48327,1,87,0,11,0,9,0,20,0.0130463144161774,0
2012,48329,671,3185,589,1376,59,200,648,1576,0.0182430633529732,0.411167512690355
2012,48331,101,747,7,47,0,56,7,103,0.00625949559404436,0.0679611650485437
2012,48333,12,87,0,0,3,3,3,3,0.000884694780300796,1
2012,48335,62,1068,0,48,0,2,0,50,0.00775915580384854,0
2012,48337,81,527,25,86,8,32,33,118,0.00864849017883319,0.279661016949153
2012,48339,4116,15065,2974,7302,1138,2472,4112,9774,0.0331252414746731,0.420708000818498
2012,48341,100,600,34,333,0,76,34,409,0.0324783609942031,0.0831295843520782
2012,48343,58,528,0,78,5,26,5,104,0.011667040610276,0.0480769230769231
2012,48345,0,29,0,6,0,0,0,6,0.0077720207253886,0
2012,48347,335,1216,135,546,0,50,135,596,0.0163911883611562,0.226510067114094
2012,48349,144,1108,120,360,17,74,137,434,0.0142383780059709,0.315668202764977
2012,48351,98,736,0,7,0,0,0,7,0.000713194090677534,0
2012,48353,32,275,6,94,0,14,6,108,0.0110655737704918,0.0555555555555556
2012,48355,1446,7200,1554,3936,267,916,1821,4852,0.0223561502451251,0.375309150865622
2012,48357,60,271,53,332,6,54,59,386,0.0620379299260688,0.152849740932642
2012,48359,4,44,0,12,0,0,0,12,0.0090702947845805,0
2012,48361,267,1702,91,546,9,53,100,599,0.0109861893146012,0.1669449081803
2012,48363,119,791,19,120,0,9,19,129,0.00688808201623238,0.147286821705426
2012,48365,48,553,0,125,0,18,0,143,0.00896383125430953,0
2012,48367,446,4667,470,1379,26,152,496,1531,0.0198316062176166,0.323971260613978
2012,48369,39,206,12,98,0,40,12,138,0.0226824457593688,0.0869565217391304
2012,48371,49,947,2,144,0,33,2,177,0.0171694635755165,0.0112994350282486
2012,48373,162,1924,14,234,22,141,36,375,0.0116041589305607,0.096
2012,48375,759,4905,315,1511,66,649,381,2160,0.0286449354162799,0.176388888888889
2012,48377,126,253,5,21,7,23,12,44,0.0088,0.272727272727273
2012,48379,0,422,0,43,0,0,0,43,0.00549310168625447,0
2012,48381,903,3775,251,776,14,108,265,884,0.0114223692371305,0.299773755656109
2012,48383,21,132,5,21,0,0,5,21,0.0100526567735759,0.238095238095238
2012,48385,17,140,0,1,0,0,0,1,4e-04,0
2012,48387,94,382,28,118,0,44,28,162,0.0176336127136171,0.172839506172839
2012,48389,57,871,0,153,0,140,0,293,0.032077950514561,0
2012,48391,6,170,0,6,1,1,1,7,0.00141385578670976,0.142857142857143
2012,48393,20,20,8,34,0,0,8,34,0.0508221225710015,0.235294117647059
2012,48395,69,357,17,101,0,0,17,101,0.00920021861905629,0.168316831683168
2012,48397,684,2862,300,925,49,192,349,1117,0.022193081798494,0.312444046553268
2012,48399,6,119,0,21,5,10,5,31,0.00434721637918945,0.161290322580645
2012,48401,314,4437,43,353,22,46,65,399,0.0110713393823358,0.162907268170426
2012,48403,86,332,7,75,0,8,7,83,0.010653317930946,0.0843373493975904
2012,48405,19,280,8,114,0,0,8,114,0.0185064935064935,0.0701754385964912
2012,48407,5,1043,0,423,28,28,28,451,0.0250430340385363,0.0620842572062084
2012,48409,345,2305,181,783,43,96,224,879,0.0213785387683627,0.254835039817975
2012,48411,22,251,0,32,0,0,0,32,0.00772760202849553,0
2012,48413,0,88,13,19,0,0,13,19,0.00918762088974855,0.684210526315789
2012,48415,61,591,7,76,0,18,7,94,0.00850063302586363,0.074468085106383
2012,48417,13,34,0,5,16,21,16,26,0.0114386273647162,0.615384615384615
2012,48419,16,407,3,109,0,26,3,135,0.00829340213785477,0.0222222222222222
2012,48421,14,118,11,41,6,6,17,47,0.0260676650027732,0.361702127659574
2012,48423,1702,6318,909,2135,142,410,1051,2545,0.0190918433943722,0.412966601178782
2012,48425,30,460,0,83,0,42,0,125,0.021952932911837,0
2012,48427,71,588,14,208,40,274,54,482,0.0143679017497839,0.112033195020747
2012,48429,86,585,19,136,27,27,46,163,0.0253066294053718,0.282208588957055
2012,48431,0,28,0,32,0,0,0,32,0.0386940749697703,0
2012,48433,10,20,0,0,0,0,0,0,0,NA
2012,48435,20,60,0,0,0,0,0,0,0,NA
2012,48437,16,512,0,37,0,17,0,54,0.0107913669064748,0
2012,48439,9868,33080,7860,23063,2663,6691,10523,29754,0.0262067580565039,0.35366673388452
2012,48441,616,2942,378,1365,56,527,434,1892,0.0234390485629336,0.22938689217759
2012,48443,10,73,0,0,0,0,0,0,0,NA
2012,48445,35,693,23,151,21,82,44,233,0.0289046024066493,0.188841201716738
2012,48447,8,23,0,1,0,2,0,3,0.00250836120401338,0
2012,48449,147,789,59,329,7,94,66,423,0.0223372234250409,0.156028368794326
2012,48451,774,2845,880,2393,55,361,935,2754,0.0397408332010563,0.339506172839506
2012,48453,10169,24557,10740,19235,3143,6235,13883,25470,0.0385248914360391,0.545072634471928
2012,48455,18,287,6,80,0,83,6,163,0.0161546085232904,0.0368098159509202
2012,48457,14,668,37,280,0,0,37,280,0.0181971794371872,0.132142857142857
2012,48459,159,1235,51,302,0,10,51,312,0.0117802529733812,0.163461538461538
2012,48461,20,128,0,23,0,0,0,23,0.0108031939877877,0
2012,48463,102,511,0,118,0,47,0,165,0.0101745082321021,0
2012,48465,174,860,178,553,13,189,191,742,0.0255826782512757,0.257412398921833
2012,48467,108,1290,8,123,6,33,14,156,0.00433200966371387,0.0897435897435897
2012,48469,290,1971,130,736,37,131,167,867,0.0154443593351978,0.192618223760092
2012,48471,632,5094,99,288,7,7,106,295,0.0068124610304136,0.359322033898305
2012,48473,99,1127,20,226,0,44,20,270,0.0108682526264944,0.0740740740740741
2012,48475,15,344,3,83,0,0,3,83,0.0122871946706144,0.036144578313253
2012,48477,221,878,32,51,0,117,32,168,0.00747530479665391,0.19047619047619
2012,48479,450,1969,271,912,525,1754,796,2666,0.0197642523537697,0.298574643660915
2012,48481,58,535,0,122,6,73,6,195,0.00736321413737114,0.0307692307692308
2012,48483,0,210,2,64,0,0,2,64,0.0172367357931592,0.03125
2012,48485,513,3008,419,2167,164,448,583,2615,0.0316816089168888,0.222944550669216
2012,48487,59,483,58,223,6,30,64,253,0.0298948363464492,0.25296442687747
2012,48489,19,1141,22,140,0,202,22,342,0.025438857482892,0.064327485380117
2012,48491,6584,18775,3852,9001,638,1857,4490,10858,0.0398678171470534,0.413519985264321
2012,48493,190,1358,89,348,27,76,116,424,0.0148876404494382,0.273584905660377
2012,48495,33,192,0,70,0,28,0,98,0.0224719101123595,0
2012,48497,392,2004,51,623,5,108,56,731,0.0187990227594188,0.0766073871409029
2012,48499,191,1810,86,334,0,18,86,352,0.0116190790559498,0.244318181818182
2012,48501,0,132,0,58,0,58,0,116,0.0242322958011281,0
2012,48503,80,360,49,243,0,33,49,276,0.0218319886093972,0.177536231884058
2012,48505,0,100,1,147,0,0,1,147,0.0191033138401559,0.00680272108843537
2012,48507,0,320,6,86,0,95,6,181,0.026882518936581,0.0331491712707182
2012,49001,0,203,0,86,0,0,0,86,0.0225013082155939,0
2012,49003,220,698,117,559,39,82,156,641,0.0223189415041783,0.243369734789392
2012,49005,546,1465,683,1708,330,439,1013,2147,0.0376679883504684,0.471821145784816
2012,49007,32,374,16,172,0,34,16,206,0.0155027092113185,0.0776699029126214
2012,49009,10,56,26,26,0,0,26,26,0.039039039039039,1
2012,49011,2437,6326,1361,3933,250,727,1611,4660,0.0269512159856569,0.345708154506438
2012,49013,34,308,47,228,0,0,47,228,0.0215216160090617,0.206140350877193
2012,49015,46,192,45,211,0,0,45,211,0.0319600121175401,0.213270142180095
2012,49017,8,111,37,167,7,7,44,174,0.0502890173410405,0.252873563218391
2012,49019,1,78,55,155,0,1,55,156,0.025,0.352564102564103
2012,49021,141,658,72,385,33,41,105,426,0.0176499834272456,0.246478873239437
2012,49023,29,163,0,60,13,15,13,75,0.0132462027552102,0.173333333333333
2012,49025,24,175,66,203,0,0,66,203,0.0405108760726402,0.32512315270936
2012,49027,132,268,36,95,1,27,37,122,0.0162949111793776,0.30327868852459
2012,49029,38,172,0,29,0,0,0,29,0.00536838208071085,0
2012,49031,0,8,11,17,0,0,11,17,0.0151245551601423,0.647058823529412
2012,49033,0,48,0,24,0,0,0,24,0.0174291938997821,0
2012,49035,3548,10293,6441,15560,1239,3782,7680,19342,0.0309997756194506,0.397063385378968
2012,49037,41,175,164,250,26,26,190,276,0.033666747987314,0.688405797101449
2012,49039,130,1000,52,382,0,14,52,396,0.0262669143008756,0.131313131313131
2012,49041,26,482,21,130,0,0,21,130,0.010380070265091,0.161538461538462
2012,49043,263,593,382,846,77,193,459,1039,0.0433259663900588,0.44177093358999
2012,49045,185,1267,285,846,54,89,339,935,0.0286845011657872,0.362566844919786
2012,49047,128,685,169,504,0,0,169,504,0.0267303102625298,0.33531746031746
2012,49049,1748,5804,2652,6808,806,1739,3458,8547,0.0339361934446408,0.404586404586405
2012,49051,101,412,105,295,11,23,116,318,0.0230167921250724,0.364779874213836
2012,49053,470,1899,875,2714,282,455,1157,3169,0.0376755079476419,0.36509940044178
2012,49055,4,38,21,40,0,61,21,101,0.0563616071428571,0.207920792079208
2012,49057,803,4185,672,2423,17,308,689,2731,0.0198037751172926,0.252288538996705
2012,50001,216,520,352,582,32,104,384,686,0.0277834028593415,0.559766763848397
2012,50003,18,117,226,630,0,0,226,630,0.0240871726247371,0.358730158730159
2012,50005,52,315,279,476,24,60,303,536,0.0249244361776331,0.565298507462687
2012,50007,517,1386,1707,2717,211,348,1918,3065,0.0302844664894721,0.625774877650897
2012,50009,4,68,41,111,7,7,48,118,0.0251813913785745,0.406779661016949
2012,50011,194,640,110,377,10,59,120,436,0.0133672624704908,0.275229357798165
2012,50013,37,142,62,109,0,10,62,119,0.0230530802014723,0.521008403361345
2012,50015,86,362,346,528,69,103,415,631,0.0376896428144786,0.657686212361331
2012,50017,113,437,164,300,22,26,186,326,0.0158614314212037,0.570552147239264
2012,50019,51,410,71,265,5,16,76,281,0.0145182123482304,0.270462633451957
2012,50021,111,528,361,873,21,31,382,904,0.0207644248438074,0.422566371681416
2012,50023,351,788,413,695,30,53,443,748,0.0179307699683575,0.592245989304813
2012,50025,54,252,569,1013,60,94,629,1107,0.0346913193356315,0.568202348690154
2012,50027,246,702,1069,1737,36,86,1105,1823,0.04366885450103,0.606143719144268
2012,51001,63,191,139,384,77,91,216,475,0.0198927883407321,0.454736842105263
2012,51003,1350,2615,1717,2304,332,483,2049,2787,0.0425983951089033,0.735199138858988
2012,51005,44,548,0,78,0,10,0,88,0.00745320572541713,0
2012,51007,34,213,0,68,0,19,0,87,0.0097752808988764,0
2012,51009,83,550,75,176,0,70,75,246,0.0110032651965827,0.304878048780488
2012,51011,24,233,8,51,0,0,8,51,0.0048460661345496,0.156862745098039
2012,51013,4087,6095,9259,11488,2189,2981,11448,14469,0.0925222529158993,0.791208791208791
2012,51015,223,1515,140,246,14,36,154,282,0.0053550065513378,0.546099290780142
2012,51017,0,226,0,15,0,0,0,15,0.00433526011560694,0
2012,51019,498,1701,138,561,45,53,183,614,0.0125229451356312,0.298045602605863
2012,51021,32,275,30,61,0,0,30,61,0.0119210474887629,0.491803278688525
2012,51023,127,679,45,166,0,0,45,166,0.00703360027117495,0.271084337349398
2012,51025,40,323,26,150,0,4,26,154,0.0126416023641438,0.168831168831169
2012,51027,46,231,41,266,0,0,41,266,0.0149354295339697,0.154135338345865
2012,51029,115,846,11,118,0,20,11,138,0.0109942638623327,0.0797101449275362
2012,51031,362,1411,131,343,0,10,131,353,0.00940004793225574,0.371104815864023
2012,51033,105,973,63,270,0,17,63,287,0.0147983912550273,0.219512195121951
2012,51035,16,348,34,303,0,3,34,306,0.0139490358754615,0.111111111111111
2012,51036,6,100,32,58,0,2,32,60,0.0110926234054354,0.533333333333333
2012,51037,35,234,7,24,0,11,7,35,0.0040271545276723,0.2
2012,51041,1906,5922,1710,3905,388,853,2098,4758,0.0229337677799361,0.440941572089113
2012,51043,113,448,110,274,0,6,110,280,0.0277502477700694,0.392857142857143
2012,51045,36,73,0,3,0,0,0,3,0.000807319698600646,0
2012,51047,232,1421,219,540,0,32,219,572,0.018281769368448,0.382867132867133
2012,51049,117,282,0,22,20,34,20,56,0.00840714607416304,0.357142857142857
2012,51051,57,372,14,80,0,0,14,80,0.00700955051257338,0.175
2012,51053,80,528,32,154,0,17,32,171,0.00899621212121212,0.187134502923977
2012,51057,23,203,26,40,0,9,26,49,0.00644397685428722,0.530612244897959
2012,51059,10454,18043,15748,23448,5688,9689,21436,33137,0.0449406049493389,0.646890183178924
2012,51061,490,1860,237,571,32,79,269,650,0.0146667268378537,0.413846153846154
2012,51063,57,161,87,155,0,0,87,155,0.014148790506618,0.561290322580645
2012,51065,188,756,40,183,0,0,40,183,0.00996189439303212,0.218579234972678
2012,51067,108,973,201,470,0,56,201,526,0.0131654694265762,0.38212927756654
2012,51069,527,2035,325,1027,31,85,356,1112,0.0210219861239768,0.320143884892086
2012,51071,46,329,21,268,5,28,26,296,0.0242941562705187,0.0878378378378378
2012,51073,131,768,47,400,49,306,96,706,0.0272976839500445,0.135977337110482
2012,51075,150,566,165,182,8,10,173,192,0.0120007500468779,0.901041666666667
2012,51077,9,220,5,96,0,0,5,96,0.00828014490253579,0.0520833333333333
2012,51079,143,437,112,256,21,60,133,316,0.0252456658943836,0.420886075949367
2012,51081,19,507,0,146,0,0,0,146,0.0162946428571429,0
2012,51083,82,380,82,407,3,30,85,437,0.0170689789860167,0.194508009153318
2012,51085,678,2352,250,1034,33,78,283,1112,0.016597510373444,0.254496402877698
2012,51087,3593,9844,2596,4862,757,1513,3353,6375,0.0306159202785448,0.525960784313726
2012,51089,99,1110,9,405,0,49,9,454,0.0116709511568123,0.0198237885462555
2012,51091,11,77,6,31,0,0,6,31,0.0160871821484172,0.193548387096774
2012,51093,208,848,177,432,13,64,190,496,0.0199959685547269,0.383064516129032
2012,51095,751,1977,798,1360,196,251,994,1611,0.0335757904170401,0.617008069522036
2012,51097,21,131,14,37,0,0,14,37,0.00732528212235201,0.378378378378378
2012,51099,112,756,210,533,11,30,221,563,0.0367421523200418,0.392539964476021
2012,51101,127,552,19,19,0,29,19,48,0.00446428571428571,0.395833333333333
2012,51103,36,177,35,78,19,29,54,107,0.0119366354306113,0.504672897196262
2012,51105,21,217,40,466,0,55,40,521,0.0282844733984799,0.0767754318618042
2012,51107,4363,6803,3724,5930,969,2086,4693,8016,0.0400037927747641,0.585454091816367
2012,51109,104,506,23,214,9,24,32,238,0.0101211992345312,0.134453781512605
2012,51111,36,411,19,103,0,0,19,103,0.0111423626135872,0.184466019417476
2012,51113,62,439,27,121,0,0,27,121,0.0128572946551907,0.223140495867769
2012,51115,63,165,13,48,0,0,13,48,0.0070859167404783,0.270833333333333
2012,51117,96,734,60,246,16,70,76,316,0.0132656059779186,0.240506329113924
2012,51119,14,199,9,27,0,0,9,27,0.00320474777448071,0.333333333333333
2012,51121,706,2044,1057,1785,279,385,1336,2170,0.0437077022236545,0.615668202764977
2012,51125,65,338,35,129,0,0,35,129,0.0116331499684372,0.271317829457364
2012,51127,250,1006,32,88,16,18,48,106,0.00805104055901565,0.452830188679245
2012,51131,27,214,5,85,0,7,5,92,0.010124353471993,0.0543478260869565
2012,51133,83,172,41,106,9,9,50,115,0.0119480519480519,0.434782608695652
2012,51135,113,600,30,101,0,12,30,113,0.0102206946454414,0.265486725663717
2012,51137,514,1346,110,368,0,23,110,391,0.0164770332911926,0.281329923273657
2012,51139,43,404,33,177,7,48,40,225,0.013184881336068,0.177777777777778
2012,51141,20,323,0,76,0,0,0,76,0.0055466355276602,0
2012,51143,291,1499,119,540,0,23,119,563,0.0123924192731835,0.211367673179396
2012,51145,257,1444,53,301,0,5,53,306,0.0152580403889304,0.173202614379085
2012,51147,152,785,242,471,0,29,242,500,0.0382584742520468,0.484
2012,51149,204,1604,256,1169,24,197,280,1366,0.0559767241732574,0.20497803806735
2012,51153,3646,10728,3725,8063,844,1601,4569,9664,0.0382116746472023,0.47278559602649
2012,51155,225,1130,63,281,0,24,63,305,0.0119001170503316,0.20655737704918
2012,51157,12,110,30,90,29,29,59,119,0.0214762678216928,0.495798319327731
2012,51159,47,274,0,111,0,10,0,121,0.0171850589404914,0
2012,51161,867,3023,443,1189,68,210,511,1399,0.0213122495924927,0.365260900643317
2012,51163,138,308,55,305,36,37,91,342,0.0210035005834306,0.266081871345029
2012,51165,553,1761,277,614,96,169,373,783,0.0151723603387137,0.476372924648787
2012,51167,58,352,21,170,0,0,21,170,0.00816601018349505,0.123529411764706
2012,51169,29,333,18,327,0,15,18,342,0.0202199361475701,0.0526315789473684
2012,51171,226,932,65,868,21,68,86,936,0.0314643001210165,0.0918803418803419
2012,51173,29,642,200,549,14,43,214,592,0.025815454386883,0.361486486486487
2012,51175,55,616,13,103,4,36,17,139,0.0104858177429089,0.122302158273381
2012,51177,628,2742,600,1958,89,197,689,2155,0.0274110254649063,0.319721577726218
2012,51179,945,3190,1742,3875,225,533,1967,4408,0.0551213595268166,0.446234119782214
2012,51181,29,220,0,40,0,0,0,40,0.00817828664894705,0
2012,51183,67,426,41,79,0,9,41,88,0.00993676603432701,0.465909090909091
2012,51185,45,508,47,688,0,21,47,709,0.0218975847797887,0.0662905500705219
2012,51187,196,1147,300,584,15,27,315,611,0.0240163515585079,0.515548281505728
2012,51191,172,800,281,902,20,43,301,945,0.0238582140422631,0.318518518518519
2012,51193,129,408,32,233,12,23,44,256,0.020291693088142,0.171875
2012,51195,10,627,28,526,0,47,28,573,0.0200405707890319,0.0488656195462478
2012,51197,0,295,0,78,0,19,0,97,0.00464893362089624,0
2012,51199,627,1719,607,1598,116,492,723,2090,0.0486465097874916,0.345933014354067
2012,51510,3505,5933,5791,7780,1272,2037,7063,9817,0.0922268986509338,0.71946623204645
2012,51515,0,234,13,79,0,0,13,79,0.0180118559051528,0.164556962025316
2012,51520,56,637,101,772,0,9,101,781,0.0625400384368994,0.12932138284251
2012,51530,51,264,0,78,19,19,19,97,0.0225319396051103,0.195876288659794
2012,51540,785,2192,659,862,262,563,921,1425,0.0575246245761343,0.646315789473684
2012,51550,1520,6645,1430,4049,256,627,1686,4676,0.0322009737420203,0.360564585115483
2012,51570,97,504,19,145,0,48,19,193,0.0161858436766186,0.0984455958549223
2012,51580,31,620,8,32,0,8,8,40,0.0098449421609648,0.2
2012,51590,216,1261,194,783,33,115,227,898,0.0302928079881258,0.252783964365256
2012,51595,0,155,0,8,0,35,0,43,0.0109109363105811,0
2012,51600,724,1313,368,466,195,242,563,708,0.0445031114463511,0.795197740112994
2012,51610,370,619,456,562,140,200,596,762,0.0913450011987533,0.782152230971129
2012,51620,51,482,31,158,0,8,31,166,0.0293545534924845,0.186746987951807
2012,51630,518,1522,244,585,0,46,244,631,0.0438224876727551,0.386687797147385
2012,51640,33,396,18,88,7,21,25,109,0.0208253725640046,0.229357798165138
2012,51650,429,2917,725,2127,85,303,810,2430,0.0273812072520761,0.333333333333333
2012,51660,708,1897,351,659,86,228,437,887,0.0412654105605955,0.492671927846674
2012,51670,54,498,6,135,6,6,12,141,0.00956970272838333,0.0851063829787234
2012,51678,94,143,56,95,63,70,119,165,0.0628571428571429,0.721212121212121
2012,51680,670,2779,498,1007,123,272,621,1279,0.0293476514995067,0.485535574667709
2012,51683,557,2144,94,434,11,65,105,499,0.0214107955033039,0.210420841683367
2012,51685,293,759,167,306,0,62,167,368,0.0414975191700496,0.453804347826087
2012,51690,33,665,31,180,0,0,31,180,0.0181836549146378,0.172222222222222
2012,51700,1135,5457,1496,4653,352,1241,1848,5894,0.052362253691299,0.31353919239905
2012,51710,1484,6233,1874,5225,404,820,2278,6045,0.0419616826322366,0.376840363937138
2012,51720,6,236,0,50,0,0,0,50,0.0191277735271614,0
2012,51730,147,561,91,398,6,43,97,441,0.0203272643466236,0.219954648526077
2012,51735,55,302,71,95,0,0,71,95,0.011333810546409,0.747368421052632
2012,51740,472,3392,330,1054,20,79,350,1133,0.0180978851191617,0.308914386584289
2012,51750,31,372,56,176,0,26,56,202,0.0299126314230712,0.277227722772277
2012,51760,2509,7286,1608,3124,221,808,1829,3932,0.0299843672551188,0.465157680569685
2012,51770,863,3640,609,1377,30,326,639,1703,0.0253452791999048,0.375220199647681
2012,51775,229,1029,98,270,91,136,189,406,0.0246793507993435,0.46551724137931
2012,51790,390,1184,42,162,15,26,57,188,0.0111473465757486,0.303191489361702
2012,51800,431,1842,436,1357,82,140,518,1497,0.0270363012461622,0.346025384101536
2012,51810,2111,9444,3889,10145,805,2313,4694,12458,0.0434087242545985,0.376786000963237
2012,51820,63,633,70,219,0,0,70,219,0.0152326632816304,0.319634703196347
2012,51830,415,770,195,333,47,114,242,447,0.0665079601249814,0.541387024608501
2012,51840,222,1474,160,473,13,208,173,681,0.039639115250291,0.254038179148311
2012,53001,49,229,12,148,0,40,12,188,0.0182790471560525,0.0638297872340425
2012,53003,69,262,145,763,55,67,200,830,0.0544440800262381,0.240963855421687
2012,53005,844,3628,1194,3076,395,715,1589,3791,0.0338460989045328,0.419150619889211
2012,53007,360,1544,272,754,0,109,272,863,0.0178615779451941,0.315179606025492
2012,53009,441,1564,357,1620,38,94,395,1714,0.0321142171925354,0.230455075845974
2012,53011,725,3430,3317,10144,274,1010,3591,11154,0.0400007172443472,0.321947283485745
2012,53013,6,152,0,25,3,21,3,46,0.0153282239253582,0.0652173913043478
2012,53015,307,1508,393,1616,67,122,460,1738,0.025086967190635,0.264672036823936
2012,53017,154,1312,123,377,40,155,163,532,0.0214992927864215,0.306390977443609
2012,53019,30,229,6,96,0,15,6,111,0.0208882197967633,0.0540540540540541
2012,53021,437,2780,300,1156,7,140,307,1296,0.0296079685643791,0.236882716049383
2012,53023,6,27,0,48,0,0,0,48,0.0273504273504274,0
2012,53025,236,1067,167,886,49,159,216,1045,0.0197561206163153,0.206698564593301
2012,53027,120,1879,85,627,0,91,85,718,0.0142074123909215,0.118384401114206
2012,53029,477,1628,573,2124,241,552,814,2676,0.0481546130175811,0.304185351270553
2012,53031,264,803,132,623,46,85,178,708,0.0296967409085189,0.251412429378531
2012,53033,6770,21151,22553,38694,9329,14375,31882,53069,0.0393466859041753,0.600765041738115
2012,53035,777,3343,2182,5570,444,1294,2626,6864,0.0405352734831753,0.382575757575758
2012,53037,285,1046,126,335,25,33,151,368,0.0152292666777024,0.410326086956522
2012,53039,70,249,37,288,0,4,37,292,0.0199331012355792,0.126712328767123
2012,53041,417,1933,93,792,0,123,93,915,0.0177023680544807,0.101639344262295
2012,53043,11,282,35,85,12,16,47,101,0.0134023354564756,0.465346534653465
2012,53045,349,2081,250,697,29,75,279,772,0.0176731834622957,0.36139896373057
2012,53047,98,799,174,443,4,138,178,581,0.0205046761955179,0.306368330464716
2012,53049,64,401,86,488,6,49,92,537,0.0339100783026017,0.171322160148976
2012,53051,20,171,41,178,0,17,41,195,0.0205891669306303,0.21025641025641
2012,53053,3011,14639,4101,12662,1319,3995,5420,16657,0.0320348484994182,0.325388725460767
2012,53055,101,311,160,336,11,32,171,368,0.0292597598791445,0.464673913043478
2012,53057,651,2221,439,1719,94,439,533,2158,0.0270816339336136,0.246987951807229
2012,53059,35,202,18,128,0,16,18,144,0.0184002044467161,0.125
2012,53061,4967,15993,3397,9483,804,2552,4201,12035,0.0251836196614284,0.349065226422933
2012,53063,1129,4868,2641,8021,375,1123,3016,9144,0.0296724157513021,0.329833770778653
2012,53065,141,660,112,480,15,84,127,564,0.0185221674876847,0.225177304964539
2012,53067,1542,5505,1761,4559,594,2082,2355,6641,0.038746980641096,0.354615268784822
2012,53069,4,44,7,22,0,0,7,22,0.0072992700729927,0.318181818181818
2012,53071,267,1529,144,1123,38,85,182,1208,0.0319365499008592,0.150662251655629
2012,53073,586,2172,847,2595,314,635,1161,3230,0.0248238124149804,0.359442724458204
2012,53075,400,807,529,805,146,210,675,1015,0.0470364706427545,0.665024630541872
2012,53077,339,1937,639,2687,88,735,727,3422,0.0236402699771335,0.212448860315605
2012,54001,7,168,1,153,0,0,1,153,0.0135518157661647,0.0065359477124183
2012,54003,258,1280,546,2526,11,149,557,2675,0.0381434478825039,0.208224299065421
2012,54005,41,280,0,234,0,0,0,234,0.0135920074349442,0
2012,54007,47,342,2,136,0,0,2,136,0.01308447181066,0.0147058823529412
2012,54009,0,177,22,322,0,11,22,333,0.0193413486670152,0.0660660660660661
2012,54011,299,1309,463,2216,19,133,482,2349,0.0360176638351375,0.205193699446573
2012,54013,38,324,41,161,0,0,41,161,0.029390288426433,0.254658385093168
2012,54015,0,200,3,10,0,0,3,10,0.00153421294875729,0.3
2012,54017,16,279,20,53,0,0,20,53,0.00923827784556388,0.377358490566038
2012,54019,15,486,113,399,4,7,117,406,0.012344552890024,0.288177339901478
2012,54021,78,455,83,420,11,44,94,464,0.0751417004048583,0.202586206896552
2012,54023,0,97,17,76,0,0,17,76,0.00888161738927194,0.223684210526316
2012,54025,27,286,249,716,13,13,262,729,0.0282887077997672,0.359396433470508
2012,54027,21,221,10,297,0,0,10,297,0.0176449619771863,0.0336700336700337
2012,54029,92,409,258,1034,0,23,258,1057,0.0469110598260252,0.244087038789026
2012,54031,2,111,38,288,0,29,38,317,0.0336196839537597,0.1198738170347
2012,54033,148,975,203,719,9,28,212,747,0.0153136531365314,0.28380187416332
2012,54035,90,546,39,198,0,0,39,198,0.00975850172498768,0.196969696969697
2012,54037,34,444,339,1192,96,201,435,1393,0.0391105371030688,0.312275664034458
2012,54039,673,2687,695,2350,49,195,744,2545,0.0184614268615574,0.292337917485265
2012,54041,16,161,20,328,10,10,30,338,0.028578675911051,0.0887573964497041
2012,54043,27,329,0,41,0,30,0,71,0.00467197473185497,0
2012,54045,38,406,27,451,37,44,64,495,0.0188112791669834,0.129292929292929
2012,54047,8,186,2,150,0,0,2,150,0.0094553706505295,0.0133333333333333
2012,54049,168,543,132,433,2,64,134,497,0.0127129482785082,0.269617706237425
2012,54051,84,522,48,476,5,13,53,489,0.0206033538383753,0.10838445807771
2012,54053,53,431,53,485,0,0,53,485,0.0249050015405156,0.109278350515464
2012,54055,153,794,192,866,0,57,192,923,0.021032243363336,0.208017334777898
2012,54057,23,251,40,338,0,0,40,338,0.0173431166298938,0.118343195266272
2012,54059,9,163,12,365,0,29,12,394,0.021044760175195,0.0304568527918782
2012,54061,408,994,902,1581,179,253,1081,1834,0.0330849854779644,0.589422028353326
2012,54063,36,170,23,210,0,0,23,210,0.0214833759590793,0.10952380952381
2012,54065,0,94,3,462,12,12,15,474,0.0370775969962453,0.0316455696202532
2012,54067,36,295,7,374,0,29,7,403,0.0215761858871399,0.0173697270471464
2012,54069,165,624,254,758,30,57,284,815,0.0264876986577399,0.348466257668712
2012,54071,13,49,0,38,0,12,0,50,0.00879352796341892,0
2012,54073,23,320,3,60,0,0,3,60,0.0109469074986316,0.05
2012,54075,31,198,24,143,39,39,63,182,0.0275215484651444,0.346153846153846
2012,54077,77,598,142,786,0,32,142,818,0.0335177217783241,0.17359413202934
2012,54079,337,998,153,377,34,54,187,431,0.0110936655427145,0.433874709976798
2012,54081,278,1480,174,1101,5,175,179,1276,0.0228342370394231,0.140282131661442
2012,54083,86,770,34,130,0,15,34,145,0.00687334091770952,0.23448275862069
2012,54085,0,107,27,60,0,0,27,60,0.00801710315339391,0.45
2012,54087,0,190,9,206,0,0,9,206,0.019335460859771,0.0436893203883495
2012,54089,36,340,50,532,0,7,50,539,0.051505016722408,0.0927643784786642
2012,54091,79,404,0,89,0,0,0,89,0.00731667214731996,0
2012,54093,8,87,13,75,0,0,13,75,0.014367816091954,0.173333333333333
2012,54095,13,77,10,82,0,16,10,98,0.0147657073979207,0.102040816326531
2012,54097,51,274,38,301,0,0,38,301,0.0183112300766517,0.12624584717608
2012,54099,74,432,30,371,15,15,45,386,0.0130154769531645,0.116580310880829
2012,54101,5,156,0,5,0,0,0,5,0.00075723156141148,0
2012,54103,2,110,17,113,0,7,17,120,0.0101112234580384,0.141666666666667
2012,54105,0,96,0,24,0,0,0,24,0.00587084148727984,0
2012,54107,199,680,293,1351,11,83,304,1434,0.023422187377499,0.211994421199442
2012,54109,0,225,13,38,0,0,13,38,0.00226244343891403,0.342105263157895
2012,55001,81,675,35,336,7,43,42,379,0.0232901124562158,0.110817941952507
2012,55003,58,246,92,186,0,5,92,191,0.0176378243605134,0.481675392670157
2012,55005,155,906,81,499,3,12,84,511,0.0158165160331806,0.164383561643836
2012,55007,117,373,100,187,0,0,100,187,0.0163361579453132,0.53475935828877
2012,55009,718,3128,751,1665,191,500,942,2165,0.0133448392763584,0.435103926096998
2012,55011,77,202,20,89,4,18,24,107,0.0111446724299552,0.224299065420561
2012,55013,36,191,98,268,2,18,100,286,0.0244695414099932,0.34965034965035
2012,55015,327,1333,37,112,26,41,63,153,0.00469613259668508,0.411764705882353
2012,55017,236,1971,119,490,13,13,132,503,0.0116794761650452,0.262425447316103
2012,55019,75,530,39,146,0,26,39,172,0.00785065498197088,0.226744186046512
2012,55021,380,1757,104,301,7,51,111,352,0.00890710797337989,0.315340909090909
2012,55023,35,432,47,178,0,2,47,180,0.015187310158623,0.261111111111111
2012,55025,2217,6341,5146,7703,1284,2113,6430,9816,0.0307433077869892,0.655052974735126
2012,55027,437,3185,170,596,12,18,182,614,0.00984700259806909,0.296416938110749
2012,55029,190,494,86,356,17,20,103,376,0.0176120661389292,0.273936170212766
2012,55031,56,347,340,929,8,26,348,955,0.0316340388883368,0.364397905759162
2012,55033,173,891,92,368,7,45,99,413,0.0158535180991133,0.239709443099274
2012,55035,328,1508,517,955,55,164,572,1119,0.018473577336437,0.511170688114388
2012,55037,7,43,18,65,0,0,18,65,0.0192535545023697,0.276923076923077
2012,55039,505,1965,182,527,5,90,187,617,0.0088817872977486,0.303079416531605
2012,55041,17,161,5,25,1,6,6,31,0.00477878834592261,0.193548387096774
2012,55043,118,842,226,367,8,50,234,417,0.0132608280862431,0.561151079136691
2012,55045,75,599,47,226,10,20,57,246,0.00966145628780143,0.231707317073171
2012,55047,125,464,23,72,4,16,27,88,0.00652964309564443,0.306818181818182
2012,55049,116,507,62,116,14,57,76,173,0.0105429946980316,0.439306358381503
2012,55051,8,72,48,161,0,3,48,164,0.0350352488784448,0.292682926829268
2012,55053,60,834,20,159,3,12,23,171,0.0119957909505437,0.134502923976608
2012,55055,353,1664,175,529,72,157,247,686,0.0123911708392038,0.360058309037901
2012,55057,89,556,19,337,3,15,22,352,0.0186026847056337,0.0625
2012,55059,486,2011,1058,3007,123,232,1181,3239,0.03023598820059,0.364618709478234
2012,55061,91,369,45,100,7,25,52,125,0.00871687587168759,0.416
2012,55063,396,1461,682,1417,69,92,751,1509,0.0208287323321555,0.497680583167661
2012,55065,38,223,15,114,0,39,15,153,0.0136024182076814,0.0980392156862745
2012,55067,51,446,19,188,0,0,19,188,0.012986115907992,0.101063829787234
2012,55069,29,428,25,122,6,50,31,172,0.00832365466511808,0.180232558139535
2012,55071,210,709,178,425,2,58,180,483,0.00847918824500114,0.372670807453416
2012,55073,350,1763,430,953,42,128,472,1081,0.011925380873057,0.436632747456059
2012,55075,104,609,30,313,30,69,60,382,0.0127129925452609,0.157068062827225
2012,55077,55,509,33,82,0,23,33,105,0.0092756183745583,0.314285714285714
2012,55078,13,92,5,42,0,0,5,42,0.0167064439140811,0.119047619047619
2012,55079,2990,8929,3904,8366,820,2349,4724,10715,0.0177372764217549,0.440877274848343
2012,55081,172,812,216,682,28,66,244,748,0.0251023558628096,0.32620320855615
2012,55083,118,716,34,120,7,25,41,145,0.00540157949634928,0.282758620689655
2012,55085,103,847,118,435,2,11,120,446,0.0164587792457008,0.269058295964126
2012,55087,1098,3517,686,1215,214,289,900,1504,0.0128665776956507,0.598404255319149
2012,55089,818,1717,582,988,74,102,656,1090,0.0183217911651987,0.601834862385321
2012,55091,26,131,4,17,0,4,4,21,0.00400916380297824,0.19047619047619
2012,55093,59,407,171,659,19,32,190,691,0.0278359651949726,0.274963820549928
2012,55095,78,493,95,489,17,97,112,586,0.0190062272963155,0.191126279863481
2012,55097,274,1059,200,458,5,65,205,523,0.0119346446990096,0.391969407265774
2012,55099,29,218,4,77,4,7,8,84,0.00785854616895874,0.0952380952380952
2012,55101,802,3762,268,1124,59,166,327,1290,0.00987514449097075,0.253488372093023
2012,55103,57,473,26,113,7,34,33,147,0.0117949129423092,0.224489795918367
2012,55105,285,1558,696,1986,95,127,791,2113,0.0198373953208908,0.374349266445812
2012,55107,39,328,86,210,0,5,86,215,0.0205074399084319,0.4
2012,55109,330,1010,829,1932,11,150,840,2082,0.0372971229981011,0.403458213256484
2012,55111,181,894,140,635,11,38,151,673,0.0157877451440368,0.224368499257058
2012,55113,40,239,46,199,0,9,46,208,0.017212843429328,0.221153846153846
2012,55115,156,996,66,285,0,14,66,299,0.0101866993731262,0.220735785953177
2012,55117,352,1670,219,839,17,100,236,939,0.0119151851992843,0.251331203407881
2012,55119,67,248,56,214,2,18,58,232,0.0164271047227926,0.25
2012,55121,54,282,51,178,3,85,54,263,0.0131994981179423,0.20532319391635
2012,55123,104,499,106,199,5,16,111,215,0.0107419435423432,0.516279069767442
2012,55125,90,349,62,215,7,15,69,230,0.0138738086620823,0.3
2012,55127,400,1470,450,1360,44,141,494,1501,0.0225962334592861,0.329113924050633
2012,55129,24,328,48,166,9,27,57,193,0.016357318416815,0.295336787564767
2012,55131,744,2394,278,782,32,74,310,856,0.00942689749350249,0.36214953271028
2012,55133,3046,8470,2177,3785,314,592,2491,4377,0.0162650266624552,0.569111263422435
2012,55135,234,1206,35,336,3,43,38,379,0.0102449045791209,0.100263852242744
2012,55137,132,907,46,208,4,25,50,233,0.0128651096018994,0.214592274678112
2012,55139,1008,4216,427,900,170,299,597,1199,0.0107517239524019,0.49791492910759
2012,55141,252,1230,204,430,6,96,210,526,0.010070647699642,0.399239543726236
2012,56001,182,487,435,1233,155,180,590,1413,0.0724875596367927,0.417551309271054
2012,56003,38,114,32,288,2,25,34,313,0.0401436449916635,0.108626198083067
2012,56005,10,488,233,1325,53,63,286,1388,0.0485620320481422,0.206051873198847
2012,56007,43,355,54,580,0,16,54,596,0.054900515843773,0.0906040268456376
2012,56009,48,293,101,274,0,0,101,274,0.0293802273214669,0.368613138686131
2012,56011,2,90,0,115,1,1,1,116,0.0236156351791531,0.00862068965517241
2012,56013,87,546,180,894,0,26,180,920,0.0346633510417844,0.195652173913043
2012,56015,42,299,100,328,0,10,100,338,0.0366634125176266,0.29585798816568
2012,56017,35,73,52,260,43,55,95,315,0.0886824324324324,0.301587301587302
2012,56019,82,223,0,31,6,11,6,42,0.00679172056921087,0.142857142857143
2012,56021,210,764,787,2171,64,328,851,2499,0.0414276714963032,0.340536214485794
2012,56023,43,218,136,453,0,0,136,453,0.0386452823750213,0.300220750551876
2012,56025,243,1087,627,1759,28,77,655,1836,0.0364618501012829,0.356753812636166
2012,56027,4,107,28,127,8,23,36,150,0.0839395635142697,0.24
2012,56029,169,383,206,870,3,65,209,935,0.0472007673279822,0.223529411764706
2012,56031,13,193,3,207,0,0,3,207,0.0326035596156875,0.0144927536231884
2012,56033,151,511,175,587,5,15,180,602,0.0295764960204382,0.299003322259136
2012,56035,43,185,185,649,0,0,185,649,0.0931267039747453,0.285053929121726
2012,56037,24,270,351,1492,17,42,368,1534,0.0556119489559165,0.239895697522816
2012,56039,11,19,98,312,11,20,109,332,0.0211303462321792,0.328313253012048
2012,56041,75,305,193,507,0,0,193,507,0.0388119115057797,0.380670611439842
2012,56043,28,115,47,126,5,5,52,131,0.0231981583141491,0.396946564885496
2012,56045,47,287,0,53,5,6,5,59,0.0118903667875857,0.0847457627118644
2012,72001,NA,NA,NA,NA,NA,NA,NA,NA,NA,NA
2012,72003,NA,NA,NA,NA,NA,NA,NA,NA,NA,NA
2012,72005,NA,NA,NA,NA,NA,NA,NA,NA,NA,NA
2012,72007,NA,NA,NA,NA,NA,NA,NA,NA,NA,NA
2012,72009,NA,NA,NA,NA,NA,NA,NA,NA,NA,NA
2012,72011,NA,NA,NA,NA,NA,NA,NA,NA,NA,NA
2012,72013,NA,NA,NA,NA,NA,NA,NA,NA,NA,NA
2012,72015,NA,NA,NA,NA,NA,NA,NA,NA,NA,NA
2012,72017,NA,NA,NA,NA,NA,NA,NA,NA,NA,NA
2012,72019,NA,NA,NA,NA,NA,NA,NA,NA,NA,NA
2012,72021,NA,NA,NA,NA,NA,NA,NA,NA,NA,NA
2012,72023,NA,NA,NA,NA,NA,NA,NA,NA,NA,NA
2012,72025,NA,NA,NA,NA,NA,NA,NA,NA,NA,NA
2012,72027,NA,NA,NA,NA,NA,NA,NA,NA,NA,NA
2012,72029,NA,NA,NA,NA,NA,NA,NA,NA,NA,NA
2012,72031,NA,NA,NA,NA,NA,NA,NA,NA,NA,NA
2012,72033,NA,NA,NA,NA,NA,NA,NA,NA,NA,NA
2012,72035,NA,NA,NA,NA,NA,NA,NA,NA,NA,NA
2012,72037,NA,NA,NA,NA,NA,NA,NA,NA,NA,NA
2012,72039,NA,NA,NA,NA,NA,NA,NA,NA,NA,NA
2012,72041,NA,NA,NA,NA,NA,NA,NA,NA,NA,NA
2012,72043,NA,NA,NA,NA,NA,NA,NA,NA,NA,NA
2012,72045,NA,NA,NA,NA,NA,NA,NA,NA,NA,NA
2012,72047,NA,NA,NA,NA,NA,NA,NA,NA,NA,NA
2012,72049,NA,NA,NA,NA,NA,NA,NA,NA,NA,NA
2012,72051,NA,NA,NA,NA,NA,NA,NA,NA,NA,NA
2012,72053,NA,NA,NA,NA,NA,NA,NA,NA,NA,NA
2012,72054,NA,NA,NA,NA,NA,NA,NA,NA,NA,NA
2012,72055,NA,NA,NA,NA,NA,NA,NA,NA,NA,NA
2012,72057,NA,NA,NA,NA,NA,NA,NA,NA,NA,NA
2012,72059,NA,NA,NA,NA,NA,NA,NA,NA,NA,NA
2012,72061,NA,NA,NA,NA,NA,NA,NA,NA,NA,NA
2012,72063,NA,NA,NA,NA,NA,NA,NA,NA,NA,NA
2012,72065,NA,NA,NA,NA,NA,NA,NA,NA,NA,NA
2012,72067,NA,NA,NA,NA,NA,NA,NA,NA,NA,NA
2012,72069,NA,NA,NA,NA,NA,NA,NA,NA,NA,NA
2012,72071,NA,NA,NA,NA,NA,NA,NA,NA,NA,NA
2012,72073,NA,NA,NA,NA,NA,NA,NA,NA,NA,NA
2012,72075,NA,NA,NA,NA,NA,NA,NA,NA,NA,NA
2012,72077,NA,NA,NA,NA,NA,NA,NA,NA,NA,NA
2012,72079,NA,NA,NA,NA,NA,NA,NA,NA,NA,NA
2012,72081,NA,NA,NA,NA,NA,NA,NA,NA,NA,NA
2012,72083,NA,NA,NA,NA,NA,NA,NA,NA,NA,NA
2012,72085,NA,NA,NA,NA,NA,NA,NA,NA,NA,NA
2012,72087,NA,NA,NA,NA,NA,NA,NA,NA,NA,NA
2012,72089,NA,NA,NA,NA,NA,NA,NA,NA,NA,NA
2012,72091,NA,NA,NA,NA,NA,NA,NA,NA,NA,NA
2012,72093,NA,NA,NA,NA,NA,NA,NA,NA,NA,NA
2012,72095,NA,NA,NA,NA,NA,NA,NA,NA,NA,NA
2012,72097,NA,NA,NA,NA,NA,NA,NA,NA,NA,NA
2012,72099,NA,NA,NA,NA,NA,NA,NA,NA,NA,NA
2012,72101,NA,NA,NA,NA,NA,NA,NA,NA,NA,NA
2012,72103,NA,NA,NA,NA,NA,NA,NA,NA,NA,NA
2012,72105,NA,NA,NA,NA,NA,NA,NA,NA,NA,NA
2012,72107,NA,NA,NA,NA,NA,NA,NA,NA,NA,NA
2012,72109,NA,NA,NA,NA,NA,NA,NA,NA,NA,NA
2012,72111,NA,NA,NA,NA,NA,NA,NA,NA,NA,NA
2012,72113,NA,NA,NA,NA,NA,NA,NA,NA,NA,NA
2012,72115,NA,NA,NA,NA,NA,NA,NA,NA,NA,NA
2012,72117,NA,NA,NA,NA,NA,NA,NA,NA,NA,NA
2012,72119,NA,NA,NA,NA,NA,NA,NA,NA,NA,NA
2012,72121,NA,NA,NA,NA,NA,NA,NA,NA,NA,NA
2012,72123,NA,NA,NA,NA,NA,NA,NA,NA,NA,NA
2012,72125,NA,NA,NA,NA,NA,NA,NA,NA,NA,NA
2012,72127,NA,NA,NA,NA,NA,NA,NA,NA,NA,NA
2012,72129,NA,NA,NA,NA,NA,NA,NA,NA,NA,NA
2012,72131,NA,NA,NA,NA,NA,NA,NA,NA,NA,NA
2012,72133,NA,NA,NA,NA,NA,NA,NA,NA,NA,NA
2012,72135,NA,NA,NA,NA,NA,NA,NA,NA,NA,NA
2012,72137,NA,NA,NA,NA,NA,NA,NA,NA,NA,NA
2012,72139,NA,NA,NA,NA,NA,NA,NA,NA,NA,NA
2012,72141,NA,NA,NA,NA,NA,NA,NA,NA,NA,NA
2012,72143,NA,NA,NA,NA,NA,NA,NA,NA,NA,NA
2012,72145,NA,NA,NA,NA,NA,NA,NA,NA,NA,NA
2012,72147,NA,NA,NA,NA,NA,NA,NA,NA,NA,NA
2012,72149,NA,NA,NA,NA,NA,NA,NA,NA,NA,NA
2012,72151,NA,NA,NA,NA,NA,NA,NA,NA,NA,NA
2012,72153,NA,NA,NA,NA,NA,NA,NA,NA,NA,NA
2013,01001,181,1455,404,858,37,37,441,895,0.0250728372926939,0.492737430167598
2013,01003,914,3805,1423,4936,191,376,1614,5312,0.0408417459231296,0.303840361445783
2013,01005,65,1213,18,235,0,101,18,336,0.0176953865599326,0.0535714285714286
2013,01007,55,861,0,118,47,59,47,177,0.0115384615384615,0.265536723163842
2013,01009,149,1538,79,467,0,59,79,526,0.0135406476857334,0.150190114068441
2013,01011,127,365,0,162,0,25,0,187,0.0249001331557923,0
2013,01013,39,197,57,96,16,34,73,130,0.00923295454545455,0.561538461538462
2013,01015,264,2084,159,1185,25,199,184,1384,0.0176204723406964,0.132947976878613
2013,01017,100,548,111,399,6,20,117,419,0.017637649435932,0.279236276849642
2013,01019,80,468,35,300,0,25,35,325,0.0173084092240507,0.107692307692308
2013,01021,69,537,47,453,0,0,47,453,0.0154596955839192,0.103752759381898
2013,01023,69,149,11,119,0,0,11,119,0.0123919608455691,0.092436974789916
2013,01025,4,207,26,96,0,10,26,106,0.00614884854109867,0.245283018867925
2013,01027,24,332,0,165,0,0,0,165,0.0171321773439934,0
2013,01029,8,227,0,103,0,0,0,103,0.0100832109642682,0
2013,01031,123,944,681,1737,139,342,820,2079,0.0611165005732428,0.394420394420394
2013,01033,218,1287,108,516,28,81,136,597,0.0157548887657351,0.227805695142379
2013,01035,0,107,0,9,0,0,0,9,0.00100457640361647,0
2013,01037,14,414,8,32,0,27,8,59,0.00725172074729597,0.135593220338983
2013,01039,81,600,70,358,0,2,70,360,0.0136923779096303,0.194444444444444
2013,01041,35,263,25,133,0,9,25,142,0.0148909395973154,0.176056338028169
2013,01043,135,1090,61,572,0,122,61,694,0.0125836340229552,0.0878962536023055
2013,01045,118,1444,619,2162,56,220,675,2382,0.0719050925227156,0.283375314861461
2013,01047,71,628,34,526,12,51,46,577,0.0207203648507918,0.0797227036395147
2013,01049,213,894,156,558,0,71,156,629,0.0133841177972593,0.248012718600954
2013,01051,412,3874,256,858,92,140,348,998,0.0186294823691923,0.348697394789579
2013,01053,25,676,25,246,0,63,25,309,0.0117929929013052,0.0809061488673139
2013,01055,281,2480,191,775,8,57,199,832,0.0116401080067714,0.239182692307692
2013,01057,9,208,0,285,0,16,0,301,0.0251377985635544,0
2013,01059,66,789,5,297,1,39,6,336,0.0159559312375344,0.0178571428571429
2013,01061,58,684,94,443,0,0,94,443,0.0235901805207945,0.212189616252822
2013,01063,15,165,33,66,0,14,33,80,0.0133000831255195,0.4125
2013,01065,32,278,0,186,0,0,0,186,0.0177277926038887,0
2013,01067,67,330,6,127,4,35,10,162,0.013320177602368,0.0617283950617284
2013,01069,267,1413,396,1767,65,137,461,1904,0.0275954026986681,0.242121848739496
2013,01071,82,635,12,292,0,10,12,302,0.00813774891541592,0.0397350993377483
2013,01073,2924,9618,3475,7257,510,1147,3985,8404,0.0190356249773493,0.474178962398858
2013,01075,17,205,0,45,0,0,0,45,0.00442739079102716,0
2013,01077,280,1524,286,956,26,67,312,1023,0.0163103266848424,0.304985337243402
2013,01079,166,562,48,183,0,32,48,215,0.00922786385681789,0.223255813953488
2013,01081,624,2723,1450,3551,339,595,1789,4146,0.0499698686272147,0.431500241196334
2013,01083,541,2207,212,884,110,203,322,1087,0.0186628665613625,0.296228150873965
2013,01085,25,245,70,82,0,0,70,82,0.011117136659436,0.853658536585366
2013,01087,45,290,50,92,36,57,86,149,0.011714757449485,0.577181208053691
2013,01089,954,3210,2777,6451,522,1053,3299,7504,0.0332482631504324,0.439632196162047
2013,01091,78,453,65,193,0,23,65,216,0.0154572778016316,0.300925925925926
2013,01093,32,636,86,286,0,27,86,313,0.0143901429819319,0.274760383386581
2013,01095,194,1719,145,950,0,34,145,984,0.0158377595364558,0.147357723577236
2013,01097,442,2171,1246,4698,279,837,1525,5535,0.0205077473712291,0.275519421860885
2013,01099,52,247,0,150,10,19,10,169,0.0110587619421542,0.0591715976331361
2013,01101,1215,4800,1778,3909,522,783,2300,4692,0.0320227134676941,0.490196078431373
2013,01103,264,2490,244,757,14,37,258,794,0.00977074437320798,0.324937027707809
2013,01105,14,139,54,76,0,38,54,114,0.0173225953502507,0.473684210526316
2013,01107,1,207,6,206,0,0,6,206,0.0154585021761969,0.029126213592233
2013,01109,85,577,207,567,29,74,236,641,0.0332883257166597,0.36817472698908
2013,01111,6,140,28,417,0,14,28,431,0.0278154243304292,0.0649651972157773
2013,01113,29,561,427,1797,127,353,554,2150,0.0596162377994676,0.257674418604651
2013,01115,548,2785,62,597,7,123,69,720,0.012425361543506,0.0958333333333333
2013,01117,2231,6051,927,2034,246,430,1173,2464,0.0185567320871805,0.476055194805195
2013,01119,9,125,0,85,0,23,0,108,0.0130560928433269,0
2013,01121,252,2255,83,946,83,181,166,1127,0.020136866367681,0.147293700088731
2013,01123,109,719,66,543,0,40,66,583,0.0200902856749027,0.113207547169811
2013,01125,749,3009,755,1786,245,341,1000,2127,0.0181490835864705,0.470145745181006
2013,01127,187,1204,49,404,23,46,72,450,0.00975250314247324,0.16
2013,01129,24,315,25,98,0,0,25,98,0.00846359789273685,0.255102040816327
2013,01131,7,193,0,6,0,18,0,24,0.00320042672356314,0
2013,01133,15,683,0,208,0,0,0,208,0.0119988462647822,0
2013,02013,10,72,28,370,5,18,33,388,0.157851912123678,0.0850515463917526
2013,02016,11,81,30,398,0,51,30,449,0.110455104551046,0.066815144766147
2013,02020,1004,3318,3114,7609,558,1405,3672,9014,0.0484907822325987,0.407366319059241
2013,02050,21,221,111,233,0,7,111,240,0.0264812975835816,0.4625
2013,02060,8,25,3,9,0,4,3,13,0.0210355987055016,0.230769230769231
2013,02068,23,53,18,67,9,9,27,76,0.0546762589928058,0.355263157894737
2013,02070,50,115,25,63,3,6,28,69,0.0253211009174312,0.405797101449275
2013,02090,233,1203,1194,3616,325,908,1519,4524,0.0754188547136784,0.335764809902741
2013,02100,16,36,8,39,0,16,8,55,0.0282340862422998,0.145454545454545
2013,02105,26,58,11,37,14,15,25,52,0.0329531051964512,0.480769230769231
2013,02110,106,292,309,927,18,62,327,989,0.0457171913280636,0.330637007077856
2013,02122,130,856,324,1361,39,102,363,1463,0.0382563673448041,0.24812030075188
2013,02130,53,235,54,290,0,21,54,311,0.0338080226111534,0.173633440514469
2013,02150,22,341,139,409,30,75,169,484,0.0578670492587279,0.349173553719008
2013,02164,0,23,14,22,0,0,14,22,0.0274656679151061,0.636363636363636
2013,02170,471,2104,378,1659,46,185,424,1844,0.032080723729993,0.229934924078091
2013,02180,42,141,34,125,0,32,34,157,0.0298592620768353,0.21656050955414
2013,02185,111,431,46,234,18,40,64,274,0.0451177342334925,0.233576642335766
2013,02188,32,158,34,96,0,0,34,96,0.0245022970903522,0.354166666666667
2013,02195,35,60,27,74,0,11,27,85,0.0315281899109792,0.317647058823529
2013,02198,28,84,36,164,0,4,36,168,0.0440136232643437,0.214285714285714
2013,02220,11,95,92,239,11,46,103,285,0.0467826657912016,0.36140350877193
2013,02230,2,16,10,40,2,2,12,42,0.0526976160602258,0.285714285714286
2013,02240,38,200,131,340,21,21,152,361,0.0797966401414677,0.421052631578947
2013,02261,14,277,36,129,0,46,36,175,0.0268281465583321,0.205714285714286
2013,02270,10,90,36,63,0,0,36,63,0.0183995327102804,0.571428571428571
2013,02275,16,38,11,55,1,2,12,57,0.0315614617940199,0.210526315789474
2013,02282,2,6,0,29,0,0,0,29,0.0732323232323232,0
2013,02290,13,144,30,55,0,0,30,55,0.0155499010460843,0.545454545454545
2013,04001,199,942,171,715,77,147,248,862,0.0203546718930789,0.287703016241299
2013,04003,405,3053,1465,4131,339,904,1804,5035,0.0565647714378799,0.358291956305859
2013,04005,656,2182,1035,2399,22,208,1057,2607,0.0332004635584478,0.405446873801304
2013,04007,199,1528,289,732,3,52,292,784,0.0203668104120123,0.372448979591837
2013,04009,67,951,83,571,10,58,93,629,0.0281759541300842,0.14785373608903
2013,04011,28,287,23,94,0,10,23,104,0.019424729174449,0.221153846153846
2013,04012,11,210,112,522,0,52,112,574,0.0359491451117931,0.195121951219512
2013,04013,5835,22029,31212,83778,6161,15596,37373,99374,0.0397845786015064,0.37608428764063
2013,04015,320,3404,1287,9132,11,624,1298,9756,0.0663307973157648,0.133046330463305
2013,04017,397,2518,189,930,46,164,235,1094,0.0166256344791952,0.214808043875686
2013,04019,1994,8399,7393,18749,1618,3946,9011,22695,0.0348917655740729,0.3970478078872
2013,04021,2217,14681,2132,11179,600,3302,2732,14481,0.0578962098192867,0.188661004074304
2013,04023,185,776,92,450,62,337,154,787,0.027393922517317,0.195679796696315
2013,04025,1198,5189,2176,6223,137,371,2313,6594,0.0417878666894808,0.350773430391265
2013,04027,240,2115,998,4392,183,1287,1181,5679,0.0467796275092876,0.207959147737278
2013,05001,25,349,33,211,24,73,57,284,0.0215543412264724,0.200704225352113
2013,05003,40,145,4,123,0,0,4,123,0.00838388657896531,0.032520325203252
2013,05005,113,521,138,730,0,52,138,782,0.0249425873947436,0.176470588235294
2013,05007,776,2985,2176,5356,850,1322,3026,6678,0.0457877090375531,0.453129679544774
2013,05009,43,355,126,845,0,33,126,878,0.0341196129483542,0.143507972665148
2013,05011,85,129,4,37,0,2,4,39,0.00502901353965184,0.102564102564103
2013,05013,0,206,0,19,0,0,0,19,0.00497252028264852,0
2013,05015,66,533,93,635,34,38,127,673,0.0348813102518918,0.188707280832095
2013,05017,6,289,7,73,0,0,7,73,0.00917200653348411,0.0958904109589041
2013,05019,35,280,62,282,0,35,62,317,0.0237595562884125,0.195583596214511
2013,05021,5,274,15,191,0,0,15,191,0.0171685393258427,0.0785340314136126
2013,05023,173,837,68,513,11,34,79,547,0.0288730535761415,0.144424131627057
2013,05025,11,107,0,15,0,2,0,17,0.0028745350016909,0
2013,05027,45,198,59,172,29,29,88,201,0.0131777355274372,0.437810945273632
2013,05029,90,606,104,212,0,0,104,212,0.0147252899909703,0.490566037735849
2013,05031,209,2107,420,1139,82,154,502,1293,0.0209314749162255,0.388244392884764
2013,05033,52,1085,114,1179,0,69,114,1248,0.030795045156196,0.0913461538461538
2013,05035,54,673,136,988,6,32,142,1020,0.0324985662397247,0.13921568627451
2013,05037,63,396,9,115,0,0,9,115,0.0096105632625773,0.0782608695652174
2013,05039,28,210,0,55,0,0,0,55,0.00996196341242529,0
2013,05041,23,211,0,49,21,24,21,73,0.00855201499531397,0.287671232876712
2013,05043,65,451,58,134,0,22,58,156,0.0132495328690335,0.371794871794872
2013,05045,383,2201,454,1468,32,70,486,1538,0.0220758156425383,0.315994798439532
2013,05047,57,546,30,166,0,15,30,181,0.0148105719662875,0.165745856353591
2013,05049,33,273,0,178,0,3,0,181,0.0202438206017224,0
2013,05051,308,1603,547,2006,67,184,614,2190,0.0318647421720405,0.280365296803653
2013,05053,103,418,5,163,0,49,5,212,0.0174055829228243,0.0235849056603774
2013,05055,106,741,10,547,40,45,50,592,0.0210923860761749,0.0844594594594595
2013,05057,5,285,6,280,0,16,6,296,0.0198431319970503,0.0202702702702703
2013,05059,36,960,74,154,0,0,74,154,0.00673400673400673,0.480519480519481
2013,05061,29,217,2,79,0,12,2,91,0.0100685992476212,0.021978021978022
2013,05063,127,866,25,400,0,7,25,407,0.0165245635403979,0.0614250614250614
2013,05065,20,472,33,265,0,5,33,270,0.0266983091070899,0.122222222222222
2013,05067,66,1559,15,206,0,2,15,208,0.0164517915051807,0.0721153846153846
2013,05069,60,1188,145,654,54,99,199,753,0.015143897190435,0.264276228419655
2013,05071,23,440,12,218,0,43,12,261,0.0155700053689674,0.0459770114942529
2013,05073,6,158,10,71,0,0,10,71,0.0138078568650331,0.140845070422535
2013,05075,0,290,14,98,0,4,14,102,0.00873437232402809,0.137254901960784
2013,05077,0,262,2,130,0,20,2,150,0.0212675457252233,0.0133333333333333
2013,05079,3,685,0,177,0,0,0,177,0.0178878221323901,0
2013,05081,93,224,14,273,4,39,18,312,0.0339980385746976,0.0576923076923077
2013,05083,2,430,7,217,0,0,7,217,0.0143861044815699,0.032258064516129
2013,05085,393,1801,237,896,69,228,306,1124,0.0252085762985557,0.272241992882562
2013,05087,26,153,0,171,0,0,0,171,0.0160774727341106,0
2013,05089,40,474,44,282,0,5,44,287,0.0226680357001817,0.153310104529617
2013,05091,28,866,103,838,0,57,103,895,0.0308546212983073,0.115083798882682
2013,05093,68,572,142,723,4,36,146,759,0.0262139946121434,0.19235836627141
2013,05095,1,133,2,119,0,0,2,119,0.0213376367222521,0.0168067226890756
2013,05097,6,273,18,129,0,0,18,129,0.0190321628799056,0.13953488372093
2013,05099,14,179,8,65,36,62,44,127,0.0206403380464814,0.346456692913386
2013,05101,9,131,9,73,5,9,14,82,0.013856032443393,0.170731707317073
2013,05103,58,412,139,227,13,13,152,240,0.0135861873761676,0.633333333333333
2013,05105,130,481,3,51,0,19,3,70,0.00971817298347911,0.0428571428571429
2013,05107,6,216,25,231,0,0,25,231,0.0171111111111111,0.108225108225108
2013,05109,68,404,36,102,0,12,36,114,0.0150039484074757,0.315789473684211
2013,05111,46,651,12,190,0,49,12,239,0.0145341765993675,0.0502092050209205
2013,05113,31,212,9,164,11,11,20,175,0.0123196057726153,0.114285714285714
2013,05115,209,1431,124,542,20,68,144,610,0.0156498537636616,0.236065573770492
2013,05117,19,164,0,39,0,0,0,39,0.00634765625,0
2013,05119,1635,6151,2401,5714,366,980,2767,6694,0.0259600245096138,0.413355243501643
2013,05121,8,219,36,320,0,10,36,330,0.0267748478701826,0.109090909090909
2013,05123,42,533,77,818,0,64,77,882,0.0465607348360872,0.0873015873015873
2013,05125,608,3299,460,1093,0,69,460,1162,0.0154615855443489,0.395869191049914
2013,05127,7,100,31,144,0,0,31,144,0.0195307201953072,0.215277777777778
2013,05129,0,81,0,11,0,9,0,20,0.00336304018833025,0
2013,05131,246,1765,524,2241,46,116,570,2357,0.0285026725034464,0.24183283835384
2013,05133,44,169,20,314,51,140,71,454,0.0432916944788786,0.156387665198238
2013,05135,66,419,26,252,0,0,26,252,0.0203143893591294,0.103174603174603
2013,05137,114,419,0,186,27,28,27,214,0.0241507730504458,0.126168224299065
2013,05139,184,502,63,549,2,6,65,555,0.01975932782683,0.117117117117117
2013,05141,34,357,20,240,14,20,34,260,0.0208149867904892,0.130769230769231
2013,05143,1199,4305,1373,3559,296,551,1669,4110,0.0330979166834438,0.406082725060827
2013,05145,172,1116,205,1107,4,168,209,1275,0.0257638215324927,0.163921568627451
2013,05147,0,50,2,39,0,0,2,39,0.00775810622637756,0.0512820512820513
2013,05149,19,556,0,110,12,12,12,122,0.00833902939166097,0.0983606557377049
2013,06001,18184,34375,9005,13586,5371,9194,14376,22780,0.0218145742040266,0.631079894644425
2013,06003,27,34,14,72,3,3,17,75,0.0921375921375921,0.226666666666667
2013,06005,146,1446,20,178,6,28,26,206,0.00713889658996396,0.12621359223301
2013,06007,712,3547,450,1561,119,376,569,1937,0.0137173531244689,0.293753226639133
2013,06009,309,1260,37,299,23,23,60,322,0.00959875991176295,0.186335403726708
2013,06011,59,369,54,147,0,75,54,222,0.0169220214955408,0.243243243243243
2013,06013,11801,25513,3858,6697,2123,4420,5981,11117,0.0155346073658381,0.538004857425564
2013,06015,119,1931,104,365,8,54,112,419,0.0214464861544761,0.267303102625298
2013,06017,1265,4616,599,1485,124,242,723,1727,0.0135986393486512,0.418645049218298
2013,06019,2281,11620,1157,4179,687,2350,1844,6529,0.0117929256895764,0.282432225455659
2013,06021,119,825,52,226,3,22,55,248,0.0139757678219217,0.221774193548387
2013,06023,597,2328,642,1588,0,19,642,1607,0.0177541595775239,0.399502177971375
2013,06025,353,2722,342,1298,112,584,454,1882,0.0179897720212207,0.241232731137088
2013,06027,76,541,50,215,1,8,51,223,0.0166766377505235,0.228699551569507
2013,06029,2288,20338,1563,5796,490,2246,2053,8042,0.0161259597472624,0.255284755036061
2013,06031,475,6791,297,1123,184,590,481,1713,0.0185979350103684,0.280793928779918
2013,06033,498,2052,195,766,18,143,213,909,0.0197815111420613,0.234323432343234
2013,06035,152,4317,22,432,0,74,22,506,0.0205682695825373,0.0434782608695652
2013,06037,26661,67850,32314,58152,20104,41412,52418,99564,0.0154200891714931,0.526475432887389
2013,06039,563,5087,76,433,36,296,112,729,0.00785035859662725,0.15363511659808
2013,06041,4137,9057,1537,2760,587,793,2124,3553,0.0189970539328126,0.597804672108078
2013,06043,132,733,82,239,8,18,90,257,0.018851316658109,0.350194552529183
2013,06045,293,1722,251,1016,34,156,285,1172,0.0191131623151062,0.243174061433447
2013,06047,749,5307,208,914,65,292,273,1206,0.00817051028427414,0.22636815920398
2013,06049,3,203,52,212,0,0,52,212,0.0311444101660056,0.245283018867925
2013,06051,360,784,41,167,39,40,80,207,0.0211916461916462,0.386473429951691
2013,06053,1746,7091,2087,4715,1107,1954,3194,6669,0.025437693099897,0.478932373669216
2013,06055,1499,3391,312,798,66,391,378,1189,0.0126586321437697,0.317914213624895
2013,06057,1056,2882,378,854,127,304,505,1158,0.0158011079878831,0.436096718480138
2013,06059,21694,48178,10432,20220,6627,13909,17059,34129,0.0169896774604641,0.499838846728589
2013,06061,3541,11118,1658,3343,375,917,2033,4260,0.0175457383625625,0.477230046948357
2013,06063,153,356,40,238,0,0,40,238,0.0161498269661396,0.168067226890756
2013,06065,12128,57452,5477,17266,2232,7584,7709,24850,0.0180592911601042,0.310221327967807
2013,06067,8214,29993,4244,10162,1701,4722,5945,14884,0.0160050410932979,0.399422198333781
2013,06069,353,1786,54,174,7,125,61,299,0.00855924197749978,0.204013377926421
2013,06071,9057,49272,3203,13306,1871,5962,5074,19268,0.0156147054414023,0.263338177288769
2013,06073,10625,25496,18849,37942,8131,18534,26980,56476,0.0275965324025685,0.477725051349246
2013,06075,13078,20025,10200,12660,4987,8028,15187,20688,0.0325584542917891,0.734097061098221
2013,06077,3249,15899,758,3094,478,1877,1236,4971,0.0118163298778908,0.248642124321062
2013,06079,2504,7990,691,1762,286,801,977,2563,0.0142480709790754,0.381193913382755
2013,06081,10757,20257,3236,4872,2309,4278,5545,9150,0.0178261454029001,0.606010928961749
2013,06083,2125,6428,2044,4176,701,2245,2745,6421,0.0243782983408634,0.427503504127083
2013,06085,14510,26445,12108,16036,12707,18144,24815,34180,0.0280116865608648,0.726009362200117
2013,06087,2038,6063,1146,1901,378,576,1524,2477,0.0145144089348287,0.615260395639887
2013,06089,875,3935,525,1896,143,447,668,2343,0.0190972222222222,0.285104566794708
2013,06091,27,60,0,18,0,0,0,18,0.00728450020234723,0
2013,06093,298,922,124,439,21,49,145,488,0.0151878248420528,0.297131147540984
2013,06095,2784,11084,857,3082,646,1562,1503,4644,0.0168500188673769,0.323643410852713
2013,06097,3309,8250,1795,3487,411,917,2206,4404,0.0130951389797448,0.500908265213442
2013,06099,1804,9604,504,2683,213,1411,717,4094,0.0128858029548588,0.175134342940889
2013,06101,344,2646,71,397,131,370,202,767,0.0128366052451005,0.263363754889179
2013,06103,244,2292,110,538,0,78,110,616,0.0146096195806849,0.178571428571429
2013,06105,99,478,8,151,0,0,8,151,0.0144927536231884,0.0529801324503311
2013,06107,834,5569,616,2491,115,724,731,3215,0.0126371812207163,0.227371695178849
2013,06109,278,2760,77,333,0,8,77,341,0.00831139709466706,0.225806451612903
2013,06111,5461,13777,3083,7321,1206,2690,4289,10011,0.0186445760132901,0.428428728398761
2013,06113,1659,5478,876,1655,908,1614,1784,3269,0.0277957281817563,0.545732639951055
2013,06115,190,3208,214,893,72,260,286,1153,0.0261113753198813,0.248048568950564
2013,08001,3618,16366,1604,5531,212,1479,1816,7010,0.0248356102261777,0.259058487874465
2013,08003,171,664,18,171,0,12,18,183,0.0195491934622369,0.0983606557377049
2013,08005,7316,22704,5301,12425,919,2290,6220,14715,0.0379861530598021,0.422697927285083
2013,08007,13,67,174,448,0,11,174,459,0.0518292682926829,0.379084967320261
2013,08009,23,58,6,61,0,0,6,61,0.0222627737226277,0.0983606557377049
2013,08011,31,352,4,80,0,0,4,80,0.0167329010667224,0.05
2013,08013,2941,6376,4785,6993,1086,1484,5871,8477,0.0439644218551461,0.692579922142267
2013,08014,1224,3798,1038,1520,73,141,1111,1661,0.0439371495079886,0.66887417218543
2013,08015,423,743,46,219,0,13,46,232,0.0164901556613832,0.198275862068966
2013,08017,27,74,8,10,0,0,8,10,0.006765899864682,0.8
2013,08019,61,207,46,74,0,0,46,74,0.0106245513280689,0.621621621621622
2013,08021,39,180,27,90,14,15,41,105,0.0200305227012591,0.39047619047619
2013,08023,0,19,6,27,13,13,19,40,0.0157294534014943,0.475
2013,08025,15,227,0,30,0,0,0,30,0.00753768844221105,0
2013,08027,34,114,27,51,18,18,45,69,0.020353982300885,0.652173913043478
2013,08029,89,609,91,426,0,36,91,462,0.0209476309226933,0.196969696969697
2013,08031,10300,26813,10412,15846,1560,3117,11972,18963,0.0443314514149455,0.631334704424405
2013,08033,9,53,4,4,0,0,4,4,0.00308880308880309,1
2013,08035,4332,8390,3673,6341,461,592,4134,6933,0.0368653057751924,0.596278667243617
2013,08037,467,978,612,899,36,270,648,1169,0.0331086439333862,0.554319931565441
2013,08039,171,671,197,503,11,51,208,554,0.0346379892459672,0.375451263537906
2013,08041,1586,5831,8134,21752,1353,5595,9487,27347,0.0683582716333295,0.346911909898709
2013,08043,204,1189,87,1086,7,47,94,1133,0.0315405601024442,0.0829655781112092
2013,08045,327,1253,354,1322,52,141,406,1463,0.039626218851571,0.277511961722488
2013,08047,30,249,83,214,0,0,83,214,0.0496289424860853,0.38785046728972
2013,08049,18,93,250,349,0,0,250,349,0.0330837046165513,0.716332378223496
2013,08051,96,372,205,279,9,31,214,310,0.0321843853820598,0.690322580645161
2013,08053,7,42,28,28,0,0,28,28,0.0403458213256484,1
2013,08055,40,345,76,200,2,17,78,217,0.0420135527589545,0.359447004608295
2013,08057,4,30,7,30,0,0,7,30,0.029126213592233,0.233333333333333
2013,08059,6241,17487,4281,9133,779,1516,5060,10649,0.0282577775890801,0.475161987041037
2013,08061,6,21,3,7,0,0,3,7,0.00771775082690187,0.428571428571429
2013,08063,40,218,2,229,0,36,2,265,0.0462639664804469,0.00754716981132075
2013,08065,134,215,153,178,0,0,153,178,0.0365578147463545,0.859550561797753
2013,08067,202,839,858,1620,27,36,885,1656,0.0463540937718684,0.534420289855073
2013,08069,1936,4524,4127,7914,402,891,4529,8805,0.0446127732880703,0.514366837024418
2013,08071,41,197,50,223,0,4,50,227,0.0212546816479401,0.220264317180617
2013,08073,9,255,2,41,0,0,2,41,0.0100539480137322,0.0487804878048781
2013,08075,79,718,16,213,15,47,31,260,0.0174836930939412,0.119230769230769
2013,08077,616,2362,742,2809,134,286,876,3095,0.0314654033061548,0.283037156704362
2013,08079,2,26,5,8,0,0,5,8,0.0117820324005891,0.625
2013,08081,63,194,16,145,0,21,16,166,0.019170804942834,0.0963855421686747
2013,08083,171,502,215,706,0,0,215,706,0.0397008378788731,0.304532577903683
2013,08085,325,898,478,1227,10,42,488,1269,0.0446516537649543,0.384554767533491
2013,08087,82,845,69,259,0,76,69,335,0.0185956147654732,0.205970149253731
2013,08089,74,536,38,165,0,21,38,186,0.0147595619742898,0.204301075268817
2013,08091,127,191,117,302,0,0,117,302,0.0843575418994413,0.387417218543046
2013,08093,150,496,231,682,12,12,243,694,0.0561852331606218,0.35014409221902
2013,08095,7,248,4,42,18,70,22,112,0.0389023966655089,0.196428571428571
2013,08097,297,487,303,541,0,31,303,572,0.0433103657151511,0.52972027972028
2013,08099,66,323,0,160,0,22,0,182,0.0231994901210962,0
2013,08101,418,2309,569,1969,39,293,608,2262,0.0212809995107816,0.268788682581786
2013,08103,0,77,38,229,20,21,58,250,0.0557786702365016,0.232
2013,08105,73,417,66,349,0,0,66,349,0.0437782237832413,0.189111747851003
2013,08107,365,524,43,206,31,59,74,265,0.015992757996379,0.279245283018868
2013,08109,34,161,41,117,0,29,41,146,0.0339771933907377,0.280821917808219
2013,08111,0,1,4,25,0,0,4,25,0.0499001996007984,0.16
2013,08113,27,74,254,448,28,75,282,523,0.0947978974080116,0.539196940726577
2013,08115,9,101,0,45,0,0,0,45,0.0277264325323475,0
2013,08117,330,812,579,1107,25,97,604,1204,0.0592111734041507,0.501661129568106
2013,08119,79,550,101,382,22,49,123,431,0.0248658628050539,0.28538283062645
2013,08121,7,199,22,108,0,8,22,116,0.0343500148060409,0.189655172413793
2013,08123,1593,6049,1095,4802,209,500,1304,5302,0.0331590533847001,0.245944926442852
2013,08125,91,448,51,194,18,28,69,222,0.0330111524163569,0.310810810810811
2013,09001,1829,4864,9148,14425,2189,4726,11337,19151,0.0306613704516672,0.591979531094982
2013,09003,3355,9358,5364,9259,1063,3086,6427,12345,0.0201055029958747,0.520615633859862
2013,09005,889,2571,866,1637,83,321,949,1958,0.0144111520825513,0.484678243105209
2013,09007,1339,3481,1032,1802,183,485,1215,2287,0.0193613382773742,0.531263664188894
2013,09009,2924,8407,4883,8695,1345,2848,6228,11543,0.0196639262436671,0.539547777874036
2013,09011,747,4007,1961,4794,320,870,2281,5664,0.0300884485643709,0.402718926553672
2013,09013,856,3846,765,1525,357,467,1122,1992,0.0207105205701631,0.563253012048193
2013,09015,571,2351,282,1466,84,209,366,1675,0.0210105115275583,0.218507462686567
2013,10001,425,1873,580,2310,153,449,733,2759,0.0259121859591453,0.265675969554186
2013,10003,311,1662,5176,11278,908,1639,6084,12917,0.0359039928842439,0.471007199814198
2013,10005,259,1364,1822,5066,65,694,1887,5760,0.0395908940943583,0.327604166666667
2013,11001,0,0,20039,28290,4632,5603,24671,33893,0.0787646959031575,0.727908417667365
2013,12001,1414,4885,2476,3650,1107,1626,3583,5276,0.0358416608357167,0.679112964366945
2013,12003,64,1339,11,278,14,14,25,292,0.0167076729415804,0.0856164383561644
2013,12005,558,2671,1161,4263,349,832,1510,5095,0.0433679766434293,0.296368989205103
2013,12007,91,1786,10,86,0,0,10,86,0.00428265524625268,0.116279069767442
2013,12009,1552,6200,2742,10763,463,1298,3205,12061,0.0304284863713885,0.265732526324517
2013,12011,10149,31239,8521,23580,5419,15021,13940,38601,0.0311792729440387,0.361130540659568
2013,12013,66,731,0,156,0,0,0,156,0.0150260065497977,0
2013,12015,933,4060,1438,5397,190,493,1628,5890,0.0454773578349998,0.276400679117148
2013,12017,260,2399,418,2869,28,155,446,3024,0.0274719284857735,0.147486772486772
2013,12019,935,5459,1023,2701,197,572,1220,3273,0.0258637038910137,0.372746715551482
2013,12021,966,5046,3567,8755,822,2122,4389,10877,0.0448123993193888,0.403511997793509
2013,12023,267,2523,241,1122,0,121,241,1243,0.0274114585630486,0.193885760257442
2013,12027,43,1249,67,291,29,374,96,665,0.0286675001077726,0.144360902255639
2013,12029,75,626,0,126,20,20,20,146,0.0123206751054852,0.136986301369863
2013,12031,3876,12359,4695,14533,970,2939,5665,17472,0.0301599138288176,0.324233058608059
2013,12033,902,4252,1734,7294,195,642,1929,7936,0.0401617400721656,0.243069556451613
2013,12035,703,2286,495,2379,0,241,495,2620,0.0363454762367173,0.188931297709924
2013,12037,24,941,20,89,4,4,24,93,0.0105478053759782,0.258064516129032
2013,12039,76,1594,46,244,97,139,143,383,0.0119829797884988,0.373368146214099
2013,12041,29,461,29,187,0,26,29,213,0.0188112690982955,0.136150234741784
2013,12043,62,497,84,253,15,15,99,268,0.0281305762569539,0.369402985074627
2013,12045,39,905,69,263,0,6,69,269,0.0225633283006207,0.256505576208178
2013,12047,20,858,0,64,0,16,0,80,0.00818414322250639,0
2013,12049,74,637,38,502,20,135,58,637,0.0371233754880821,0.0910518053375196
2013,12051,295,1137,53,421,49,274,102,695,0.0296236307062785,0.146762589928058
2013,12053,440,4075,618,4229,104,316,722,4545,0.035604054710389,0.158855885588559
2013,12055,290,2077,289,2219,0,377,289,2596,0.0351052752572719,0.111325115562404
2013,12057,5645,18783,8123,19337,2914,7017,11037,26354,0.0316529204545318,0.418797905441299
2013,12059,99,680,88,314,0,16,88,330,0.0235361243848513,0.266666666666667
2013,12061,585,3088,902,3380,190,482,1092,3862,0.0370469850162117,0.282755049197307
2013,12063,188,2222,92,542,28,76,120,618,0.0174986550386499,0.194174757281553
2013,12065,68,807,16,78,0,9,16,87,0.00806376865325795,0.183908045977011
2013,12067,28,423,0,85,0,10,0,95,0.0162559890485969,0
2013,12069,1765,7025,1113,6344,140,506,1253,6850,0.0313307567406865,0.182919708029197
2013,12071,1804,9801,5539,19291,788,3446,6327,22737,0.0490467623571438,0.27826890091041
2013,12073,1800,5080,1880,3697,511,773,2391,4470,0.027848905668841,0.53489932885906
2013,12075,174,1461,19,643,0,53,19,696,0.0241465445462115,0.0272988505747126
2013,12077,61,627,7,153,12,12,19,165,0.0299021384559623,0.115151515151515
2013,12079,62,870,9,199,0,16,9,215,0.0161897590361446,0.0418604651162791
2013,12081,1628,7278,3078,9215,493,1985,3571,11200,0.046759015722719,0.318839285714286
2013,12083,1216,7311,1535,6905,94,714,1629,7619,0.0310429687818314,0.213807586297414
2013,12085,1130,4469,1335,3717,107,493,1442,4210,0.0374478531972995,0.342517814726841
2013,12086,4768,18145,9054,19015,9412,25800,18466,44815,0.0255770021002648,0.412049536985384
2013,12087,397,1895,951,2669,144,554,1095,3223,0.0561058403690487,0.339745578653428
2013,12089,242,1469,499,1543,148,213,647,1756,0.0334865272030359,0.368451025056948
2013,12091,578,2775,1852,5698,318,721,2170,6419,0.0512613698980203,0.338058887677208
2013,12093,53,709,65,494,10,71,75,565,0.0211800869695607,0.132743362831858
2013,12095,6814,23401,5686,17773,3686,9862,9372,27635,0.0365539910450328,0.339135154695133
2013,12097,875,6553,754,3968,529,2110,1283,6078,0.0337921985500156,0.211089174070418
2013,12099,5708,17477,10354,24523,2888,8619,13242,33142,0.0344868850565503,0.399553436726812
2013,12101,2441,9839,1887,8633,289,1353,2176,9986,0.0296525490918053,0.217905067093932
2013,12103,4749,14709,6222,18539,1641,4431,7863,22970,0.0332495700860986,0.342316064431868
2013,12105,2128,10194,2123,9916,577,2539,2700,12455,0.0300957360950692,0.216780409474107
2013,12107,111,1505,120,652,13,69,133,721,0.0140677436978069,0.184466019417476
2013,12109,2025,6061,2407,4516,238,720,2645,5236,0.0382686994781541,0.505156608097785
2013,12111,1488,7622,1123,5486,135,912,1258,6398,0.0323471121177803,0.196623944982807
2013,12113,698,3695,1987,5137,123,551,2110,5688,0.0537867254210362,0.370956399437412
2013,12115,1967,7528,3698,10786,636,1947,4334,12733,0.0423641124430648,0.340375402497448
2013,12117,3277,10548,2306,5591,694,1744,3000,7335,0.0253697375520538,0.408997955010225
2013,12119,537,2799,2154,5586,70,578,2224,6164,0.071421950315165,0.36080467229072
2013,12121,147,1752,117,549,0,36,117,585,0.0197255285430084,0.2
2013,12123,39,1340,58,214,9,16,67,230,0.0140500916310324,0.291304347826087
2013,12125,45,1330,0,151,0,0,0,151,0.0139892532888642,0
2013,12127,2157,9090,2246,11100,291,1188,2537,12288,0.0341746276751074,0.206461588541667
2013,12129,64,2038,57,360,0,44,57,404,0.0187002406961674,0.141089108910891
2013,12131,367,1944,600,1500,14,36,614,1536,0.0375485858166084,0.399739583333333
2013,12133,83,1295,18,233,0,16,18,249,0.0143383623171715,0.072289156626506
2013,13001,171,342,0,67,0,17,0,84,0.00686554965263588,0
2013,13003,3,93,7,121,0,7,7,128,0.0247008876881513,0.0546875
2013,13005,20,317,18,125,0,0,18,125,0.016850903208412,0.144
2013,13007,0,35,0,0,0,0,0,0,0,NA
2013,13009,112,995,108,333,0,33,108,366,0.0131352282515073,0.295081967213115
2013,13011,86,648,17,49,0,28,17,77,0.00628520120806465,0.220779220779221
2013,13013,389,2366,61,488,0,31,61,519,0.011592584319857,0.117533718689788
2013,13015,332,2010,84,941,83,137,167,1078,0.0165033680342927,0.154916512059369
2013,13017,163,547,48,242,0,18,48,260,0.0234107689537187,0.184615384615385
2013,13019,30,436,7,135,0,31,7,166,0.012954580927111,0.0421686746987952
2013,13021,768,3630,424,1075,166,365,590,1440,0.0144924619069664,0.409722222222222
2013,13023,162,408,0,15,0,6,0,21,0.0026697177726926,0
2013,13025,2,390,1,291,0,0,1,291,0.0241694352159468,0.00343642611683849
2013,13027,80,554,0,178,0,13,0,191,0.0176622896245608,0
2013,13029,284,858,584,966,232,274,816,1240,0.0625725387293738,0.658064516129032
2013,13031,231,1466,180,496,23,62,203,558,0.0150436751860239,0.363799283154122
2013,13033,26,536,42,163,17,17,59,180,0.0123304562268804,0.327777777777778
2013,13035,71,1557,13,159,0,8,13,167,0.0104446807179936,0.0778443113772455
2013,13037,45,679,9,86,0,0,9,86,0.0189845474613687,0.104651162790698
2013,13039,52,549,310,1537,13,164,323,1701,0.055277525022748,0.189888300999412
2013,13043,13,522,0,93,0,0,0,93,0.0131971051511281,0
2013,13045,705,3129,267,1028,40,304,307,1332,0.0194902109976296,0.23048048048048
2013,13047,96,906,335,1460,2,16,337,1476,0.0340029487652046,0.228319783197832
2013,13049,11,860,27,543,0,5,27,548,0.0585720393330483,0.0492700729927007
2013,13051,1071,3888,2414,5589,372,1128,2786,6717,0.0382730681131839,0.414768497841298
2013,13053,18,238,727,1441,204,508,931,1949,0.349533715925395,0.477680861980503
2013,13055,11,305,61,203,0,11,61,214,0.0120651744939956,0.285046728971963
2013,13057,2157,5744,1062,2685,196,327,1258,3012,0.0212206824154378,0.417662682602922
2013,13059,810,2740,1107,1588,288,446,1395,2034,0.0325372322556908,0.685840707964602
2013,13061,0,63,0,101,0,3,0,104,0.0505099562894609,0
2013,13063,1308,10219,672,4460,134,637,806,5097,0.0320179406000302,0.158132234647832
2013,13065,3,130,0,42,0,0,0,42,0.00964851826326671,0
2013,13067,7928,20106,6934,14840,1445,2599,8379,17439,0.038083154444345,0.48047479786685
2013,13069,94,744,68,239,0,119,68,358,0.0131830902931212,0.189944134078212
2013,13071,214,895,57,645,0,125,57,770,0.0266546662974245,0.074025974025974
2013,13073,821,2874,1333,2982,124,371,1457,3353,0.0405083783359308,0.434536236206382
2013,13075,22,329,31,141,0,94,31,235,0.021078123598529,0.131914893617021
2013,13077,913,3543,526,1727,167,248,693,1975,0.0233982560894702,0.350886075949367
2013,13079,49,323,0,24,0,5,0,29,0.00332149811018211,0
2013,13081,19,489,37,193,0,22,37,215,0.0139574136587899,0.172093023255814
2013,13083,0,157,95,387,0,0,95,387,0.0350575233263883,0.245478036175711
2013,13085,206,611,49,131,10,10,59,141,0.0090868080170136,0.418439716312057
2013,13087,66,602,4,445,6,20,10,465,0.0256735865724382,0.021505376344086
2013,13089,9732,22769,5767,11971,1467,3964,7234,15935,0.0342799489726772,0.453969250078444
2013,13091,1,299,2,46,0,0,2,46,0.00317219502103303,0.0434782608695652
2013,13093,3,265,0,9,0,0,0,9,0.000887573964497041,0
2013,13095,377,2137,236,988,21,106,257,1094,0.0188160022015067,0.23491773308958
2013,13097,1027,4828,468,2372,59,287,527,2659,0.0314425248619438,0.198194810078977
2013,13099,8,147,8,38,0,0,8,38,0.00540079590676521,0.210526315789474
2013,13101,6,178,0,13,0,78,0,91,0.0376344086021505,0
2013,13103,131,887,153,874,0,60,153,934,0.0277852149338093,0.163811563169165
2013,13105,29,190,31,173,0,0,31,173,0.0126637874240539,0.179190751445087
2013,13107,68,633,0,179,0,0,0,179,0.0121454742841634,0
2013,13109,50,550,4,118,0,0,4,118,0.0167044167610419,0.0338983050847458
2013,13111,56,359,29,441,12,32,41,473,0.0266674183909342,0.0866807610993657
2013,13113,880,2776,725,1575,177,434,902,2009,0.0281179582639365,0.448979591836735
2013,13115,269,1789,330,901,69,155,399,1056,0.0167629690774017,0.377840909090909
2013,13117,2086,4972,1122,2626,186,556,1308,3182,0.0273240936335377,0.411062225015713
2013,13119,28,447,31,87,12,24,43,111,0.00735927865809189,0.387387387387387
2013,13121,11766,27196,10497,19636,2818,4288,13315,23924,0.038437809282657,0.55655408794516
2013,13123,121,948,87,385,0,49,87,434,0.021504310771975,0.200460829493088
2013,13125,8,38,0,28,0,5,0,33,0.0158045977011494,0
2013,13127,297,1587,459,1287,123,313,582,1600,0.029433948380213,0.36375
2013,13129,160,989,81,581,0,72,81,653,0.0182836343273135,0.124042879019908
2013,13131,2,561,95,564,0,16,95,580,0.0350559081293442,0.163793103448276
2013,13133,82,361,27,86,0,38,27,124,0.0105316799728215,0.217741935483871
2013,13135,5136,16895,5027,12471,1541,3578,6568,16049,0.0310646649839731,0.409246682036264
2013,13137,107,1112,21,296,16,24,37,320,0.0110135949062124,0.115625
2013,13139,955,3908,566,1901,58,296,624,2197,0.0190252688823845,0.284023668639053
2013,13141,15,377,0,75,0,0,0,75,0.0114381576940674,0
2013,13143,58,888,21,289,0,18,21,307,0.0161681061723194,0.0684039087947883
2013,13145,220,1264,31,177,15,34,46,211,0.00945721841244229,0.218009478672986
2013,13147,57,815,39,270,0,25,39,295,0.0167832963531888,0.132203389830508
2013,13149,31,398,7,109,4,4,11,113,0.0145039147734566,0.0973451327433628
2013,13151,1253,5375,796,2238,109,241,905,2479,0.0191652042149533,0.36506655909641
2013,13153,589,3185,668,1904,253,521,921,2425,0.0265491569958397,0.37979381443299
2013,13155,43,272,11,126,0,0,11,126,0.0191722458916616,0.0873015873015873
2013,13157,292,1502,98,476,32,118,130,594,0.0149055230734486,0.218855218855219
2013,13159,75,443,22,128,6,17,28,145,0.0156182679879362,0.193103448275862
2013,13161,59,213,0,90,0,11,0,101,0.0105483028720627,0
2013,13163,38,494,70,229,6,6,76,235,0.0215754682335659,0.323404255319149
2013,13165,20,187,0,48,0,0,0,48,0.00827586206896552,0
2013,13167,21,714,10,35,0,0,10,35,0.00502873563218391,0.285714285714286
2013,13169,169,984,0,95,22,22,22,117,0.00618164526866381,0.188034188034188
2013,13171,60,479,0,172,0,46,0,218,0.01878176962178,0
2013,13173,32,621,10,155,0,19,10,174,0.0263357045557742,0.0574712643678161
2013,13175,90,544,84,330,11,36,95,366,0.0115050924179555,0.259562841530055
2013,13177,202,1210,31,313,18,44,49,357,0.019369540448158,0.137254901960784
2013,13179,273,1179,511,3055,191,1113,702,4168,0.115851794201851,0.168426103646833
2013,13181,5,69,20,77,0,0,20,77,0.0137943389466141,0.25974025974026
2013,13183,120,722,22,473,28,50,50,523,0.058816914080072,0.0956022944550669
2013,13185,245,2140,702,1726,119,513,821,2239,0.0352592872553188,0.366681554265297
2013,13187,267,1072,118,473,0,63,118,536,0.0281158203944608,0.220149253731343
2013,13189,45,326,19,104,0,3,19,107,0.00751721230855698,0.177570093457944
2013,13191,108,378,4,73,0,0,4,73,0.00747032337290217,0.0547945205479452
2013,13193,14,542,0,32,0,122,0,154,0.015819209039548,0
2013,13195,92,477,54,205,7,7,61,212,0.0110971524288107,0.287735849056604
2013,13197,36,475,36,57,4,53,40,110,0.0183762111593719,0.363636363636364
2013,13199,167,856,16,35,0,6,16,41,0.00276112869553505,0.390243902439024
2013,13201,0,164,6,24,0,4,6,28,0.00678623364032962,0.214285714285714
2013,13205,11,847,17,156,0,0,17,156,0.0100463678516229,0.108974358974359
2013,13207,164,1058,0,318,0,8,0,326,0.0177424621748122,0
2013,13209,5,228,12,52,0,0,12,52,0.00880311494836634,0.230769230769231
2013,13211,91,293,44,171,0,0,44,171,0.0139660241751062,0.257309941520468
2013,13213,13,731,0,130,0,24,0,154,0.00602032838154808,0
2013,13215,668,4107,2264,6998,503,1131,2767,8129,0.0663153343503479,0.340386271374093
2013,13217,331,3685,216,960,62,124,278,1084,0.0172496101333503,0.256457564575646
2013,13219,245,832,166,301,12,46,178,347,0.0160759786889043,0.512968299711816
2013,13221,157,566,28,122,0,17,28,139,0.0138239681750373,0.201438848920863
2013,13223,870,4157,739,1543,18,108,757,1651,0.0184428060768543,0.458509993943065
2013,13225,184,665,10,215,0,6,10,221,0.0134542798003166,0.0452488687782805
2013,13227,112,659,57,189,12,39,69,228,0.0108597285067873,0.302631578947368
2013,13229,104,495,47,145,9,9,56,154,0.0125335720680394,0.363636363636364
2013,13231,67,750,56,135,4,4,60,139,0.0118844049247606,0.431654676258993
2013,13233,113,980,27,120,0,51,27,171,0.0064208471012316,0.157894736842105
2013,13235,10,334,0,37,0,11,0,48,0.00552231937413714,0
2013,13237,169,577,38,142,0,56,38,198,0.01301261829653,0.191919191919192
2013,13239,0,19,0,35,0,0,0,35,0.0221799746514575,0
2013,13241,53,262,92,191,2,2,94,193,0.0161398227128282,0.487046632124352
2013,13243,35,173,0,55,0,0,0,55,0.0103734439834025,0
2013,13245,519,3576,1527,4996,199,801,1726,5797,0.0453947471456986,0.297740210453683
2013,13247,654,3428,305,1623,70,220,375,1843,0.0334658894881153,0.203472599023332
2013,13249,0,146,5,36,0,0,5,36,0.0108859993952223,0.138888888888889
2013,13251,55,324,0,35,0,1,0,36,0.00375508501095233,0
2013,13253,12,83,0,44,0,39,0,83,0.0137827964131518,0
2013,13255,263,2127,166,759,0,29,166,788,0.018623118190627,0.210659898477157
2013,13257,28,308,0,138,20,20,20,158,0.00916154470601879,0.126582278481013
2013,13259,12,359,17,303,8,46,25,349,0.0808244557665586,0.0716332378223496
2013,13261,100,796,10,153,15,27,25,180,0.00909918107370337,0.138888888888889
2013,13263,0,108,0,62,0,6,0,68,0.0143641740599916,0
2013,13265,11,57,1,3,0,6,1,9,0.00733496332518337,0.111111111111111
2013,13267,79,1974,5,238,0,16,5,254,0.0147528605448104,0.0196850393700787
2013,13269,39,272,7,129,0,0,7,129,0.0224036123654047,0.0542635658914729
2013,13271,15,206,0,13,0,16,0,29,0.00243166191514338,0
2013,13273,11,272,0,28,0,0,0,28,0.00463269358041032,0
2013,13275,83,809,117,461,0,12,117,473,0.0157582622601279,0.247357293868922
2013,13277,92,700,221,380,72,115,293,495,0.019649094950778,0.591919191919192
2013,13279,14,222,26,121,6,46,32,167,0.00974329054842474,0.191616766467066
2013,13281,24,140,101,261,0,11,101,272,0.0348449910325391,0.371323529411765
2013,13283,6,202,0,13,0,7,0,20,0.00444148345547413,0
2013,13285,132,1403,159,1008,128,250,287,1258,0.0292041972327978,0.228139904610493
2013,13287,10,174,0,30,0,0,0,30,0.00529007229765473,0
2013,13289,45,232,0,32,1,2,1,34,0.00549361770883826,0.0294117647058824
2013,13291,52,316,102,524,32,32,134,556,0.0340644528856758,0.241007194244604
2013,13293,54,499,10,145,0,0,10,145,0.00792956360056874,0.0689655172413793
2013,13295,118,1314,352,1310,0,38,352,1348,0.0285158233203588,0.261127596439169
2013,13297,615,2237,122,939,0,13,122,952,0.0172877170044309,0.128151260504202
2013,13299,131,1369,67,490,18,73,85,563,0.0234202753858314,0.150976909413854
2013,13301,15,102,22,55,0,0,22,55,0.014052120592744,0.4
2013,13303,35,689,4,48,0,31,4,79,0.00559886605244507,0.0506329113924051
2013,13305,132,676,133,763,0,26,133,789,0.0388020064915904,0.168567807351077
2013,13307,7,30,0,95,0,11,0,106,0.0568364611260054,0
2013,13309,7,139,0,26,0,0,0,26,0.00443458980044346,0
2013,13311,68,442,11,156,0,0,11,156,0.00822828208238831,0.0705128205128205
2013,13313,156,1661,229,1100,63,170,292,1270,0.0199200062740177,0.22992125984252
2013,13315,31,784,12,101,0,14,12,115,0.017549214100412,0.104347826086957
2013,13317,36,324,33,116,0,0,33,116,0.016017674675504,0.28448275862069
2013,13319,12,179,1,21,0,4,1,25,0.00391849529780564,0.04
2013,13321,45,462,7,299,0,0,7,299,0.0206820225496299,0.0234113712374582
2013,15001,74,935,1207,3380,246,660,1453,4040,0.0312652359983593,0.359653465346535
2013,15003,394,2200,8549,21891,3292,8489,11841,30380,0.0465679511940893,0.389763001974984
2013,15005,0,4,2,2,0,0,2,2,0.0307692307692308,1
2013,15007,134,435,607,1155,30,394,637,1549,0.0325256173357971,0.411233053582957
2013,15009,231,1043,1190,3371,326,856,1516,4227,0.0388043807547897,0.358646794416844
2013,16001,1278,6002,4165,9422,409,1023,4574,10445,0.0400191570881226,0.437912876974629
2013,16003,25,133,21,67,7,7,28,74,0.0248322147651007,0.378378378378378
2013,16005,233,1707,473,1355,23,100,496,1455,0.0287583507925841,0.340893470790378
2013,16007,35,79,5,126,0,0,5,126,0.031858407079646,0.0396825396825397
2013,16009,23,103,13,139,0,0,13,139,0.0216477184239215,0.0935251798561151
2013,16011,132,747,104,692,0,28,104,720,0.0268396331916797,0.144444444444444
2013,16013,57,256,264,319,95,97,359,416,0.0279007377598927,0.862980769230769
2013,16015,39,338,18,143,0,3,18,146,0.028272656855151,0.123287671232877
2013,16017,131,461,268,818,11,52,279,870,0.029375021102745,0.320689655172414
2013,16019,299,1810,419,1343,106,197,525,1540,0.0242500590504685,0.340909090909091
2013,16021,10,73,60,128,7,11,67,139,0.0185160516850939,0.482014388489209
2013,16023,12,53,6,40,0,0,6,40,0.0216567406605306,0.15
2013,16025,0,22,0,8,0,0,0,8,0.00911161731207289,0
2013,16027,613,4676,655,3156,47,327,702,3483,0.0304679094097991,0.201550387596899
2013,16029,5,36,31,64,0,31,31,95,0.0213100044863167,0.326315789473684
2013,16031,163,695,77,405,0,45,77,450,0.0332840236686391,0.171111111111111
2013,16033,0,0,0,7,0,0,0,7,0.0145530145530146,0
2013,16035,38,351,25,158,0,0,25,158,0.0237701218594855,0.158227848101266
2013,16037,11,75,3,17,0,0,3,17,0.00523237919359803,0.176470588235294
2013,16039,62,316,108,657,84,509,192,1166,0.0736483072258717,0.164665523156089
2013,16041,11,69,62,253,3,68,65,321,0.0435608630750441,0.202492211838006
2013,16043,33,193,104,182,0,0,104,182,0.0222412318220701,0.571428571428571
2013,16045,52,617,118,303,0,0,118,303,0.0260869565217391,0.389438943894389
2013,16047,24,236,17,99,5,16,22,115,0.0120456687964806,0.191304347826087
2013,16049,116,435,28,320,0,0,28,320,0.0269541778975741,0.0875
2013,16051,152,624,66,162,24,88,90,250,0.0166356135214267,0.36
2013,16053,27,412,16,98,0,117,16,215,0.0161411411411411,0.0744186046511628
2013,16055,140,1116,1146,4090,13,63,1159,4153,0.0440038992137998,0.279075367204431
2013,16057,201,454,336,1314,78,104,414,1418,0.0674595623215985,0.291960507757405
2013,16059,18,60,21,128,0,7,21,135,0.0227655986509275,0.155555555555556
2013,16061,25,140,12,61,0,0,12,61,0.0218951902368988,0.19672131147541
2013,16063,65,217,7,56,0,0,7,56,0.0180820148530836,0.125
2013,16065,77,630,257,692,34,116,291,808,0.0541119742834182,0.360148514851485
2013,16067,8,361,12,208,0,100,12,308,0.024530105129022,0.038961038961039
2013,16069,114,608,156,777,12,12,168,789,0.0291240633420693,0.212927756653992
2013,16071,13,47,15,97,0,0,15,97,0.035427319211103,0.154639175257732
2013,16073,60,469,11,155,0,0,11,155,0.0213645761543763,0.0709677419354839
2013,16075,33,292,149,835,0,47,149,882,0.0611565663569547,0.168934240362812
2013,16077,6,111,0,78,0,11,0,89,0.0189765458422175,0
2013,16079,26,238,40,216,0,0,40,216,0.0232934325461016,0.185185185185185
2013,16081,74,235,257,428,0,0,257,428,0.0655536835656303,0.600467289719626
2013,16083,257,1548,246,1101,11,178,257,1279,0.0259437311101645,0.200938232994527
2013,16085,30,236,97,211,0,0,97,211,0.0294322778630213,0.459715639810427
2013,16087,25,154,38,127,0,0,38,127,0.0177896063874492,0.299212598425197
2013,17001,78,359,189,587,20,43,209,630,0.0137278828553996,0.331746031746032
2013,17003,9,98,38,232,0,0,38,232,0.0432190760059613,0.163793103448276
2013,17005,48,289,150,240,0,0,150,240,0.0208026350004334,0.625
2013,17007,126,1100,218,332,19,57,237,389,0.0113480556609003,0.609254498714653
2013,17009,17,726,53,77,20,20,73,97,0.0192804611409263,0.752577319587629
2013,17011,145,532,52,259,0,13,52,272,0.0112206592137288,0.191176470588235
2013,17013,37,102,15,25,0,11,15,36,0.00997229916897507,0.416666666666667
2013,17015,26,276,9,79,6,16,15,95,0.00856473133790119,0.157894736842105
2013,17017,83,401,31,234,49,101,80,335,0.0367324561403509,0.238805970149254
2013,17019,776,2016,1839,3207,1307,1690,3146,4897,0.0424751281539756,0.642434143353073
2013,17021,99,935,68,261,30,36,98,297,0.012263099219621,0.32996632996633
2013,17023,48,211,24,219,6,25,30,244,0.0216043917124137,0.122950819672131
2013,17025,44,226,12,35,0,0,12,35,0.00368537432873539,0.342857142857143
2013,17027,85,984,83,272,0,5,83,277,0.0105347227504374,0.299638989169675
2013,17029,177,785,113,504,0,0,113,504,0.0159645232815965,0.224206349206349
2013,17031,13055,27845,30219,50352,13642,23155,43861,73507,0.0210949927552057,0.596691471560532
2013,17033,44,404,7,152,0,0,7,152,0.0109747292418773,0.0460526315789474
2013,17035,51,321,4,129,0,0,4,129,0.0171291993095206,0.0310077519379845
2013,17037,666,1917,458,832,58,227,516,1059,0.0176977840168455,0.487252124645892
2013,17039,63,372,9,99,0,6,9,105,0.00904236996210816,0.0857142857142857
2013,17041,11,342,61,150,0,18,61,168,0.0127157129881926,0.363095238095238
2013,17043,9921,20999,5098,8155,2049,3907,7147,12062,0.0194939838869989,0.592521969822583
2013,17045,56,319,67,281,7,20,74,301,0.0231147289202887,0.245847176079734
2013,17047,16,103,7,20,0,2,7,22,0.00470185937166061,0.318181818181818
2013,17049,121,458,59,212,31,53,90,265,0.0115473441108545,0.339622641509434
2013,17051,54,650,35,150,0,0,35,150,0.0101044122600202,0.233333333333333
2013,17053,76,497,1,37,15,15,16,52,0.00534209985617423,0.307692307692308
2013,17055,76,506,6,300,21,82,27,382,0.0139451684736977,0.0706806282722513
2013,17057,77,1046,10,173,15,53,25,226,0.00859315589353612,0.110619469026549
2013,17059,35,79,26,91,0,0,26,91,0.0229334677419355,0.285714285714286
2013,17061,23,156,8,80,0,0,8,80,0.00832639467110741,0.1
2013,17063,104,1043,69,218,42,42,111,260,0.00796959293771457,0.426923076923077
2013,17065,21,166,6,14,0,6,6,20,0.00339040515341583,0.3
2013,17067,34,160,139,420,0,21,139,441,0.032567757181892,0.315192743764172
2013,17069,19,91,10,40,0,0,10,40,0.0128369704749679,0.25
2013,17071,54,142,56,162,0,2,56,164,0.031019481747683,0.341463414634146
2013,17073,184,904,71,361,9,12,80,373,0.0107950105634822,0.214477211796247
2013,17075,84,399,42,138,13,29,55,167,0.00815628815628816,0.329341317365269
2013,17077,327,1113,285,763,110,217,395,980,0.0284751278475128,0.403061224489796
2013,17079,32,154,16,85,0,11,16,96,0.0140969162995595,0.166666666666667
2013,17081,173,982,60,375,18,82,78,457,0.0169837966404043,0.170678336980306
2013,17083,56,400,165,233,3,22,168,255,0.016402933230413,0.658823529411765
2013,17085,95,255,85,346,0,25,85,371,0.0224508320726172,0.22911051212938
2013,17087,5,921,12,73,0,0,12,73,0.00793047256925584,0.164383561643836
2013,17089,3794,11182,1193,3626,305,1430,1498,5056,0.015467023974499,0.29628164556962
2013,17091,359,1834,72,527,72,175,144,702,0.00961117196056955,0.205128205128205
2013,17093,1359,3735,198,1038,66,123,264,1161,0.0160814460835238,0.227390180878553
2013,17095,207,1312,72,308,26,113,98,421,0.0115168923539871,0.232779097387173
2013,17097,4248,8860,3990,9384,1349,2400,5339,11784,0.0262620679818501,0.453071961982349
2013,17099,530,2060,137,556,0,59,137,615,0.00788815494131982,0.222764227642276
2013,17101,14,1098,32,181,0,65,32,246,0.0200914733747141,0.130081300813008
2013,17103,156,1177,75,282,5,84,80,366,0.014673455478491,0.218579234972678
2013,17105,159,1606,9,204,0,35,9,239,0.00878773394124352,0.0376569037656904
2013,17107,70,2378,18,142,1,37,19,179,0.00849226681848373,0.106145251396648
2013,17109,271,714,156,289,44,72,200,361,0.0200310731328376,0.554016620498615
2013,17111,1466,4484,1011,2705,111,402,1122,3107,0.0154186661637942,0.361120051496621
2013,17113,857,2106,1253,2167,619,691,1872,2858,0.0279147905413985,0.655003498950315
2013,17115,481,1846,451,1013,45,134,496,1147,0.0152996571916392,0.432432432432432
2013,17117,72,840,125,340,14,87,139,427,0.0129437085088969,0.325526932084309
2013,17119,844,3382,1039,2784,133,259,1172,3043,0.0167844279339654,0.385146237265856
2013,17121,88,523,91,360,0,20,91,380,0.0141854561744065,0.239473684210526
2013,17123,63,243,49,78,1,17,50,95,0.0106299653127448,0.526315789473684
2013,17125,20,318,33,137,0,33,33,170,0.016398186553487,0.194117647058824
2013,17127,6,80,30,290,6,24,36,314,0.0293677515899738,0.114649681528662
2013,17129,60,353,6,107,0,0,6,107,0.0120862984299108,0.0560747663551402
2013,17131,25,231,21,101,0,2,21,103,0.00894097222222222,0.203883495145631
2013,17133,190,733,176,431,12,16,188,447,0.0195949500263019,0.420581655480984
2013,17135,59,2002,59,295,1,1,60,296,0.0139648990375543,0.202702702702703
2013,17137,329,1170,20,385,56,75,76,460,0.0189612530915087,0.165217391304348
2013,17139,65,282,0,32,0,11,0,43,0.00425784731161501,0
2013,17141,142,759,63,318,2,8,65,326,0.00907622918870761,0.199386503067485
2013,17143,837,3035,1156,2461,373,543,1529,3004,0.0243811378946514,0.508988015978695
2013,17145,140,1016,0,22,0,31,0,53,0.00346111147391106,0
2013,17147,104,325,39,72,0,2,39,74,0.00639088004145436,0.527027027027027
2013,17149,12,371,26,182,0,51,26,233,0.0206487061325771,0.111587982832618
2013,17151,12,54,16,96,0,0,16,96,0.0298136645962733,0.166666666666667
2013,17153,10,68,0,54,0,0,0,54,0.0130434782608696,0
2013,17155,4,116,3,16,10,22,13,38,0.00894328077194634,0.342105263157895
2013,17157,36,918,20,288,19,48,39,336,0.0140850974638441,0.116071428571429
2013,17159,173,360,68,152,0,0,68,152,0.0134453781512605,0.447368421052632
2013,17161,273,1416,356,1855,144,594,500,2449,0.0242855159556534,0.204164965291956
2013,17163,611,2479,1462,4149,316,804,1778,4953,0.0279977615357222,0.358974358974359
2013,17165,24,484,13,96,9,30,22,126,0.00732941655517422,0.174603174603175
2013,17167,1116,3142,960,2126,160,745,1120,2871,0.021267926988266,0.390107976314873
2013,17169,38,143,0,26,0,0,0,26,0.00478821362799263,0
2013,17171,0,125,2,9,0,3,2,12,0.00325291406885335,0.166666666666667
2013,17173,41,518,28,85,0,2,28,87,0.00553470322539602,0.32183908045977
2013,17175,6,95,36,47,0,0,36,47,0.0112064854554125,0.765957446808511
2013,17177,192,798,150,382,0,23,150,405,0.0122623228775584,0.37037037037037
2013,17179,653,2415,279,1183,29,110,308,1293,0.0137674755369103,0.238205723124517
2013,17181,70,328,23,155,0,21,23,176,0.0141127415604202,0.130681818181818
2013,17183,72,929,70,727,26,131,96,858,0.015742541558108,0.111888111888112
2013,17185,0,118,34,93,0,6,34,99,0.0120335480734168,0.343434343434343
2013,17187,27,261,46,156,0,12,46,168,0.0145668949969652,0.273809523809524
2013,17189,33,331,15,72,9,11,24,83,0.00803407220985384,0.289156626506024
2013,17191,12,204,10,115,0,12,10,127,0.0109144035751117,0.078740157480315
2013,17193,15,225,57,196,0,0,57,196,0.018748804285441,0.290816326530612
2013,17195,106,720,8,225,22,55,30,280,0.00699021370081885,0.107142857142857
2013,17197,4492,12021,1855,3682,527,1515,2382,5197,0.0120902921723675,0.458341350779296
2013,17199,470,1732,293,825,5,40,298,865,0.0186595336195181,0.344508670520231
2013,17201,942,3076,687,2436,194,429,881,2865,0.0146130972115252,0.307504363001745
2013,17203,274,1127,111,198,15,45,126,243,0.00946704067321178,0.518518518518518
2013,18001,79,466,16,93,0,50,16,143,0.00685719765992136,0.111888111888112
2013,18003,708,2852,922,3385,214,618,1136,4003,0.0174952470444265,0.283787159630277
2013,18005,172,1387,434,1082,274,420,708,1502,0.0287695372356727,0.471371504660453
2013,18007,52,421,15,71,0,17,15,88,0.0148048452220727,0.170454545454545
2013,18009,26,257,8,88,0,0,8,88,0.00997167138810198,0.0909090909090909
2013,18011,446,1372,262,539,17,43,279,582,0.0153085380609185,0.479381443298969
2013,18013,139,522,3,128,7,7,10,135,0.0121348314606742,0.0740740740740741
2013,18015,95,548,55,129,6,26,61,155,0.0112465534755478,0.393548387096774
2013,18017,156,721,19,147,22,121,41,268,0.0103434967194134,0.152985074626866
2013,18019,316,1905,298,1709,30,41,328,1750,0.0230405645596619,0.187428571428571
2013,18021,68,465,37,221,0,8,37,229,0.0125218722659668,0.161572052401747
2013,18023,128,771,5,147,0,38,5,185,0.00857990909934143,0.027027027027027
2013,18025,21,195,6,66,0,5,6,71,0.00968093809653668,0.0845070422535211
2013,18027,106,376,69,234,0,4,69,238,0.0119856977388327,0.289915966386555
2013,18029,34,465,190,1233,27,44,217,1277,0.0377341764671119,0.169929522317933
2013,18031,38,431,116,350,0,8,116,358,0.0205652573529412,0.324022346368715
2013,18033,161,831,21,298,0,17,21,315,0.0112927511292751,0.0666666666666667
2013,18035,573,2499,316,1120,36,119,352,1239,0.017413914265636,0.28410008071025
2013,18037,114,529,162,333,0,46,162,379,0.0132823999439265,0.427440633245383
2013,18039,404,2545,465,1984,61,176,526,2160,0.0173136577506673,0.243518518518519
2013,18041,24,361,37,118,9,42,46,160,0.00960038401536061,0.2875
2013,18043,233,1335,305,1241,17,130,322,1371,0.0270750636886071,0.234865061998541
2013,18045,50,379,0,82,0,13,0,95,0.00807273963290279,0
2013,18047,167,474,68,217,0,36,68,253,0.0162994459476872,0.268774703557312
2013,18049,83,527,19,164,0,7,19,171,0.0121259395830379,0.111111111111111
2013,18051,86,561,163,389,0,13,163,402,0.017693661971831,0.40547263681592
2013,18053,219,871,82,569,32,105,114,674,0.0148756317729369,0.169139465875371
2013,18055,72,869,50,282,36,36,86,318,0.0139823242316317,0.270440251572327
2013,18057,4120,7870,2509,4084,475,986,2984,5070,0.0279472805146268,0.588560157790927
2013,18059,379,1750,240,644,34,56,274,700,0.0148214021046391,0.391428571428571
2013,18061,92,464,82,374,0,17,82,391,0.0144954400533847,0.209718670076726
2013,18063,889,4363,672,1460,296,394,968,1854,0.0190425324308501,0.522114347357066
2013,18065,141,1964,33,388,0,22,33,410,0.0117596443424638,0.0804878048780488
2013,18067,162,1198,139,657,23,137,162,794,0.013983797111659,0.204030226700252
2013,18069,84,638,42,243,10,43,52,286,0.0115658362989324,0.181818181818182
2013,18071,114,490,103,327,121,195,224,522,0.0180080725842619,0.42911877394636
2013,18073,142,543,17,315,0,25,17,340,0.0155784650630011,0.05
2013,18075,36,286,27,137,0,0,27,137,0.00983065442020666,0.197080291970803
2013,18077,119,965,91,348,0,15,91,363,0.0165776133716948,0.25068870523416
2013,18079,70,807,0,274,11,73,11,347,0.0186729806812678,0.031700288184438
2013,18081,723,4312,318,1614,179,376,497,1990,0.0214534438706756,0.249748743718593
2013,18083,104,482,70,474,29,65,99,539,0.0215712170328571,0.183673469387755
2013,18085,277,1315,248,677,108,148,356,825,0.0162471936665485,0.431515151515152
2013,18087,112,661,30,239,0,46,30,285,0.0134758144593125,0.105263157894737
2013,18089,547,2548,1367,7757,274,747,1641,8504,0.0261339086235138,0.19296801505174
2013,18091,410,3542,407,1164,19,87,426,1251,0.0163071107345369,0.34052757793765
2013,18093,228,916,36,121,0,23,36,144,0.0045111368691457,0.25
2013,18095,504,2698,136,991,72,157,208,1148,0.0128545354787419,0.181184668989547
2013,18097,4625,13618,3920,10275,1175,2666,5095,12941,0.0218885259876561,0.393709914226103
2013,18099,140,808,89,205,25,70,114,275,0.0089372765680858,0.414545454545455
2013,18101,58,274,13,168,25,35,38,203,0.0285112359550562,0.187192118226601
2013,18103,99,1669,21,277,0,5,21,282,0.0112346121668459,0.074468085106383
2013,18105,683,2614,1674,2419,706,929,2380,3348,0.0436830499849954,0.710872162485066
2013,18107,104,604,152,266,0,5,152,271,0.0106692913385827,0.560885608856089
2013,18109,358,2468,103,401,9,20,112,421,0.00901074440306494,0.26603325415677
2013,18111,27,309,30,153,0,0,30,153,0.0156457715512834,0.196078431372549
2013,18113,118,1199,78,227,4,34,82,261,0.00845426276237367,0.314176245210728
2013,18115,15,85,11,140,0,4,11,144,0.0326382592928377,0.0763888888888889
2013,18117,17,299,9,56,0,0,9,56,0.00419979001049947,0.160714285714286
2013,18119,39,615,10,104,0,0,10,104,0.00699488835082055,0.0961538461538462
2013,18121,136,894,0,160,0,3,0,163,0.0134655101197852,0
2013,18123,92,639,55,243,0,0,55,243,0.0177787532923617,0.226337448559671
2013,18125,8,177,17,36,0,0,17,36,0.004,0.472222222222222
2013,18127,622,2902,755,1985,90,242,845,2227,0.02016077927251,0.379434216434665
2013,18129,85,478,23,184,6,42,29,226,0.0128613703619394,0.128318584070796
2013,18131,22,244,32,43,0,10,32,53,0.00585894317930577,0.60377358490566
2013,18133,150,1873,0,202,13,29,13,231,0.00937956797141465,0.0562770562770563
2013,18135,8,427,28,236,0,53,28,289,0.0162752717238272,0.0968858131487889
2013,18137,75,446,65,247,0,0,65,247,0.012931260143448,0.263157894736842
2013,18139,39,286,60,137,0,7,60,144,0.0122908842608399,0.416666666666667
2013,18141,546,2576,1591,3613,325,799,1916,4412,0.0257466649548908,0.43427017225748
2013,18143,38,424,16,143,0,21,16,164,0.0100867212005658,0.0975609756097561
2013,18145,257,1371,45,389,29,113,74,502,0.0165966872747711,0.147410358565737
2013,18147,83,432,49,111,0,13,49,124,0.00850538445709582,0.395161290322581
2013,18149,81,579,0,191,0,16,0,207,0.0130657072524143,0
2013,18151,182,478,74,583,0,37,74,620,0.0270931655305017,0.119354838709677
2013,18153,21,787,12,53,0,0,12,53,0.00353923205342237,0.226415094339623
2013,18155,75,233,2,64,0,18,2,82,0.01169757489301,0.024390243902439
2013,18157,639,2714,1356,2301,744,1171,2100,3472,0.0360746012779885,0.604838709677419
2013,18159,23,304,50,69,0,0,50,69,0.00620224719101124,0.72463768115942
2013,18161,15,107,9,96,0,4,9,100,0.0199640646835696,0.09
2013,18163,587,2334,757,2347,16,122,773,2469,0.0205914731785428,0.313082219522074
2013,18165,26,246,11,74,8,18,19,92,0.00822750849579682,0.206521739130435
2013,18167,299,1304,355,1248,77,153,432,1401,0.0201605940252115,0.308351177730193
2013,18169,37,625,46,141,24,32,70,173,0.00785542387503973,0.404624277456647
2013,18171,29,220,0,39,0,0,0,39,0.00658116773540331,0
2013,18173,452,1657,146,504,31,113,177,617,0.0151794720397569,0.286871961102107
2013,18175,98,593,64,234,0,9,64,243,0.012847626097071,0.263374485596708
2013,18177,205,941,318,1140,10,43,328,1183,0.0254031651957311,0.277261200338123
2013,18179,88,513,36,156,0,0,36,156,0.00832488393190672,0.230769230769231
2013,18181,174,656,15,131,0,6,15,137,0.00811274945224137,0.109489051094891
2013,18183,164,823,0,133,0,39,0,172,0.00759516029320851,0
2013,19001,33,243,23,55,0,1,23,56,0.0102979036410445,0.410714285714286
2013,19003,5,68,15,25,8,19,23,44,0.0152990264255911,0.522727272727273
2013,19005,22,249,20,244,25,65,45,309,0.0308629644426688,0.145631067961165
2013,19007,23,170,22,264,0,0,22,264,0.0292035398230088,0.0833333333333333
2013,19009,23,111,2,16,0,7,2,23,0.00528007346189164,0.0869565217391304
2013,19011,107,504,28,67,0,6,28,73,0.00414372481126185,0.383561643835616
2013,19013,549,1677,346,1107,145,288,491,1395,0.0169363944298081,0.351971326164875
2013,19015,289,909,58,188,0,33,58,221,0.0121937762083425,0.262443438914027
2013,19017,164,528,33,100,5,16,38,116,0.00727592046666249,0.327586206896552
2013,19019,87,293,24,90,0,30,24,120,0.00866425992779783,0.2
2013,19021,33,261,72,299,6,148,78,447,0.0347535375524802,0.174496644295302
2013,19023,54,269,26,69,0,2,26,71,0.00679165869523627,0.366197183098592
2013,19025,103,579,10,61,2,2,12,63,0.00874757011941127,0.19047619047619
2013,19027,107,475,82,205,0,10,82,215,0.0151248680970805,0.381395348837209
2013,19029,47,225,7,50,7,15,14,65,0.00669688852256336,0.215384615384615
2013,19031,70,359,3,71,0,0,3,71,0.00551713419846142,0.0422535211267606
2013,19033,330,883,182,381,1,3,183,384,0.0123417111268239,0.4765625
2013,19035,44,278,69,146,13,33,82,179,0.0207825380239173,0.458100558659218
2013,19037,4,132,18,67,2,16,20,83,0.00966464834653004,0.240963855421687
2013,19039,24,123,0,92,0,16,0,108,0.0172717095794019,0
2013,19041,102,197,22,145,0,37,22,182,0.0156223175965665,0.120879120879121
2013,19043,32,276,41,184,3,9,44,193,0.0152256232249921,0.227979274611399
2013,19045,130,488,110,590,9,17,119,607,0.018108051669103,0.196046128500824
2013,19047,69,212,29,134,20,41,49,175,0.0157913733983036,0.28
2013,19049,1396,2752,440,762,43,77,483,839,0.018554147592826,0.575685339690107
2013,19051,25,227,1,82,0,1,1,83,0.0149900668231895,0.0120481927710843
2013,19053,65,201,26,31,0,0,26,31,0.00595009596928983,0.838709677419355
2013,19055,63,490,31,54,0,0,31,54,0.00447279052431044,0.574074074074074
2013,19057,90,575,79,471,16,41,95,512,0.0183690309618627,0.185546875
2013,19059,48,186,79,195,2,2,81,197,0.0156722354813047,0.411167512690355
2013,19061,240,686,422,1610,123,144,545,1754,0.0280851200102477,0.310718358038769
2013,19063,47,158,15,219,9,17,24,236,0.0340794223826715,0.101694915254237
2013,19065,71,320,69,187,0,0,69,187,0.0132803067963923,0.368983957219251
2013,19067,33,287,73,233,3,44,76,277,0.0247719549275622,0.274368231046931
2013,19069,21,160,27,121,0,0,27,121,0.0162372517444981,0.223140495867769
2013,19071,27,84,17,53,3,10,20,63,0.0122496597316741,0.317460317460317
2013,19073,15,253,12,95,4,15,16,110,0.0168996773697957,0.145454545454545
2013,19075,80,275,12,29,0,6,12,35,0.00405421058728136,0.342857142857143
2013,19077,39,169,44,93,1,9,45,102,0.0132209980557356,0.441176470588235
2013,19079,30,293,31,154,2,3,33,157,0.0146087280171211,0.210191082802548
2013,19081,22,234,47,101,9,20,56,121,0.0151743165287183,0.462809917355372
2013,19083,71,258,20,150,2,2,22,152,0.0126329787234043,0.144736842105263
2013,19085,21,146,29,125,0,23,29,148,0.0144700821274932,0.195945945945946
2013,19087,60,366,29,255,0,11,29,266,0.0193835167237485,0.109022556390977
2013,19089,4,107,21,58,0,0,21,58,0.0089011663597299,0.362068965517241
2013,19091,25,131,5,127,0,13,5,140,0.0205158264947245,0.0357142857142857
2013,19093,38,114,19,71,3,3,22,74,0.0148385803088029,0.297297297297297
2013,19095,82,505,44,250,0,0,44,250,0.0219375219375219,0.176
2013,19097,71,314,38,126,0,7,38,133,0.00960358148602787,0.285714285714286
2013,19099,133,1244,46,228,8,25,54,253,0.00979064277698232,0.213438735177866
2013,19101,58,240,174,287,55,95,229,382,0.0318412936567475,0.599476439790576
2013,19103,1072,2776,1693,2699,530,744,2223,3443,0.0438615488490006,0.645657856520476
2013,19105,75,568,140,194,0,1,140,195,0.0132897158045389,0.717948717948718
2013,19107,12,230,7,44,0,4,7,48,0.0065879769420807,0.145833333333333
2013,19109,45,271,11,74,2,11,13,85,0.0077055570664491,0.152941176470588
2013,19111,41,354,175,445,74,74,249,519,0.0206632957757694,0.479768786127168
2013,19113,733,2952,1165,2854,220,417,1385,3271,0.0232490369169972,0.4234179150107
2013,19115,37,166,13,69,0,18,13,87,0.011411332633788,0.149425287356322
2013,19117,0,88,24,178,14,24,38,202,0.0329312031300946,0.188118811881188
2013,19119,34,110,24,91,0,3,24,94,0.0124338624338624,0.25531914893617
2013,19121,67,516,3,62,0,51,3,113,0.0107414448669202,0.0265486725663717
2013,19123,41,359,19,184,0,13,19,197,0.013168449197861,0.0964467005076142
2013,19125,261,654,116,283,3,20,119,303,0.0139973206448931,0.392739273927393
2013,19127,150,576,109,356,14,76,123,432,0.0159592153385792,0.284722222222222
2013,19129,74,239,79,219,0,8,79,227,0.0222113502935421,0.348017621145374
2013,19131,24,94,8,69,3,3,11,72,0.00970742887960092,0.152777777777778
2013,19133,17,195,13,91,0,3,13,94,0.0141758407480018,0.138297872340426
2013,19135,60,170,38,95,0,7,38,102,0.0185151570157923,0.372549019607843
2013,19137,14,123,47,135,0,0,47,135,0.0179640718562874,0.348148148148148
2013,19139,75,562,50,300,20,58,70,358,0.0126180741576202,0.195530726256983
2013,19141,113,423,31,291,22,31,53,322,0.0324204591220298,0.164596273291925
2013,19143,7,89,5,52,0,2,5,54,0.0121348314606742,0.0925925925925926
2013,19145,82,517,62,424,0,5,62,429,0.0378140149845747,0.144522144522145
2013,19147,42,176,13,55,0,1,13,56,0.00872681938600592,0.232142857142857
2013,19149,77,386,37,211,18,35,55,246,0.014537288736556,0.223577235772358
2013,19151,16,139,12,91,0,5,12,96,0.0184864240323512,0.125
2013,19153,2455,7128,2304,5869,499,1499,2803,7368,0.0256780210359032,0.38042888165038
2013,19155,229,990,443,1690,38,136,481,1826,0.0295039586362902,0.26341730558598
2013,19157,41,341,81,178,20,22,101,200,0.016389412439564,0.505
2013,19159,35,111,9,14,0,15,9,29,0.00815064643057898,0.310344827586207
2013,19161,37,213,25,43,0,8,25,51,0.00695106991958566,0.490196078431373
2013,19163,406,1203,1618,3647,169,362,1787,4009,0.0359142501366157,0.445747069094537
2013,19165,77,189,47,100,1,3,48,103,0.012046783625731,0.466019417475728
2013,19167,7,139,67,326,0,85,67,411,0.0202792717225046,0.16301703163017
2013,19169,569,1790,949,1181,541,573,1490,1754,0.0368867111101764,0.849486887115165
2013,19171,70,270,20,108,5,5,25,113,0.00941823637272879,0.221238938053097
2013,19173,6,90,3,90,2,8,5,98,0.021978021978022,0.0510204081632653
2013,19175,42,209,21,126,0,3,21,129,0.0151301900070373,0.162790697674419
2013,19177,19,128,41,117,0,3,41,120,0.0226628895184136,0.341666666666667
2013,19179,50,496,87,301,16,39,103,340,0.0141613561581074,0.302941176470588
2013,19181,377,1406,196,405,54,65,250,470,0.0155546730209161,0.531914893617021
2013,19183,81,388,26,183,0,0,26,183,0.0122530967525946,0.14207650273224
2013,19185,2,101,10,53,0,5,10,58,0.0131728367022485,0.172413793103448
2013,19187,140,1017,105,495,58,107,163,602,0.0238567012760561,0.270764119601329
2013,19189,22,122,44,244,0,0,44,244,0.032546351874083,0.180327868852459
2013,19191,68,316,51,146,14,35,65,181,0.0134813049307314,0.359116022099448
2013,19193,168,843,470,1620,34,158,504,1778,0.0275817135411011,0.283464566929134
2013,19195,18,117,0,32,0,1,0,33,0.0061544199925401,0
2013,19197,11,168,17,108,0,39,17,147,0.0161131206839855,0.115646258503401
2013,20001,81,308,0,31,0,0,0,31,0.00344942695003895,0
2013,20003,53,388,8,105,0,0,8,105,0.0192695907505964,0.0761904761904762
2013,20005,24,107,9,80,0,13,9,93,0.00899854862119013,0.0967741935483871
2013,20007,20,126,8,71,0,0,8,71,0.020431654676259,0.112676056338028
2013,20009,146,529,60,302,16,21,76,323,0.0175925925925926,0.235294117647059
2013,20011,43,249,25,125,0,3,25,128,0.0129541544378099,0.1953125
2013,20013,84,287,8,105,2,13,10,118,0.0174272633289027,0.0847457627118644
2013,20015,590,2413,151,652,31,37,182,689,0.0163444431265568,0.264150943396226
2013,20017,28,167,0,28,0,3,0,31,0.0159137577002053,0
2013,20019,18,74,15,107,0,3,15,110,0.0414781297134238,0.136363636363636
2013,20021,57,142,87,414,0,18,87,432,0.0298280742939999,0.201388888888889
2013,20023,3,40,0,32,11,11,11,43,0.0208940719144801,0.255813953488372
2013,20025,16,39,12,57,0,0,12,57,0.0379494007989348,0.210526315789474
2013,20027,19,136,0,99,61,100,61,199,0.0334960444369635,0.306532663316583
2013,20029,10,159,27,42,0,19,27,61,0.00959421201635735,0.442622950819672
2013,20031,30,290,39,191,3,19,42,210,0.0354131534569983,0.2
2013,20033,9,35,0,11,0,0,0,11,0.00825825825825826,0
2013,20035,117,961,129,681,9,20,138,701,0.0298272487447877,0.196861626248217
2013,20037,84,380,216,491,40,51,256,542,0.0227453942674892,0.472324723247232
2013,20039,2,72,9,41,0,0,9,41,0.0178493687418372,0.219512195121951
2013,20041,28,453,99,403,0,30,99,433,0.0323641527767397,0.228637413394919
2013,20043,26,39,14,170,0,7,14,177,0.0343023255813954,0.0790960451977401
2013,20045,690,1961,999,1602,296,396,1295,1998,0.0316961736150771,0.648148148148148
2013,20047,6,79,1,39,0,3,1,42,0.0196537201684605,0.0238095238095238
2013,20049,34,105,4,13,0,0,4,13,0.00625601539942252,0.307692307692308
2013,20051,177,627,90,315,2,57,92,372,0.0214582371942778,0.247311827956989
2013,20053,64,294,10,50,0,15,10,65,0.0139875188293523,0.153846153846154
2013,20055,105,483,150,479,32,117,182,596,0.0279326990673478,0.305369127516779
2013,20057,127,584,59,644,32,125,91,769,0.0386665325824618,0.118335500650195
2013,20059,93,479,94,420,18,35,112,455,0.0266987442788405,0.246153846153846
2013,20061,227,643,398,1448,116,678,514,2126,0.109311532726618,0.241768579492004
2013,20063,8,58,2,28,0,0,2,28,0.0139095876800795,0.0714285714285714
2013,20065,3,24,8,56,0,0,8,56,0.0289106866288074,0.142857142857143
2013,20067,22,79,36,77,0,2,36,79,0.0165479681608714,0.455696202531646
2013,20069,31,97,26,103,0,0,26,103,0.0274666666666667,0.252427184466019
2013,20071,0,8,0,14,0,0,0,14,0.015748031496063,0
2013,20073,22,119,4,20,0,2,4,22,0.00470387000213812,0.181818181818182
2013,20075,8,45,0,23,0,18,0,41,0.0231116121758737,0
2013,20077,24,96,7,75,0,3,7,78,0.0188451316743175,0.0897435897435897
2013,20079,256,969,66,374,4,49,70,423,0.0185096048658819,0.16548463356974
2013,20081,0,100,10,56,0,6,10,62,0.0240776699029126,0.161290322580645
2013,20083,0,45,3,14,0,0,3,14,0.0101010101010101,0.214285714285714
2013,20085,81,345,63,139,0,0,63,139,0.0155550581915846,0.453237410071942
2013,20087,162,436,47,106,0,5,47,111,0.00844491783323189,0.423423423423423
2013,20089,7,46,0,42,0,3,0,45,0.0194720900043271,0
2013,20091,2755,6256,7821,14536,906,1753,8727,16289,0.0442254905421145,0.535760329056418
2013,20093,45,135,0,95,0,39,0,134,0.0535143769968051,0
2013,20095,21,63,15,126,0,0,15,126,0.0229049263770224,0.119047619047619
2013,20097,11,60,6,35,0,0,6,35,0.0205519671168526,0.171428571428571
2013,20099,41,372,60,229,0,0,60,229,0.0160454035874439,0.262008733624454
2013,20101,3,7,0,16,0,2,0,18,0.0155306298533218,0
2013,20103,448,1804,1323,3457,573,841,1896,4298,0.0833834513531865,0.441135411819451
2013,20105,13,100,5,53,0,10,5,63,0.0271668822768435,0.0793650793650794
2013,20107,25,130,34,86,0,0,34,86,0.0126210742588788,0.395348837209302
2013,20109,10,40,3,84,1,11,4,95,0.0490956072351421,0.0421052631578947
2013,20111,103,656,54,627,22,68,76,695,0.0349492104998491,0.109352517985612
2013,20113,126,470,94,355,28,42,122,397,0.0199167210154016,0.307304785894207
2013,20115,7,298,44,102,9,18,53,120,0.0140564601147944,0.441666666666667
2013,20117,19,118,23,109,7,7,30,116,0.0162578836720392,0.258620689655172
2013,20119,38,119,11,72,0,4,11,76,0.0261168384879725,0.144736842105263
2013,20121,160,843,96,523,8,8,104,531,0.0244779421933343,0.195856873822976
2013,20123,53,137,10,28,0,1,10,29,0.00661194710442316,0.344827586206897
2013,20125,75,515,114,572,39,72,153,644,0.0277669986633898,0.237577639751553
2013,20127,35,156,7,116,6,33,13,149,0.0351166627386283,0.087248322147651
2013,20129,34,72,14,70,0,0,14,70,0.0335892514395393,0.2
2013,20131,75,147,33,81,0,7,33,88,0.0127832655432888,0.375
2013,20133,119,456,15,119,0,31,15,150,0.0136786430786066,0.1
2013,20135,7,33,0,21,0,0,0,21,0.0089974293059126,0
2013,20137,28,353,2,100,0,0,2,100,0.0238549618320611,0.02
2013,20139,23,442,61,141,19,32,80,173,0.0155226558995065,0.46242774566474
2013,20141,53,117,5,54,0,3,5,57,0.0203716940671908,0.087719298245614
2013,20143,32,197,14,65,0,0,14,65,0.0155094249582439,0.215384615384615
2013,20145,7,353,0,113,0,4,0,117,0.0234657039711191,0
2013,20147,41,100,4,41,0,0,4,41,0.0104698672114402,0.0975609756097561
2013,20149,230,575,151,366,0,31,151,397,0.0287472845763939,0.380352644836272
2013,20151,24,132,88,122,0,49,88,171,0.0268193224592221,0.514619883040936
2013,20153,5,7,24,36,0,0,24,36,0.0182926829268293,0.666666666666667
2013,20155,340,1684,159,715,100,280,259,995,0.0230286759089962,0.260301507537688
2013,20157,8,52,12,76,0,0,12,76,0.0206971677559913,0.157894736842105
2013,20159,24,185,35,130,0,3,35,133,0.0204678362573099,0.263157894736842
2013,20161,340,1035,814,1856,294,585,1108,2441,0.0687935067497111,0.45391233101188
2013,20163,20,139,20,42,0,6,20,48,0.0131291028446389,0.416666666666667
2013,20165,27,89,3,29,0,0,3,29,0.0121542330259849,0.103448275862069
2013,20167,0,185,4,63,0,1,4,64,0.012625764450582,0.0625
2013,20169,129,729,311,570,0,34,311,604,0.0165493054223635,0.514900662251656
2013,20171,0,47,22,90,0,0,22,90,0.0256410256410256,0.244444444444444
2013,20173,1619,5086,2252,6407,304,854,2556,7261,0.0228515858578865,0.352017628425837
2013,20175,88,252,142,636,12,21,154,657,0.050325545767905,0.234398782343988
2013,20177,653,2530,850,2373,112,304,962,2677,0.0225154757098641,0.359357489727307
2013,20179,0,86,6,21,0,0,6,21,0.0118110236220472,0.285714285714286
2013,20181,34,82,37,187,0,0,37,187,0.0440725901484798,0.197860962566845
2013,20183,9,49,2,24,0,0,2,24,0.00836820083682008,0.0833333333333333
2013,20185,20,97,4,24,4,4,8,28,0.00919238345370978,0.285714285714286
2013,20187,0,58,8,27,0,0,8,27,0.0204236006051437,0.296296296296296
2013,20189,14,127,0,121,0,0,0,121,0.0336204501250347,0
2013,20191,70,730,53,134,0,8,53,142,0.00892127913551549,0.373239436619718
2013,20193,38,220,50,157,0,0,50,157,0.0316277195809831,0.318471337579618
2013,20195,17,125,28,50,0,0,28,50,0.0238322211630124,0.56
2013,20197,34,140,10,49,0,4,10,53,0.010952676172763,0.188679245283019
2013,20199,6,14,0,31,0,0,0,31,0.0288372093023256,0
2013,20201,8,54,4,67,0,3,4,70,0.0169573643410853,0.0571428571428571
2013,20203,3,18,20,62,0,0,20,62,0.0429362880886427,0.32258064516129
2013,20205,12,121,2,46,0,0,2,46,0.0072021293251918,0.0434782608695652
2013,20207,13,80,3,32,0,0,3,32,0.0133222314737719,0.09375
2013,20209,533,2579,606,3127,226,761,832,3888,0.0393928954994022,0.213991769547325
2013,21001,31,401,5,142,0,0,5,142,0.0114747474747475,0.0352112676056338
2013,21003,76,437,14,308,7,33,21,341,0.0253098790172938,0.06158357771261
2013,21005,178,848,38,66,0,5,38,71,0.00488947042214723,0.535211267605634
2013,21007,4,103,26,73,0,2,26,75,0.0128008192524322,0.346666666666667
2013,21009,49,593,101,382,3,49,104,431,0.0149258900124671,0.241299303944316
2013,21011,64,396,0,52,0,31,0,83,0.0105263157894737,0
2013,21013,16,286,85,479,0,0,85,479,0.0243877602973372,0.177453027139875
2013,21015,624,2946,1159,2800,264,393,1423,3193,0.0408683075426538,0.445662386470404
2013,21017,41,428,30,134,0,36,30,170,0.0124196376388077,0.176470588235294
2013,21019,98,814,84,930,0,41,84,971,0.0276433411148437,0.0865087538619979
2013,21021,131,998,50,492,14,42,64,534,0.0276183087664856,0.119850187265918
2013,21023,5,95,15,42,0,12,15,54,0.00952717007762879,0.277777777777778
2013,21025,4,198,18,47,5,18,23,65,0.00683634833824148,0.353846153846154
2013,21027,13,422,18,200,0,39,18,239,0.0174033350324037,0.0753138075313808
2013,21029,168,1636,130,745,28,45,158,790,0.0156188216686437,0.2
2013,21031,12,112,5,145,0,0,5,145,0.0164623069936421,0.0344827586206897
2013,21033,101,280,41,193,0,0,41,193,0.021267217630854,0.212435233160622
2013,21035,83,265,224,487,65,91,289,578,0.0254502223592092,0.5
2013,21037,522,1694,580,1530,16,63,596,1593,0.0265093523264328,0.37413684871312
2013,21039,6,71,0,5,0,0,0,5,0.00141362736782584,0
2013,21041,2,413,13,212,0,0,13,212,0.0295758928571429,0.0613207547169811
2013,21043,38,404,20,231,0,25,20,256,0.0138760908450323,0.078125
2013,21045,54,415,31,181,0,29,31,210,0.0190631808278867,0.147619047619048
2013,21047,162,730,256,3032,167,1033,423,4065,0.0956380575945793,0.104059040590406
2013,21049,203,885,158,481,0,18,158,499,0.0201274604711197,0.316633266533066
2013,21051,15,264,9,360,0,0,9,360,0.0240112052291069,0.025
2013,21053,0,120,0,71,0,7,0,78,0.0111158614792646,0
2013,21055,0,108,0,111,3,3,3,114,0.0175438596491228,0.0263157894736842
2013,21057,26,65,8,85,0,8,8,93,0.0195296094078118,0.0860215053763441
2013,21059,166,1372,69,600,23,118,92,718,0.0110083866120847,0.128133704735376
2013,21061,30,265,7,58,0,14,7,72,0.00850862680217443,0.0972222222222222
2013,21063,6,491,0,9,0,0,0,9,0.00165107319757843,0
2013,21065,46,260,4,5,0,10,4,15,0.0014571595103944,0.266666666666667
2013,21067,1487,6487,2969,5730,1014,2187,3983,7917,0.0407578058637288,0.503094606542882
2013,21069,30,90,18,221,0,16,18,237,0.0241713411524732,0.0759493670886076
2013,21071,94,866,15,269,19,27,34,296,0.0108009487319832,0.114864864864865
2013,21073,429,1714,141,559,33,110,174,669,0.019768919358175,0.260089686098655
2013,21075,33,187,33,175,0,4,33,179,0.0379237288135593,0.184357541899441
2013,21077,21,205,64,147,0,7,64,154,0.0279644089340839,0.415584415584416
2013,21079,104,415,0,85,9,23,9,108,0.0091533180778032,0.0833333333333333
2013,21081,52,698,39,123,0,4,39,127,0.00810414140769574,0.307086614173228
2013,21083,33,303,27,264,27,101,54,365,0.0144468632495547,0.147945205479452
2013,21085,61,576,0,373,6,17,6,390,0.0223508510516362,0.0153846153846154
2013,21087,4,222,0,50,0,16,0,66,0.00829979879275654,0
2013,21089,45,494,113,536,0,20,113,556,0.021460552725027,0.203237410071942
2013,21091,48,269,5,131,0,9,5,140,0.024263431542461,0.0357142857142857
2013,21093,324,1854,1282,4247,205,854,1487,5101,0.0748232463989204,0.291511468339541
2013,21095,28,311,13,113,0,6,13,119,0.00597419549174155,0.109243697478992
2013,21097,82,623,42,145,0,1,42,146,0.0113840155945419,0.287671232876712
2013,21099,31,303,0,85,9,21,9,106,0.00863825279113357,0.0849056603773585
2013,21101,115,620,183,565,16,60,199,625,0.0197024147279491,0.3184
2013,21103,61,457,0,41,11,19,11,60,0.00571482998380798,0.183333333333333
2013,21105,46,243,3,91,0,0,3,91,0.0261119081779053,0.032967032967033
2013,21107,70,765,46,319,11,40,57,359,0.0110407184155493,0.158774373259053
2013,21109,8,152,0,77,0,0,0,77,0.00832342449464923,0
2013,21111,1853,7534,4425,10647,827,2429,5252,13076,0.0257905709388628,0.401651881309269
2013,21113,462,1924,356,584,24,24,380,608,0.0193181457121978,0.625
2013,21115,38,366,37,160,0,0,37,160,0.00985889457144618,0.23125
2013,21117,651,3057,1367,3312,103,314,1470,3626,0.0338448327359618,0.405405405405405
2013,21119,0,208,71,158,0,13,71,171,0.0153873841446954,0.415204678362573
2013,21121,55,866,21,291,25,40,46,331,0.0156775446407427,0.138972809667674
2013,21123,36,323,19,73,0,19,19,92,0.00948551397051242,0.206521739130435
2013,21125,180,1244,130,633,0,42,130,675,0.0168337572946282,0.192592592592593
2013,21127,37,360,15,197,18,27,33,224,0.0206661131100655,0.147321428571429
2013,21129,11,232,0,113,0,0,0,113,0.0205678922460866,0
2013,21131,7,142,0,242,0,0,0,242,0.0308594746238205,0
2013,21133,39,253,18,43,0,0,18,43,0.0025298582102724,0.418604651162791
2013,21135,32,209,42,221,0,0,42,221,0.0232558139534884,0.190045248868778
2013,21137,165,754,56,156,0,0,56,156,0.00929401251117069,0.358974358974359
2013,21139,18,122,12,97,0,0,12,97,0.01420829061081,0.123711340206186
2013,21141,59,448,30,430,0,20,30,450,0.0245351943732621,0.0666666666666667
2013,21143,33,575,11,80,0,8,11,88,0.0133474897618686,0.125
2013,21145,157,1202,303,1075,0,76,303,1151,0.0249707120232568,0.263249348392702
2013,21147,6,379,23,435,0,41,23,476,0.038480194017785,0.0483193277310924
2013,21149,29,156,20,31,0,0,20,31,0.00472416946053033,0.645161290322581
2013,21151,368,1382,296,1079,22,79,318,1158,0.0224544802311377,0.274611398963731
2013,21153,27,151,21,59,0,6,21,65,0.00725527402611899,0.323076923076923
2013,21155,43,563,53,77,0,17,53,94,0.0069583240802428,0.563829787234043
2013,21157,170,444,12,285,0,0,12,285,0.0126145266232904,0.0421052631578947
2013,21159,0,170,44,318,0,7,44,325,0.0367065733002033,0.135384615384615
2013,21161,110,421,23,356,7,18,30,374,0.0316172119367656,0.0802139037433155
2013,21163,101,998,144,839,16,86,160,925,0.049317551716784,0.172972972972973
2013,21165,1,109,0,35,0,29,0,64,0.0148148148148148,0
2013,21167,127,628,25,143,0,5,25,148,0.0100128543400311,0.168918918918919
2013,21169,31,304,4,84,0,13,4,97,0.0140112667918532,0.0412371134020619
2013,21171,35,205,21,100,6,6,27,106,0.0140285865537321,0.254716981132075
2013,21173,71,699,29,334,0,0,29,334,0.0184642600475427,0.0868263473053892
2013,21175,36,611,37,129,0,0,37,129,0.013182096873084,0.286821705426357
2013,21177,0,637,36,224,0,26,36,250,0.0114264820147173,0.144
2013,21179,127,934,31,282,10,14,41,296,0.0101788170563961,0.138513513513514
2013,21181,29,127,39,77,0,0,39,77,0.0156663275686673,0.506493506493506
2013,21183,0,347,7,141,4,6,11,147,0.00912250217202433,0.0748299319727891
2013,21185,616,2124,335,947,93,125,428,1072,0.0266666666666667,0.399253731343284
2013,21187,0,209,77,95,1,5,78,100,0.0135281385281385,0.78
2013,21189,3,74,0,0,0,0,0,0,0,NA
2013,21191,42,316,24,179,0,0,24,179,0.0181486363175504,0.134078212290503
2013,21193,72,420,14,151,0,12,14,163,0.0082527466963698,0.0858895705521472
2013,21195,131,798,168,818,0,50,168,868,0.0192397207137316,0.193548387096774
2013,21197,64,225,0,10,0,0,0,10,0.00119274809160305,0
2013,21199,226,841,74,667,0,46,74,713,0.0161696337453226,0.103786816269285
2013,21201,0,41,16,27,0,0,16,27,0.017578125,0.592592592592593
2013,21203,41,248,11,93,0,13,11,106,0.00901207277673865,0.10377358490566
2013,21205,91,655,75,308,0,0,75,308,0.0228435808054587,0.243506493506494
2013,21207,21,183,0,59,0,11,0,70,0.00570171866091065,0
2013,21209,409,1781,189,632,6,30,195,662,0.0213555275976644,0.294561933534743
2013,21211,145,1068,112,549,31,31,143,580,0.0201046830046102,0.246551724137931
2013,21213,31,407,117,548,0,0,117,548,0.047018447018447,0.213503649635036
2013,21215,71,496,73,112,0,0,73,112,0.00961455918963001,0.651785714285714
2013,21217,40,336,11,194,0,25,11,219,0.0134661501567976,0.0502283105022831
2013,21219,26,184,36,133,0,3,36,136,0.0171500630517024,0.264705882352941
2013,21221,26,173,54,178,0,11,54,189,0.0186482486433152,0.285714285714286
2013,21223,3,196,15,190,55,55,70,245,0.0410798122065728,0.285714285714286
2013,21225,0,269,21,174,0,22,21,196,0.0205493814216817,0.107142857142857
2013,21227,368,1941,622,2167,109,302,731,2469,0.0350640497628313,0.296071283920616
2013,21229,16,181,18,61,0,8,18,69,0.00881113523177117,0.260869565217391
2013,21231,52,282,0,220,0,1,0,221,0.0152277268655688,0
2013,21233,7,352,5,149,7,7,12,156,0.0167922497308934,0.0769230769230769
2013,21235,72,794,82,401,0,0,82,401,0.0173502942194531,0.204488778054863
2013,21237,22,95,0,18,0,0,0,18,0.00357142857142857,0
2013,21239,184,457,154,316,9,78,163,394,0.0228326379230413,0.413705583756345
2013,22001,118,1037,122,497,21,163,143,660,0.016802016241949,0.216666666666667
2013,22003,15,675,55,449,0,76,55,525,0.029839718085711,0.104761904761905
2013,22005,365,1591,264,1163,47,398,311,1561,0.0224762782393342,0.199231262011531
2013,22007,27,409,0,95,0,0,0,95,0.00612547553033722,0
2013,22009,120,1023,37,264,1,1,38,265,0.00943732193732194,0.143396226415094
2013,22011,115,1101,75,663,70,153,145,816,0.0344667370644139,0.177696078431373
2013,22013,39,343,0,161,0,0,0,161,0.0167185877466251,0
2013,22015,902,3182,1007,2860,68,254,1075,3114,0.0401842747086834,0.345215157353886
2013,22017,919,4301,1041,2718,134,452,1175,3170,0.0189029153423694,0.370662460567823
2013,22019,486,2423,491,2379,180,344,671,2723,0.0217751157527729,0.246419390378259
2013,22021,66,269,2,85,0,17,2,102,0.0147676270450268,0.0196078431372549
2013,22023,9,63,14,88,0,0,14,88,0.0190229139645482,0.159090909090909
2013,22025,20,548,85,117,0,2,85,119,0.0169178276940574,0.714285714285714
2013,22027,43,483,16,168,0,2,16,170,0.0142641382782346,0.0941176470588235
2013,22029,79,640,68,318,0,34,68,352,0.0256391579867434,0.193181818181818
2013,22031,43,339,26,196,0,57,26,253,0.0141025641025641,0.102766798418972
2013,22033,1885,5285,2082,4446,614,1002,2696,5448,0.0198203507852832,0.494860499265786
2013,22035,0,304,5,127,0,0,5,127,0.02579727808247,0.0393700787401575
2013,22037,43,882,31,76,0,0,31,76,0.00535512965050733,0.407894736842105
2013,22039,65,905,0,234,0,85,0,319,0.014866943188703,0
2013,22041,63,797,36,239,0,13,36,252,0.0184994861253854,0.142857142857143
2013,22043,30,605,5,570,0,64,5,634,0.0415710445216707,0.00788643533123028
2013,22045,184,964,135,507,9,137,144,644,0.013747758517633,0.22360248447205
2013,22047,118,1759,32,237,0,3,32,240,0.0105536256101315,0.133333333333333
2013,22049,41,403,23,289,2,17,25,306,0.0273654086925416,0.0816993464052288
2013,22051,1937,7806,1858,5171,514,1454,2372,6625,0.0222297533084584,0.358037735849057
2013,22053,94,838,57,395,8,53,65,448,0.0217983651226158,0.145089285714286
2013,22055,1269,4112,696,2567,184,507,880,3074,0.0214371391112723,0.286271958360442
2013,22057,327,1770,125,440,10,179,135,619,0.00976556337361562,0.218093699515347
2013,22059,35,433,7,261,0,31,7,292,0.0288452039909118,0.023972602739726
2013,22061,285,798,229,614,124,161,353,775,0.0304566533050381,0.455483870967742
2013,22063,679,2627,55,1131,30,135,85,1266,0.0151585904666116,0.0671406003159558
2013,22065,21,654,24,129,0,12,24,141,0.0179002158182049,0.170212765957447
2013,22067,83,278,36,130,0,0,36,130,0.00705295138888889,0.276923076923077
2013,22069,101,829,25,275,17,35,42,310,0.0131478496903893,0.135483870967742
2013,22071,2281,6727,4517,8467,781,1169,5298,9636,0.0401746069467549,0.549813200498132
2013,22073,476,3101,320,1176,22,77,342,1253,0.0128775654926465,0.272944932162809
2013,22075,122,490,57,422,15,17,72,439,0.0293233584930866,0.164009111617312
2013,22077,16,183,17,97,0,43,17,140,0.00902527075812274,0.121428571428571
2013,22079,335,2057,150,703,50,208,200,911,0.0105848999604954,0.21953896816685
2013,22081,28,148,0,21,0,0,0,21,0.00353654429100707,0
2013,22083,102,688,37,124,0,0,37,124,0.00907427735089645,0.298387096774194
2013,22085,55,201,28,119,1,14,29,133,0.00812312954253955,0.218045112781955
2013,22087,119,1139,83,497,15,93,98,590,0.023865383059623,0.166101694915254
2013,22089,253,1241,45,380,23,117,68,497,0.0145351387710935,0.13682092555332
2013,22091,10,275,0,90,0,0,0,90,0.0123152709359606,0
2013,22093,18,186,69,143,8,9,77,152,0.0106204583566238,0.506578947368421
2013,22095,204,1104,69,308,0,0,69,308,0.0106907323845887,0.224025974025974
2013,22097,168,1233,72,375,0,42,72,417,0.00779279026742165,0.172661870503597
2013,22099,52,1108,14,247,34,77,48,324,0.00947202245220137,0.148148148148148
2013,22101,111,671,130,591,14,90,144,681,0.0192285972441834,0.211453744493392
2013,22103,1493,4377,1827,4395,229,547,2056,4942,0.0310602727672679,0.416025900445164
2013,22105,139,1583,221,1254,47,88,268,1342,0.0174501007736818,0.199701937406855
2013,22107,0,118,0,3,0,0,0,3,0.000857142857142857,0
2013,22109,215,2008,130,1081,15,65,145,1146,0.0159817033204569,0.12652705061082
2013,22111,23,276,56,123,0,8,56,131,0.008491605626499,0.427480916030534
2013,22113,147,900,134,333,16,19,150,352,0.00931833223031105,0.426136363636364
2013,22115,82,481,717,2370,102,465,819,2835,0.0912397013388259,0.288888888888889
2013,22117,65,785,22,534,0,13,22,547,0.0174120643004934,0.0402193784277879
2013,22119,18,651,30,419,25,50,55,469,0.0168329624578279,0.11727078891258
2013,22121,222,962,37,380,0,0,37,380,0.0241223893861487,0.0973684210526316
2013,22123,0,146,0,129,0,4,0,133,0.0171369668857106,0
2013,22125,153,483,21,130,0,10,21,140,0.0118313191920899,0.15
2013,22127,46,521,34,205,0,0,34,205,0.0195108023222614,0.165853658536585
2013,23001,387,2100,328,806,29,112,357,918,0.0124723177044414,0.388888888888889
2013,23003,99,455,107,760,13,53,120,813,0.0157597844418167,0.14760147601476
2013,23005,1704,4415,3147,5592,437,885,3584,6477,0.0324647008405636,0.553342596881272
2013,23007,88,397,83,164,0,8,83,172,0.00808004885610936,0.482558139534884
2013,23009,238,754,262,768,28,120,290,888,0.0219410950780787,0.326576576576577
2013,23011,597,2078,548,1295,112,195,660,1490,0.017289996170672,0.442953020134228
2013,23013,124,556,214,374,74,78,288,452,0.0152553241756387,0.63716814159292
2013,23015,140,485,225,312,44,73,269,385,0.0148752028436751,0.698701298701299
2013,23017,153,894,206,632,4,9,210,641,0.0154547208023917,0.327613104524181
2013,23019,460,2270,655,1591,98,172,753,1763,0.0168648421133187,0.427112875779921
2013,23021,28,202,32,118,17,33,49,151,0.0115152901700602,0.324503311258278
2013,23023,324,1094,149,411,0,39,149,450,0.017621490386498,0.331111111111111
2013,23025,73,820,34,375,6,6,40,381,0.0101502557544757,0.10498687664042
2013,23027,112,540,194,428,7,7,201,435,0.0156362329259526,0.462068965517241
2013,23029,47,455,192,404,55,62,247,466,0.0195888856194039,0.530042918454936
2013,23031,548,2719,1534,3661,96,242,1630,3903,0.0276168035831794,0.417627466051755
2013,24001,111,779,216,1000,71,106,287,1106,0.021408799674803,0.259493670886076
2013,24003,3502,10233,4752,9288,918,1817,5670,11105,0.0300754526890515,0.510580819450698
2013,24005,4019,14779,3759,7706,1760,2898,5519,10604,0.0191551432932612,0.520463975858167
2013,24009,446,1371,699,1396,106,193,805,1589,0.0268743552015154,0.506607929515419
2013,24011,100,704,52,268,0,20,52,288,0.0131584959108146,0.180555555555556
2013,24013,1179,2599,464,1086,91,193,555,1279,0.0113660600028437,0.433932759968726
2013,24015,214,1123,667,2210,13,201,680,2411,0.0357842555212539,0.282040647034426
2013,24017,632,2265,874,2481,115,272,989,2753,0.0283884672496288,0.359244460588449
2013,24019,188,626,57,185,9,50,66,235,0.0101727197956798,0.280851063829787
2013,24021,1150,3300,1423,3161,341,726,1764,3887,0.0246712196608104,0.453820427064574
2013,24023,32,214,170,592,0,11,170,603,0.0285470813804857,0.281923714759536
2013,24025,1431,3840,1326,2668,132,392,1458,3060,0.0183778264916969,0.476470588235294
2013,24027,3663,6815,3121,4256,896,1349,4017,5605,0.0285131450431385,0.716681534344335
2013,24029,90,221,179,307,7,23,186,330,0.02356637863315,0.563636363636364
2013,24031,3852,8871,17681,24660,5275,9850,22956,34510,0.0508822939643072,0.66519849319038
2013,24033,3543,9511,6354,17793,1554,3697,7908,21490,0.0377475812741082,0.367985109353188
2013,24035,281,1060,159,355,90,159,249,514,0.0154470323065364,0.48443579766537
2013,24037,444,1364,671,2177,138,372,809,2549,0.0370963282057253,0.31737936445665
2013,24039,63,1422,78,201,9,12,87,213,0.01258344656466,0.408450704225352
2013,24041,131,795,252,582,43,70,295,652,0.0232574730684169,0.452453987730061
2013,24043,374,3256,780,2399,49,242,829,2641,0.0258099193745419,0.313896251419917
2013,24045,334,1253,265,1514,211,294,476,1808,0.028938186241557,0.263274336283186
2013,24047,319,1136,182,809,42,53,224,862,0.022464296883144,0.259860788863109
2013,24510,4280,12594,5066,8132,1361,2418,6427,10550,0.0254877091260494,0.609194312796209
2013,25001,1173,2701,1255,2822,56,383,1311,3205,0.019515313889058,0.409048361934477
2013,25003,404,755,486,1531,66,182,552,1713,0.0183954210113723,0.322241681260946
2013,25005,1458,5414,1596,5029,338,815,1934,5844,0.0155333818862267,0.330937713894593
2013,25007,119,268,148,220,4,154,152,374,0.0298150510204082,0.406417112299465
2013,25009,3800,9485,3288,6946,873,2781,4161,9727,0.0189905915841633,0.427778348925671
2013,25011,628,1459,405,886,47,238,452,1124,0.0217109965038342,0.402135231316726
2013,25013,1154,3701,1076,3746,457,2070,1533,5816,0.0189632798387991,0.263583218707015
2013,25015,1147,2682,1151,1719,498,682,1649,2401,0.0246471282656675,0.686797167846731
2013,25017,15333,26373,16366,22507,7903,11667,24269,34174,0.0323592909628058,0.710159770585825
2013,25019,64,150,94,155,0,23,94,178,0.0239183015318463,0.528089887640449
2013,25021,9991,17768,4626,6890,2107,3313,6733,10203,0.0217188155231099,0.659903949818681
2013,25023,3344,9463,1308,3167,397,1071,1705,4238,0.012505569670305,0.402312411514866
2013,25025,10126,18329,8888,12023,3726,6968,12614,18991,0.0392139453057246,0.664209362329525
2013,25027,3559,8909,2897,6555,1249,2499,4146,9054,0.0167656731452951,0.45791915175613
2013,26001,54,344,18,101,6,23,24,124,0.0142250774348973,0.193548387096774
2013,26003,86,609,18,133,0,6,18,139,0.0190855416723878,0.129496402877698
2013,26005,373,2736,239,591,10,124,249,715,0.00962522212051047,0.348251748251748
2013,26007,86,386,52,162,0,44,52,206,0.00969503012048193,0.252427184466019
2013,26009,76,526,35,120,11,34,46,154,0.00892081330012165,0.298701298701299
2013,26011,30,428,20,105,0,5,20,110,0.00950406082598929,0.181818181818182
2013,26013,24,414,15,41,0,5,15,46,0.00687285223367698,0.326086956521739
2013,26015,255,1180,33,315,36,59,69,374,0.00923251623096102,0.184491978609626
2013,26017,351,1928,103,673,110,143,213,816,0.0109299864714628,0.261029411764706
2013,26019,68,366,72,131,0,10,72,141,0.010936166912278,0.51063829787234
2013,26021,256,1242,775,1755,308,524,1083,2279,0.0213211836578132,0.475208424747696
2013,26023,78,1180,52,282,0,35,52,317,0.0105298123235343,0.16403785488959
2013,26025,535,2678,322,1188,39,142,361,1330,0.0146379044684129,0.271428571428571
2013,26027,69,506,161,742,6,30,167,772,0.0212631173052029,0.216321243523316
2013,26029,146,481,90,246,15,47,105,293,0.0156818668379362,0.358361774744027
2013,26031,81,722,75,254,0,13,75,267,0.0139091477391123,0.280898876404494
2013,26033,136,1489,112,431,0,70,112,501,0.0186954250317188,0.223552894211577
2013,26035,105,863,7,149,5,27,12,176,0.00796596361002987,0.0681818181818182
2013,26037,641,1830,239,530,8,47,247,577,0.0115949601109258,0.428076256499133
2013,26039,115,635,0,89,0,8,0,97,0.00932423339421321,0
2013,26041,82,437,50,391,13,47,63,438,0.0164519400518349,0.143835616438356
2013,26043,97,457,110,486,0,39,110,525,0.0277998411437649,0.20952380952381
2013,26045,960,3631,379,875,141,249,520,1124,0.0152638583340123,0.462633451957295
2013,26047,289,742,109,301,25,78,134,379,0.016423990292945,0.353562005277045
2013,26049,1185,5481,655,2423,209,520,864,2943,0.0105113524749717,0.293577981651376
2013,26051,126,724,27,82,5,35,32,117,0.00619900392073752,0.273504273504274
2013,26053,29,370,56,345,9,9,65,354,0.0290187720304943,0.18361581920904
2013,26055,865,2979,400,927,67,147,467,1074,0.0173615040170705,0.434823091247672
2013,26057,103,1670,40,144,11,35,51,179,0.00632978535308886,0.284916201117318
2013,26059,68,575,80,307,3,64,83,371,0.011920061688729,0.223719676549865
2013,26061,132,417,147,338,143,176,290,514,0.0238636891220577,0.56420233463035
2013,26063,113,562,25,108,16,34,41,142,0.00592753381198865,0.288732394366197
2013,26065,1709,5660,1560,2760,1015,1681,2575,4441,0.0265224583888249,0.579824363882009
2013,26067,247,2620,41,345,13,74,54,419,0.00990426663514951,0.128878281622912
2013,26069,92,808,24,338,14,38,38,376,0.0192003268140734,0.101063829787234
2013,26071,17,102,21,149,0,11,21,160,0.0175361683472161,0.13125
2013,26073,361,1670,145,502,67,163,212,665,0.0185489944492483,0.318796992481203
2013,26075,654,4799,266,963,54,208,320,1171,0.010777726645191,0.273270708795901
2013,26077,1578,4426,800,2205,149,463,949,2668,0.0170742165251282,0.355697151424288
2013,26079,126,534,14,158,7,18,21,176,0.0144855967078189,0.119318181818182
2013,26081,3036,8769,2431,4995,711,1552,3142,6547,0.0168355709616616,0.479914464640293
2013,26083,8,69,31,63,0,0,31,63,0.0369284876905041,0.492063492063492
2013,26085,26,445,5,113,0,1,5,114,0.012972234865726,0.043859649122807
2013,26087,415,2208,182,551,8,120,190,671,0.0111118471168814,0.283159463487332
2013,26089,281,640,200,310,3,5,203,315,0.0192554557124519,0.644444444444444
2013,26091,244,2014,440,941,24,163,464,1104,0.0164036729963448,0.420289855072464
2013,26093,1806,4718,404,1276,114,250,518,1526,0.0123429828605631,0.339449541284404
2013,26095,23,334,3,36,0,8,3,44,0.00889787664307381,0.0681818181818182
2013,26097,67,222,40,151,4,7,44,158,0.0187670744744031,0.278481012658228
2013,26099,3852,16893,953,3664,989,2855,1942,6519,0.0111934724490164,0.29789845068262
2013,26101,119,788,86,209,14,44,100,253,0.0139240506329114,0.395256916996047
2013,26103,198,1001,276,626,44,181,320,807,0.0180468278283427,0.396530359355638
2013,26105,146,646,92,248,2,36,94,284,0.0138868514987042,0.330985915492958
2013,26107,207,744,66,213,14,55,80,268,0.0104458995946367,0.298507462686567
2013,26109,19,238,53,422,5,17,58,439,0.0251029277218664,0.132118451025057
2013,26111,281,1618,491,1397,137,181,628,1578,0.0278700105969622,0.397972116603295
2013,26113,45,358,28,91,0,10,28,101,0.00984693380130642,0.277227722772277
2013,26115,490,2466,269,1301,41,174,310,1475,0.0143475511891445,0.210169491525424
2013,26117,244,1847,32,346,15,60,47,406,0.00947424917742048,0.11576354679803
2013,26119,13,295,12,189,0,6,12,195,0.0259377494014366,0.0615384615384615
2013,26121,571,3756,155,1263,27,108,182,1371,0.012065263306111,0.132749817651349
2013,26123,115,1197,89,423,0,46,89,469,0.0143675520019606,0.189765458422175
2013,26125,9722,27353,5625,10038,4128,6654,9753,16692,0.0199015414991016,0.584291876347951
2013,26127,146,570,17,333,8,67,25,400,0.0222494159528312,0.0625
2013,26129,91,718,19,115,4,13,23,128,0.00811101958050821,0.1796875
2013,26131,12,54,13,37,0,3,13,40,0.00754147812971342,0.325
2013,26133,96,655,26,139,14,20,40,159,0.00997115264016054,0.251572327044025
2013,26135,13,250,6,57,0,4,6,61,0.00961993376439048,0.0983606557377049
2013,26137,143,734,37,306,8,11,45,317,0.0187929807920322,0.141955835962145
2013,26139,1344,5173,713,1586,291,502,1004,2088,0.0128047097783093,0.480842911877395
2013,26141,42,325,33,145,0,7,33,152,0.014809041309431,0.217105263157895
2013,26143,53,765,14,207,0,52,14,259,0.0135900933990975,0.0540540540540541
2013,26145,484,3099,352,1496,127,290,479,1786,0.0135120821921954,0.268197088465845
2013,26147,484,2891,245,1051,38,123,283,1174,0.0105512914996495,0.241056218057922
2013,26149,69,591,82,460,0,22,82,482,0.0119032919269997,0.170124481327801
2013,26151,83,755,17,188,2,36,19,224,0.00758011573212412,0.0848214285714286
2013,26153,26,89,4,61,0,3,4,64,0.0102383618621021,0.0625
2013,26155,232,1637,96,471,3,66,99,537,0.0113250521964696,0.184357541899441
2013,26157,84,1142,92,318,30,53,122,371,0.00971153342756924,0.328840970350404
2013,26159,198,1058,158,796,73,139,231,935,0.018370434406743,0.247058823529412
2013,26161,2731,6841,3581,5196,1961,2388,5542,7584,0.0351220054368716,0.730748945147679
2013,26163,5133,18735,3134,10064,1780,4598,4914,14662,0.012452735321196,0.335152093848043
2013,26165,114,818,55,205,0,13,55,218,0.00972780008924587,0.252293577981651
2013,27001,106,422,6,80,0,12,6,92,0.00742414460942544,0.0652173913043478
2013,27003,1934,8991,762,2452,260,799,1022,3251,0.0146633650415635,0.314364810827438
2013,27005,128,573,120,453,1,20,121,473,0.0210306344760126,0.255813953488372
2013,27007,323,857,98,347,20,58,118,405,0.0149039523073526,0.291358024691358
2013,27009,286,1689,13,111,0,15,13,126,0.00496258369436786,0.103174603174603
2013,27011,37,118,2,20,2,2,4,22,0.00573364607766484,0.181818181818182
2013,27013,335,1167,159,303,23,47,182,350,0.00933781548476602,0.52
2013,27015,139,348,29,79,0,28,29,107,0.00610103774660737,0.271028037383178
2013,27017,167,735,78,240,3,24,81,264,0.010762331838565,0.306818181818182
2013,27019,1305,3098,506,861,62,193,568,1054,0.0178332741146811,0.538899430740038
2013,27021,109,575,46,131,4,14,50,145,0.00705493115360288,0.344827586206897
2013,27023,33,332,20,88,2,4,22,92,0.0107778819119025,0.239130434782609
2013,27025,442,2203,95,269,3,141,98,410,0.0113344207005225,0.239024390243902
2013,27027,119,571,520,1308,23,83,543,1391,0.0390269906290332,0.390366642703091
2013,27029,28,155,4,41,2,3,6,44,0.00732113144758735,0.136363636363636
2013,27031,13,84,44,50,18,46,62,96,0.0239461212272387,0.645833333333333
2013,27033,48,219,5,66,0,1,5,67,0.00834682945060421,0.0746268656716418
2013,27035,254,1317,126,450,15,77,141,527,0.0120528771384137,0.267552182163188
2013,27037,3441,9667,1838,3821,470,1331,2308,5152,0.0193230916946711,0.447981366459627
2013,27039,104,459,34,78,0,12,34,90,0.00697458152510849,0.377777777777778
2013,27041,155,713,29,162,0,29,29,191,0.00747817235033867,0.151832460732984
2013,27043,37,266,29,93,0,4,29,97,0.00940286932919736,0.298969072164948
2013,27045,52,329,44,166,8,38,52,204,0.0141303594929695,0.254901960784314
2013,27047,44,393,39,177,5,70,44,247,0.0112328891718587,0.178137651821862
2013,27049,168,723,196,540,28,47,224,587,0.0182683928793726,0.38160136286201
2013,27051,33,116,11,21,0,0,11,21,0.00485100485100485,0.523809523809524
2013,27053,9635,20917,9228,16359,3061,5179,12289,21538,0.0270796635976046,0.570572940848732
2013,27055,11,106,88,353,19,25,107,378,0.0282215917575034,0.283068783068783
2013,27057,81,428,43,214,6,12,49,226,0.0152836951376209,0.216814159292035
2013,27059,198,1303,42,246,0,54,42,300,0.0118170717296254,0.14
2013,27061,195,799,77,370,10,64,87,434,0.0134573643410853,0.200460829493088
2013,27063,35,201,11,95,2,6,13,101,0.0139522033430032,0.128712871287129
2013,27065,75,430,27,123,18,30,45,153,0.0134980149977944,0.294117647058824
2013,27067,106,595,98,322,2,17,100,339,0.0120195716919586,0.294985250737463
2013,27069,8,49,12,27,0,0,12,27,0.00826193390452876,0.444444444444444
2013,27071,20,209,10,71,0,13,10,84,0.00867320598864223,0.119047619047619
2013,27073,47,107,5,26,1,4,6,30,0.00568936089512611,0.2
2013,27075,22,237,32,172,27,33,59,205,0.02519975414874,0.28780487804878
2013,27077,13,127,21,47,0,0,21,47,0.0159646739130435,0.446808510638298
2013,27079,207,710,63,221,2,6,65,227,0.0120315895478878,0.286343612334802
2013,27081,33,123,27,59,0,0,27,59,0.0140342530922931,0.457627118644068
2013,27083,142,461,110,257,15,17,125,274,0.0168397762891033,0.456204379562044
2013,27085,220,816,15,35,6,17,21,52,0.00211244718882028,0.403846153846154
2013,27087,12,88,17,33,0,0,17,33,0.00970302852102323,0.515151515151515
2013,27089,37,140,14,94,0,7,14,101,0.0151288196524865,0.138613861386139
2013,27091,53,190,48,153,2,21,50,174,0.0117998101179981,0.28735632183908
2013,27093,78,500,23,82,4,20,27,102,0.00644549763033175,0.264705882352941
2013,27095,174,1060,43,136,2,12,45,148,0.00843160713268387,0.304054054054054
2013,27097,123,798,43,99,33,63,76,162,0.00715326533315671,0.469135802469136
2013,27099,105,649,70,451,24,76,94,527,0.0201599020695459,0.178368121442125
2013,27101,34,155,16,58,3,8,19,66,0.0105650712341924,0.287878787878788
2013,27103,189,1025,63,290,31,49,94,339,0.0163279067527213,0.277286135693215
2013,27105,45,223,95,210,11,107,106,317,0.0227697169946847,0.334384858044164
2013,27107,9,78,2,69,0,7,2,76,0.0160948750529437,0.0263157894736842
2013,27109,676,2060,1389,2420,320,501,1709,2921,0.0297363330957956,0.585073604929819
2013,27111,234,1075,119,470,12,90,131,560,0.0136219897835077,0.233928571428571
2013,27113,66,364,14,146,8,13,22,159,0.0168432203389831,0.138364779874214
2013,27115,137,919,17,211,0,21,17,232,0.0110051705327072,0.0732758620689655
2013,27117,85,172,10,136,0,16,10,152,0.0234242564339652,0.0657894736842105
2013,27119,126,575,114,669,28,50,142,719,0.0344216775181923,0.19749652294854
2013,27121,38,292,22,71,1,22,23,93,0.0116848850358085,0.247311827956989
2013,27123,5487,13857,3521,6420,1224,2632,4745,9052,0.0269704165636257,0.524193548387097
2013,27125,22,96,0,18,0,3,0,21,0.0073865634892719,0
2013,27127,67,325,13,96,19,31,32,127,0.0116706487777982,0.251968503937008
2013,27129,31,373,32,98,0,10,32,108,0.00992464620474178,0.296296296296296
2013,27131,411,2571,216,533,0,103,216,636,0.0159738791912596,0.339622641509434
2013,27133,25,97,12,129,9,9,21,138,0.0210912425492893,0.152173913043478
2013,27135,92,284,7,78,0,16,7,94,0.0089294195877268,0.074468085106383
2013,27137,795,2684,518,1390,102,270,620,1660,0.0122368343456979,0.373493975903614
2013,27139,1430,4373,336,800,46,217,382,1017,0.0120616245834173,0.375614552605703
2013,27141,889,3626,119,687,81,207,200,894,0.0159040774211912,0.223713646532438
2013,27143,21,267,9,72,1,13,10,85,0.00826044703595724,0.117647058823529
2013,27145,712,3135,327,983,112,287,439,1270,0.0137278004172387,0.345669291338583
2013,27147,110,692,167,373,43,51,210,424,0.0174356443786496,0.495283018867925
2013,27149,24,144,2,87,13,41,15,128,0.0222802436901654,0.1171875
2013,27151,37,176,30,44,0,12,30,56,0.00818354522870086,0.535714285714286
2013,27153,89,419,49,115,5,17,54,132,0.00789473684210526,0.409090909090909
2013,27155,3,45,5,62,8,20,13,82,0.03198127925117,0.158536585365854
2013,27157,75,452,63,128,16,47,79,175,0.011568718186025,0.451428571428571
2013,27159,43,322,17,70,0,33,17,103,0.0108844975166438,0.16504854368932
2013,27161,123,294,28,335,10,12,38,347,0.0260549632076888,0.109510086455331
2013,27163,2727,7298,1401,2402,233,411,1634,2813,0.0175580952618734,0.580874511198009
2013,27165,53,162,7,32,0,5,7,37,0.00485819327731092,0.189189189189189
2013,27167,59,117,13,137,7,9,20,146,0.0319195452557936,0.136986301369863
2013,27169,113,345,147,407,35,60,182,467,0.0152549570443929,0.389721627408994
2013,27171,806,3035,209,627,22,182,231,809,0.0100705812057311,0.285537700865266
2013,27173,58,228,21,109,8,23,29,132,0.018508132361189,0.21969696969697
2013,28001,54,148,50,690,10,48,60,738,0.0327229193455416,0.0813008130081301
2013,28003,163,635,152,635,0,0,152,635,0.0252635766858962,0.239370078740157
2013,28005,16,94,0,62,0,0,0,62,0.0068259385665529,0
2013,28007,44,425,17,262,0,8,17,270,0.0210723483961602,0.062962962962963
2013,28009,4,117,63,167,0,5,63,172,0.0297680858428522,0.366279069767442
2013,28011,47,622,185,587,0,8,185,595,0.0279303384499836,0.310924369747899
2013,28013,32,379,16,80,10,27,26,107,0.0106861080595226,0.242990654205607
2013,28015,9,280,0,15,0,0,0,15,0.0020746887966805,0
2013,28017,0,289,15,122,0,18,15,140,0.0123959624579423,0.107142857142857
2013,28019,3,182,6,126,0,0,6,126,0.0220858895705521,0.0476190476190476
2013,28021,12,52,0,41,0,7,0,48,0.00873362445414847,0
2013,28023,14,90,44,74,5,16,49,90,0.00797801613332151,0.544444444444444
2013,28025,31,434,8,57,0,10,8,67,0.00498400654615785,0.119402985074627
2013,28027,21,322,24,226,0,1,24,227,0.0146206363519258,0.105726872246696
2013,28029,114,353,8,49,0,0,8,49,0.00260126347082869,0.163265306122449
2013,28031,90,503,9,42,0,54,9,96,0.00754005655042413,0.09375
2013,28033,353,2192,1136,4885,51,280,1187,5165,0.0492021909978566,0.229816069699903
2013,28035,520,2343,285,961,47,252,332,1213,0.0266341699053642,0.273701566364386
2013,28037,34,66,0,8,0,0,0,8,0.00147383935151069,0
2013,28039,101,668,17,142,0,130,17,272,0.0185830429732869,0.0625
2013,28041,26,1344,53,170,12,37,65,207,0.0205847255369928,0.314009661835749
2013,28043,108,345,0,158,0,56,0,214,0.0150576977202364,0
2013,28045,400,1421,44,801,0,40,44,841,0.0273167245915484,0.0523186682520809
2013,28047,629,3328,1312,5357,190,715,1502,6072,0.0490587379817403,0.247364953886693
2013,28049,1217,4277,549,1466,39,193,588,1659,0.0108548434586319,0.354430379746835
2013,28051,12,177,57,126,0,19,57,145,0.0128740122525082,0.393103448275862
2013,28053,19,73,8,20,0,26,8,46,0.00800696257615318,0.173913043478261
2013,28055,5,106,0,34,0,0,0,34,0.0348360655737705,0
2013,28057,118,492,44,255,0,9,44,264,0.0170157911698356,0.166666666666667
2013,28059,465,2060,483,2276,54,241,537,2517,0.0272564838377822,0.213349225268176
2013,28061,50,127,7,84,0,3,7,87,0.00764902409002989,0.0804597701149425
2013,28063,0,187,0,22,0,0,0,22,0.00441678377835776,0
2013,28065,24,299,30,59,0,0,30,59,0.00704645885584617,0.508474576271186
2013,28067,100,794,207,578,3,32,210,610,0.0138287501983632,0.344262295081967
2013,28069,0,370,0,112,0,0,0,112,0.0160711723346248,0
2013,28071,133,493,482,1063,97,97,579,1160,0.0435206723193517,0.499137931034483
2013,28073,883,2643,278,966,0,88,278,1054,0.0293756967670011,0.263757115749526
2013,28075,313,1622,476,1261,0,0,476,1261,0.024016760308542,0.377478191911182
2013,28077,27,103,19,141,0,9,19,150,0.0176574455562095,0.126666666666667
2013,28079,45,418,3,160,7,28,10,188,0.0131294084782457,0.0531914893617021
2013,28081,362,1649,217,804,59,128,276,932,0.0170639715844593,0.296137339055794
2013,28083,52,409,10,242,31,47,41,289,0.0148456362048595,0.141868512110727
2013,28085,57,256,83,235,0,8,83,243,0.0106499539816803,0.34156378600823
2013,28087,120,1050,199,781,27,147,226,928,0.0241082794274284,0.243534482758621
2013,28089,1114,2101,676,1071,116,209,792,1280,0.0202515623763943,0.61875
2013,28091,88,453,11,348,9,69,20,417,0.0236555479918312,0.0479616306954436
2013,28093,0,624,0,346,0,16,0,362,0.0147484212670605,0
2013,28095,43,588,26,168,0,32,26,200,0.00808930593755056,0.13
2013,28097,8,106,0,13,0,48,0,61,0.0088086642599278,0
2013,28099,161,715,6,99,0,3,6,102,0.00545308740978348,0.0588235294117647
2013,28101,68,428,0,117,0,0,0,117,0.00835893405729799,0
2013,28103,30,113,24,24,0,0,24,24,0.00328632069012734,1
2013,28105,304,696,186,593,43,81,229,674,0.0275799983632048,0.339762611275964
2013,28107,88,304,34,318,0,16,34,334,0.0151336656094246,0.101796407185629
2013,28109,79,453,214,1175,15,75,229,1250,0.0338707492209728,0.1832
2013,28111,0,140,8,154,0,25,8,179,0.0219416523657759,0.0446927374301676
2013,28113,130,544,61,507,23,23,84,530,0.0205953213647315,0.158490566037736
2013,28115,17,633,33,152,48,48,81,200,0.010270631130283,0.405
2013,28117,38,689,88,154,38,38,126,192,0.0116187594553707,0.65625
2013,28119,14,169,0,102,0,4,0,106,0.020530699205888,0
2013,28121,1345,4726,586,1720,33,160,619,1880,0.0195261785814439,0.329255319148936
2013,28123,40,644,21,151,12,173,33,324,0.017962080053221,0.101851851851852
2013,28125,32,104,0,30,0,0,0,30,0.00938086303939963,0
2013,28127,62,517,29,131,0,7,29,138,0.00775237346216505,0.210144927536232
2013,28129,8,180,40,51,0,23,40,74,0.00686838685724893,0.540540540540541
2013,28131,39,489,69,208,0,0,69,208,0.0180148969340031,0.331730769230769
2013,28133,62,1502,65,247,7,7,72,254,0.0138171136376,0.283464566929134
2013,28135,15,265,32,632,0,13,32,645,0.0631795474581252,0.0496124031007752
2013,28137,58,441,22,220,0,10,22,230,0.0126784631497712,0.0956521739130435
2013,28139,4,414,0,107,0,0,0,107,0.00741407982261641,0
2013,28141,0,223,9,165,0,13,9,178,0.013078618662748,0.050561797752809
2013,28143,81,314,24,179,0,43,24,222,0.0341328413284133,0.108108108108108
2013,28145,52,532,13,97,0,0,13,97,0.00538141470180305,0.134020618556701
2013,28147,85,218,1,63,0,0,1,63,0.00626990445859873,0.0158730158730159
2013,28149,44,497,209,738,20,87,229,825,0.0258466743945612,0.277575757575758
2013,28151,126,519,142,513,18,66,160,579,0.0182592242194891,0.276338514680484
2013,28153,36,139,62,178,0,0,62,178,0.0132440476190476,0.348314606741573
2013,28155,77,236,31,50,0,0,31,50,0.0074019245003701,0.62
2013,28157,1,381,19,83,0,8,19,91,0.0138888888888889,0.208791208791209
2013,28159,110,424,33,171,0,0,33,171,0.0133918082856919,0.192982456140351
2013,28161,7,209,13,22,0,23,13,45,0.00537056928034372,0.288888888888889
2013,28163,52,260,29,616,8,66,37,682,0.0364063417498532,0.0542521994134897
2013,29001,71,366,165,399,9,20,174,419,0.0300854455374453,0.41527446300716
2013,29003,49,366,22,103,12,16,34,119,0.0100303438975051,0.285714285714286
2013,29005,6,56,13,83,0,0,13,83,0.0204938271604938,0.156626506024096
2013,29007,79,1294,48,340,0,9,48,349,0.0201640859718049,0.137535816618911
2013,29009,85,800,34,475,3,115,37,590,0.0242240105107571,0.0627118644067797
2013,29011,7,181,17,180,1,6,18,186,0.0223584565452578,0.0967741935483871
2013,29013,29,296,24,168,0,14,24,182,0.0157398598979504,0.131868131868132
2013,29015,37,434,91,385,0,0,91,385,0.0265425715270596,0.236363636363636
2013,29017,34,258,0,52,0,8,0,60,0.00706630549994111,0
2013,29019,845,2728,1295,2366,432,636,1727,3002,0.0312649711512425,0.575283144570287
2013,29021,290,2775,414,1905,39,162,453,2067,0.0352501790647703,0.219158200290276
2013,29023,103,613,81,497,0,14,81,511,0.0173945603703578,0.158512720156556
2013,29025,27,302,0,67,2,2,2,69,0.0109350237717908,0.0289855072463768
2013,29027,177,1863,88,550,59,97,147,647,0.0220300316660424,0.227202472952087
2013,29029,322,1428,163,840,19,59,182,899,0.0275395172160274,0.202447163515017
2013,29031,222,1510,278,746,49,157,327,903,0.0184984123732459,0.362126245847176
2013,29033,22,90,0,45,0,0,0,45,0.0071349294434755,0
2013,29035,19,127,70,91,0,0,70,91,0.0215946843853821,0.769230769230769
2013,29037,491,2222,292,1212,23,121,315,1333,0.020187181972377,0.236309077269317
2013,29039,2,198,11,75,0,3,11,78,0.00803543834346348,0.141025641025641
2013,29041,34,201,3,6,0,9,3,15,0.00272628135223555,0.2
2013,29043,818,2749,339,1368,4,72,343,1440,0.0279329608938547,0.238194444444444
2013,29045,4,133,0,79,0,15,0,94,0.0194295163290616,0
2013,29047,1343,6199,1214,3705,119,347,1333,4052,0.0271563568125461,0.328973346495558
2013,29049,86,579,63,257,0,6,63,263,0.0186445484191124,0.239543726235741
2013,29051,639,3075,226,646,27,59,253,705,0.0137124851691206,0.35886524822695
2013,29053,59,929,29,173,0,10,29,183,0.0154365246731337,0.158469945355191
2013,29055,164,793,6,92,0,0,6,92,0.00547488693168293,0.0652173913043478
2013,29057,34,301,7,36,0,0,7,36,0.00647249190938511,0.194444444444444
2013,29059,87,339,43,258,6,33,49,291,0.0254281719678434,0.168384879725086
2013,29061,17,174,8,98,0,11,8,109,0.0196679898953446,0.073394495412844
2013,29063,37,1160,38,181,0,2,38,183,0.0192105815662398,0.207650273224044
2013,29065,28,396,4,87,0,0,4,87,0.00801769422173072,0.0459770114942529
2013,29067,71,330,0,155,26,64,26,219,0.0228267667292058,0.118721461187215
2013,29069,23,698,61,664,0,23,61,687,0.032540735126942,0.0887918486171761
2013,29071,166,1487,154,505,10,39,164,544,0.00795461192021992,0.301470588235294
2013,29073,33,375,0,85,0,0,0,85,0.00790036248722,0
2013,29075,49,210,13,82,4,4,17,86,0.0186997173298543,0.197674418604651
2013,29077,1413,5279,1198,4505,210,450,1408,4955,0.0274226575903481,0.284157416750757
2013,29079,45,375,1,108,0,48,1,156,0.0225303292894281,0.00641025641025641
2013,29081,16,101,5,190,0,0,5,190,0.0312038101494498,0.0263157894736842
2013,29083,50,500,25,196,3,3,28,199,0.0127018574072892,0.14070351758794
2013,29085,0,262,3,74,0,3,3,77,0.0105019094380797,0.038961038961039
2013,29087,10,85,19,52,0,10,19,62,0.0176437108708025,0.306451612903226
2013,29089,74,284,24,42,0,0,24,42,0.00638200881325027,0.571428571428571
2013,29091,0,584,82,472,16,57,98,529,0.0195780903034789,0.185255198487713
2013,29093,9,313,0,78,0,5,0,83,0.0112863747620343,0
2013,29095,1853,8194,4632,11734,486,1291,5118,13025,0.0289766407119021,0.392936660268714
2013,29097,298,1787,430,2011,36,70,466,2081,0.0278004141339924,0.223930802498799
2013,29099,1077,4464,347,1489,32,171,379,1660,0.0112903664608102,0.228313253012048
2013,29101,192,1012,210,968,55,277,265,1245,0.0406809567376814,0.21285140562249
2013,29103,22,76,12,95,0,0,12,95,0.0339892665474061,0.126315789473684
2013,29105,116,842,160,484,46,46,206,530,0.022127588510354,0.388679245283019
2013,29107,97,1190,91,243,18,28,109,271,0.0120145415853875,0.402214022140221
2013,29109,177,954,38,314,0,35,38,349,0.0136466724016579,0.108882521489971
2013,29111,39,137,0,157,0,0,0,157,0.0237267643947408,0
2013,29113,211,1099,48,194,17,33,65,227,0.00663626264398059,0.286343612334802
2013,29115,62,306,0,35,0,0,0,35,0.00405797101449275,0
2013,29117,63,447,9,134,0,5,9,139,0.0131342719455731,0.0647482014388489
2013,29119,69,472,21,484,21,30,42,514,0.0350040860800872,0.0817120622568093
2013,29121,20,191,2,75,13,26,15,101,0.00942691805114803,0.148514851485149
2013,29123,29,200,0,196,0,1,0,197,0.0233938962118513,0
2013,29125,12,394,22,102,2,2,24,104,0.0165026975563313,0.230769230769231
2013,29127,104,608,18,207,12,34,30,241,0.0125129802699896,0.12448132780083
2013,29129,18,81,2,21,0,0,2,21,0.00810185185185185,0.0952380952380952
2013,29131,59,548,60,206,0,0,60,206,0.0121620025977093,0.29126213592233
2013,29133,28,603,42,448,0,41,42,489,0.0493192133131619,0.0858895705521472
2013,29135,107,959,22,165,0,2,22,167,0.0159686364505642,0.131736526946108
2013,29137,94,352,49,132,0,22,49,154,0.0250243743906402,0.318181818181818
2013,29139,69,406,6,124,0,9,6,133,0.0156987724268178,0.0451127819548872
2013,29141,68,564,46,170,0,0,46,170,0.0116999311768754,0.270588235294118
2013,29143,78,405,0,119,0,0,0,119,0.00929397063417682,0
2013,29145,325,1732,157,723,21,90,178,813,0.0210485436893204,0.218942189421894
2013,29147,52,668,70,237,35,69,105,306,0.0242953552997221,0.343137254901961
2013,29149,2,229,18,233,0,0,18,233,0.0302872741453269,0.0772532188841202
2013,29151,35,195,3,50,0,0,3,50,0.00546567555749891,0.06
2013,29153,32,159,8,196,0,0,8,196,0.0271618625277162,0.0408163265306122
2013,29155,35,293,91,321,0,13,91,334,0.0288927335640138,0.272455089820359
2013,29157,88,473,36,201,12,12,48,213,0.0166914818587885,0.225352112676056
2013,29159,188,981,148,507,14,59,162,566,0.0203905180488508,0.286219081272085
2013,29161,299,1007,332,545,184,374,516,919,0.0337235330813548,0.561479869423286
2013,29163,75,1065,10,170,0,26,10,196,0.0153532821557261,0.0510204081632653
2013,29165,1037,3201,1044,2837,263,335,1307,3172,0.0517134565848251,0.412042875157629
2013,29167,85,746,32,154,2,17,34,171,0.00862547288776797,0.198830409356725
2013,29169,298,1323,1068,3588,458,1546,1526,5134,0.182231214283179,0.297234125438255
2013,29171,15,112,9,41,0,0,9,41,0.0117545871559633,0.219512195121951
2013,29173,30,216,15,45,10,10,25,55,0.00761245674740484,0.454545454545455
2013,29175,60,1344,15,322,11,22,26,344,0.0201157827027659,0.0755813953488372
2013,29177,31,504,4,36,0,0,4,36,0.00227430665234696,0.111111111111111
2013,29179,7,79,3,48,0,0,3,48,0.010090393104898,0.0625
2013,29181,11,144,44,241,0,3,44,244,0.0252300692792886,0.180327868852459
2013,29183,2395,6893,1685,3512,404,612,2089,4124,0.0171013891768609,0.506547041707081
2013,29185,22,285,21,236,0,7,21,243,0.0342253521126761,0.0864197530864197
2013,29186,97,466,0,29,7,7,7,36,0.00289668490505311,0.194444444444444
2013,29187,325,3537,135,514,0,159,135,673,0.014768812131054,0.200594353640416
2013,29189,5227,17119,7122,12203,1659,2616,8781,14819,0.0217443936910591,0.592550104595452
2013,29195,93,364,23,159,12,60,35,219,0.0143090493302842,0.159817351598174
2013,29197,14,103,9,44,0,0,9,44,0.0150943396226415,0.204545454545455
2013,29199,20,77,0,139,0,0,0,139,0.0448531784446596,0
2013,29201,114,585,9,338,59,65,68,403,0.0153605732581186,0.168734491315136
2013,29203,4,122,7,42,0,0,7,42,0.0073943661971831,0.166666666666667
2013,29205,5,108,2,45,2,5,4,50,0.0115420129270545,0.08
2013,29207,89,615,27,259,0,0,27,259,0.0125229668310608,0.104247104247104
2013,29209,142,928,80,787,6,39,86,826,0.0343165766514333,0.104116222760291
2013,29211,25,193,23,133,0,0,23,133,0.0291028446389497,0.172932330827068
2013,29213,245,1422,372,1918,46,111,418,2029,0.0566158825827334,0.206012814194184
2013,29215,21,653,65,498,0,52,65,550,0.0307726738656073,0.118181818181818
2013,29217,21,312,59,262,3,34,62,296,0.021239954075775,0.209459459459459
2013,29219,81,793,25,417,5,33,30,450,0.0202401835109972,0.0666666666666667
2013,29221,96,791,60,131,0,16,60,147,0.00853311661926046,0.408163265306122
2013,29223,10,236,6,116,7,7,13,123,0.0127329192546584,0.105691056910569
2013,29225,106,1352,22,278,0,0,22,278,0.0118343195266272,0.079136690647482
2013,29227,0,6,7,15,0,0,7,15,0.0099272005294507,0.466666666666667
2013,29229,139,492,33,283,0,0,33,283,0.0227711618925008,0.11660777385159
2013,29510,3135,9733,3366,6269,627,1264,3993,7533,0.0350038335540531,0.530067702110713
2013,30001,27,202,22,196,0,9,22,205,0.0328525641025641,0.107317073170732
2013,30003,27,77,8,90,3,19,11,109,0.0150698188856629,0.100917431192661
2013,30005,18,122,0,51,0,18,0,69,0.0171855541718555,0
2013,30007,62,182,50,211,0,6,50,217,0.0543043043043043,0.230414746543779
2013,30009,21,136,120,241,0,6,120,247,0.032312925170068,0.48582995951417
2013,30011,1,15,0,18,0,0,0,18,0.0190274841437632,0
2013,30013,218,1173,455,1989,64,261,519,2250,0.041023957991467,0.230666666666667
2013,30015,12,72,22,33,0,3,22,36,0.0093921210540047,0.611111111111111
2013,30017,25,263,62,317,0,3,62,320,0.0391916717697489,0.19375
2013,30019,0,2,41,53,0,0,41,53,0.0394052044609665,0.773584905660377
2013,30021,19,166,13,176,0,8,13,184,0.0286783042394015,0.0706521739130435
2013,30023,76,230,42,158,0,0,42,158,0.0234630234630235,0.265822784810127
2013,30025,3,63,28,104,0,0,28,104,0.0499759730898606,0.269230769230769
2013,30027,84,317,39,111,0,2,39,113,0.0131380072084641,0.345132743362832
2013,30029,131,354,439,1670,32,96,471,1766,0.0278803953143254,0.266704416761042
2013,30031,412,1263,1386,2382,164,205,1550,2587,0.0449803526097994,0.599149594124468
2013,30033,7,7,8,9,0,0,8,9,0.0111801242236025,0.888888888888889
2013,30035,34,186,95,209,0,0,95,209,0.0268464996788696,0.454545454545455
2013,30037,2,26,1,1,0,13,1,14,0.025830258302583,0.0714285714285714
2013,30039,7,126,35,74,0,0,35,74,0.0298989898989899,0.472972972972973
2013,30041,49,287,4,89,21,26,25,115,0.0112955505353109,0.217391304347826
2013,30043,71,406,93,297,0,0,93,297,0.0361621819067332,0.313131313131313
2013,30045,4,55,19,36,0,2,19,38,0.0240202275600506,0.5
2013,30047,110,611,159,469,0,23,159,492,0.0253725955340106,0.323170731707317
2013,30049,438,1085,437,851,39,115,476,966,0.0217881631180079,0.492753623188406
2013,30051,0,19,14,28,15,15,29,43,0.0251903925014646,0.674418604651163
2013,30053,80,145,69,357,30,42,99,399,0.0271207177814029,0.24812030075188
2013,30055,9,29,0,7,0,0,0,7,0.00522778192681105,0
2013,30057,78,150,37,132,0,4,37,136,0.023019634394042,0.272058823529412
2013,30059,4,68,8,40,0,0,8,40,0.0294985250737463,0.2
2013,30061,0,67,23,55,0,0,23,55,0.0173830594184576,0.418181818181818
2013,30063,685,1967,946,2179,189,396,1135,2575,0.0359677058889261,0.440776699029126
2013,30065,0,140,5,19,0,3,5,22,0.00642335766423358,0.227272727272727
2013,30067,47,105,43,350,83,85,126,435,0.0372750642673522,0.289655172413793
2013,30069,0,8,0,20,0,0,0,20,0.0503778337531486,0
2013,30071,0,37,4,15,0,19,4,34,0.0112137203166227,0.117647058823529
2013,30073,12,135,8,63,7,17,15,80,0.0193050193050193,0.1875
2013,30075,1,49,8,37,0,0,8,37,0.0291568163908589,0.216216216216216
2013,30077,100,565,18,121,0,0,18,121,0.0223082595870206,0.148760330578512
2013,30079,15,35,0,0,0,0,0,0,0,NA
2013,30081,176,651,145,847,4,60,149,907,0.0310808032348708,0.164277839029768
2013,30083,77,270,88,363,0,0,88,363,0.0515405367031095,0.242424242424242
2013,30085,7,43,25,124,0,0,25,124,0.0200647249190939,0.201612903225806
2013,30087,44,154,42,68,0,7,42,75,0.0128711172129741,0.56
2013,30089,8,83,60,219,0,0,60,219,0.0257829055804097,0.273972602739726
2013,30091,4,17,9,46,0,18,9,64,0.0248930377285103,0.140625
2013,30093,211,900,255,649,58,75,313,724,0.0309309181014226,0.43232044198895
2013,30095,40,151,39,100,0,7,39,107,0.0160107736046686,0.364485981308411
2013,30097,17,35,1,34,0,0,1,34,0.0132657042528287,0.0294117647058824
2013,30099,15,139,14,29,4,6,18,35,0.00829187396351575,0.514285714285714
2013,30101,11,368,82,172,0,1,82,173,0.0459861775651249,0.473988439306358
2013,30103,0,0,16,19,0,0,16,19,0.0339285714285714,0.842105263157895
2013,30105,19,43,1,43,0,0,1,43,0.00810708898944193,0.0232558139534884
2013,30107,0,28,2,18,0,0,2,18,0.0119284294234592,0.111111111111111
2013,30109,0,0,3,13,0,0,3,13,0.0185714285714286,0.230769230769231
2013,30111,568,2912,836,2818,108,236,944,3054,0.0300525476766842,0.309102815979044
2013,31001,97,597,143,390,0,33,143,423,0.0209946396664681,0.33806146572104
2013,31003,49,124,5,36,0,2,5,38,0.00816677412422093,0.131578947368421
2013,31005,13,26,0,0,0,0,0,0,0,NA
2013,31007,0,23,7,31,0,6,7,37,0.0634648370497427,0.189189189189189
2013,31009,5,18,5,8,0,0,5,8,0.0203045685279188,0.625
2013,31011,20,81,3,20,0,2,3,22,0.0058078141499472,0.136363636363636
2013,31013,34,133,28,278,25,25,53,303,0.0402390438247012,0.174917491749175
2013,31015,7,20,0,5,0,3,0,8,0.00521172638436482,0
2013,31017,8,45,0,11,0,0,0,11,0.00480769230769231,0
2013,31019,308,1111,207,443,0,59,207,502,0.0178934236321511,0.412350597609562
2013,31021,17,96,31,61,0,0,31,61,0.0125695446115805,0.508196721311475
2013,31023,25,259,33,85,6,10,39,95,0.0164388302474477,0.410526315789474
2013,31025,127,462,97,261,0,32,97,293,0.0170517371820986,0.331058020477816
2013,31027,43,198,3,84,3,7,6,91,0.0151869158878505,0.0659340659340659
2013,31029,7,22,44,91,0,32,44,123,0.0437722419928826,0.357723577235772
2013,31031,36,72,32,80,0,16,32,96,0.02321083172147,0.333333333333333
2013,31033,7,85,34,231,41,98,75,329,0.0473995101570379,0.227963525835866
2013,31035,13,119,16,56,0,2,16,58,0.0131281122679946,0.275862068965517
2013,31037,14,132,17,164,4,75,21,239,0.0365108463183624,0.0878661087866109
2013,31039,11,92,17,78,0,8,17,86,0.0139406710974226,0.197674418604651
2013,31041,26,142,22,67,16,17,38,84,0.0110135046545168,0.452380952380952
2013,31043,14,89,65,323,10,74,75,397,0.0311470265181233,0.188916876574307
2013,31045,12,118,154,220,0,0,154,220,0.0393841747225206,0.7
2013,31047,78,426,75,379,4,25,79,404,0.0263707571801567,0.195544554455446
2013,31049,15,32,16,38,0,4,16,42,0.02945301542777,0.380952380952381
2013,31051,4,88,14,84,0,5,14,89,0.0219698839792644,0.157303370786517
2013,31053,213,754,43,249,0,38,43,287,0.0114424687026553,0.149825783972125
2013,31055,2215,6336,3377,8305,946,1787,4323,10092,0.0299963440841039,0.428359096313912
2013,31057,8,19,0,28,0,0,0,28,0.019047619047619,0
2013,31059,15,124,4,16,4,6,8,22,0.00531144374698213,0.363636363636364
2013,31061,21,87,7,75,0,0,7,75,0.0321750321750322,0.0933333333333333
2013,31063,8,46,14,21,0,5,14,26,0.0147811256395679,0.538461538461538
2013,31065,25,132,17,95,0,5,17,100,0.0284981476204047,0.17
2013,31067,152,495,29,273,0,14,29,287,0.0186182289977295,0.101045296167247
2013,31069,10,40,13,67,0,6,13,73,0.0469151670951157,0.178082191780822
2013,31071,1,50,11,19,0,0,11,19,0.0130763936682725,0.578947368421053
2013,31073,2,52,0,5,0,0,0,5,0.00363901018922853,0
2013,31075,0,4,0,6,0,0,0,6,0.0147420147420147,0
2013,31077,21,73,1,20,0,0,1,20,0.0114678899082569,0.05
2013,31079,194,984,42,948,23,86,65,1034,0.0270652287718563,0.062862669245648
2013,31081,5,120,44,55,0,0,44,55,0.00885383129426916,0.8
2013,31083,5,94,19,63,0,0,19,63,0.0245327102803738,0.301587301587302
2013,31085,0,14,0,19,0,0,0,19,0.0240202275600506,0
2013,31087,14,44,0,32,0,0,0,32,0.0151085930122757,0
2013,31089,13,142,46,163,0,5,46,168,0.022869588891914,0.273809523809524
2013,31091,2,4,8,8,0,3,8,11,0.0208728652751423,0.727272727272727
2013,31093,10,146,5,38,0,4,5,42,0.00953461975028377,0.119047619047619
2013,31095,25,144,3,61,0,19,3,80,0.0146466495789088,0.0375
2013,31097,21,274,4,33,0,13,4,46,0.0119325551232166,0.0869565217391304
2013,31099,34,269,71,93,0,0,71,93,0.0204981265153185,0.763440860215054
2013,31101,112,224,53,332,0,1,53,333,0.0543851053405194,0.159159159159159
2013,31103,0,0,0,11,0,0,0,11,0.0191304347826087,0
2013,31105,37,84,2,74,0,0,2,74,0.0276222471071295,0.027027027027027
2013,31107,42,109,2,96,0,9,2,105,0.0172839506172839,0.019047619047619
2013,31109,818,3584,1694,4054,516,1049,2210,5103,0.0284095021238928,0.433078581226729
2013,31111,167,376,43,482,11,21,54,503,0.020565027188356,0.107355864811133
2013,31113,2,26,3,3,0,0,3,3,0.00556586270871985,1
2013,31115,3,20,0,14,0,0,0,14,0.0339805825242718,0
2013,31117,1,9,1,2,3,3,4,5,0.0175438596491228,0.8
2013,31119,137,634,171,526,0,17,171,543,0.0240318654569595,0.314917127071823
2013,31121,36,233,5,65,0,14,5,79,0.0146486185796403,0.0632911392405063
2013,31123,5,78,16,63,0,0,16,63,0.0182714617169374,0.253968253968254
2013,31125,8,72,4,33,3,7,7,40,0.0153080750095675,0.175
2013,31127,65,147,8,109,0,0,8,109,0.0231520815632965,0.073394495412844
2013,31129,45,91,11,65,5,5,16,70,0.0209643605870021,0.228571428571429
2013,31131,194,519,17,119,2,21,19,140,0.012987012987013,0.135714285714286
2013,31133,10,61,0,18,0,3,0,21,0.0103092783505155,0
2013,31135,7,74,18,40,0,0,18,40,0.0191570881226054,0.45
2013,31137,33,171,84,198,8,24,92,222,0.0349992117294656,0.414414414414414
2013,31139,28,159,16,58,0,3,16,61,0.0124413624311646,0.262295081967213
2013,31141,182,477,11,289,0,38,11,327,0.0155632763790396,0.0336391437308868
2013,31143,15,132,10,17,0,6,10,23,0.00609756097560976,0.434782608695652
2013,31145,31,134,9,119,0,0,9,119,0.0159989244420543,0.0756302521008403
2013,31147,49,60,8,162,0,0,8,162,0.0268300761841669,0.0493827160493827
2013,31149,0,20,4,42,3,3,7,45,0.0416666666666667,0.155555555555556
2013,31151,40,249,0,43,0,27,0,70,0.00799360511590727,0
2013,31153,1103,4451,1275,2975,159,565,1434,3540,0.0347212005296454,0.405084745762712
2013,31155,97,579,55,154,8,20,63,174,0.0123535676251331,0.362068965517241
2013,31157,140,435,197,943,7,27,204,970,0.0393493164577502,0.210309278350515
2013,31159,115,450,57,162,0,23,57,185,0.0174363807728558,0.308108108108108
2013,31161,34,109,19,89,0,0,19,89,0.0229086229086229,0.213483146067416
2013,31163,15,38,0,15,0,5,0,20,0.00880281690140845,0
2013,31165,5,10,0,14,0,0,0,14,0.0150862068965517,0
2013,31167,28,197,8,20,0,3,8,23,0.00565527415785591,0.347826086956522
2013,31169,35,104,0,36,0,0,0,36,0.00937011972930765,0
2013,31171,3,9,0,0,0,0,0,0,0,NA
2013,31173,27,79,21,84,0,0,21,84,0.0223582645727974,0.25
2013,31175,27,57,0,42,0,0,0,42,0.0137120470127326,0
2013,31177,71,374,77,264,0,0,77,264,0.0194992244626634,0.291666666666667
2013,31179,65,230,72,150,0,0,72,150,0.0288295214299443,0.48
2013,31181,7,73,6,62,0,0,6,62,0.0229970326409496,0.0967741935483871
2013,31183,4,12,0,2,0,0,0,2,0.00333889816360601,0
2013,31185,46,469,14,136,2,11,16,147,0.015780998389694,0.108843537414966
2013,32001,0,435,246,890,36,95,282,985,0.060407212069177,0.286294416243655
2013,32003,543,2984,14609,53753,2786,8418,17395,62171,0.0475320360158137,0.279792829454247
2013,32005,129,538,274,1178,0,16,274,1194,0.0343251401466149,0.229480737018425
2013,32007,84,424,132,1255,26,26,158,1281,0.0415828085437902,0.123341139734582
2013,32009,10,30,0,45,0,0,0,45,0.0607287449392713,0
2013,32011,9,14,33,53,0,0,33,53,0.0435855263157895,0.622641509433962
2013,32013,55,421,74,427,13,56,87,483,0.0450559701492537,0.180124223602484
2013,32015,0,78,19,166,0,0,19,166,0.0453304205352267,0.114457831325301
2013,32017,34,286,45,63,0,3,45,66,0.019873532068654,0.681818181818182
2013,32019,109,1728,262,1298,37,73,299,1371,0.0386240703177823,0.218088986141503
2013,32021,4,94,17,130,0,0,17,130,0.0367959241437871,0.130769230769231
2013,32023,99,1274,256,1226,0,57,256,1283,0.0400899915632909,0.199532346063913
2013,32027,19,683,6,163,0,2,6,165,0.0328750747160789,0.0363636363636364
2013,32029,71,157,8,110,0,0,8,110,0.0340136054421769,0.0727272727272727
2013,32031,656,3477,3329,10941,681,1476,4010,12417,0.0439211774568375,0.322944350487235
2013,32033,13,212,44,177,0,5,44,182,0.0263806348746195,0.241758241758242
2013,32510,285,2325,253,1304,8,50,261,1354,0.0351450968177335,0.192762186115214
2013,33001,326,1024,439,858,40,117,479,975,0.0223854896108369,0.491282051282051
2013,33003,232,578,396,1102,7,27,403,1129,0.0311887068703555,0.356953055801594
2013,33005,139,579,680,1682,78,169,758,1851,0.0357218673408341,0.409508373851972
2013,33007,134,565,157,542,0,11,157,553,0.0226009481772111,0.283905967450271
2013,33009,303,999,1442,2361,333,462,1775,2823,0.0465626443227552,0.628763726532058
2013,33011,995,3974,3084,6983,614,1465,3698,8448,0.0307243572724859,0.437736742424242
2013,33013,999,3510,855,1751,78,209,933,1960,0.0192062714355708,0.476020408163265
2013,33015,787,2888,3152,5848,241,463,3393,6311,0.030245520202819,0.537632704801141
2013,33017,503,2096,762,2097,228,347,990,2444,0.0307909390984453,0.405073649754501
2013,33019,357,1004,255,503,8,24,263,527,0.0167407878017789,0.499051233396584
2013,34001,889,2923,747,2565,361,1263,1108,3828,0.0205763307693548,0.28944618599791
2013,34003,4705,9085,5821,9711,2722,4406,8543,14117,0.0220687434244774,0.605156903024722
2013,34005,2025,6135,2125,5368,651,1515,2776,6883,0.0222650652295569,0.403312509080343
2013,34007,1730,6899,2263,5342,272,1254,2535,6596,0.0191780423626557,0.384323832625834
2013,34009,475,1149,768,1561,70,308,838,1869,0.0263536379018613,0.44836811128946
2013,34011,423,3981,153,1121,49,527,202,1648,0.0157136455085481,0.122572815533981
2013,34013,3386,8495,3549,7304,1131,3008,4680,10312,0.0199186795568905,0.453840186190846
2013,34015,944,4133,827,1759,89,472,916,2231,0.0115606636888414,0.410578216046616
2013,34017,4448,8071,8449,11711,3842,6305,12291,18016,0.0400408943414678,0.682226909413854
2013,34019,1123,2425,752,1279,143,158,895,1437,0.0162415090927586,0.622825330549756
2013,34021,2766,6430,2200,4237,1223,2188,3423,6425,0.026216143431887,0.532762645914397
2013,34023,6129,11968,4299,7236,3193,5122,7492,12358,0.0224889220494436,0.606246965528403
2013,34025,3865,7903,2591,5870,740,1475,3331,7345,0.0169949188778957,0.453505786249149
2013,34027,4326,7944,2755,4577,981,1642,3736,6219,0.0181518344473308,0.600739668757035
2013,34029,2303,7863,1322,4509,397,1333,1719,5842,0.0146183026554164,0.294248545018829
2013,34031,1774,4907,1004,2360,300,1574,1304,3934,0.0120367282373567,0.331469242501271
2013,34033,179,1115,116,734,27,180,143,914,0.0202463228779018,0.156455142231947
2013,34035,3306,6170,1585,2374,848,1401,2433,3775,0.0168571938912209,0.644503311258278
2013,34037,620,2051,521,1372,104,290,625,1662,0.0162799126252584,0.376052948255114
2013,34039,3623,8898,1815,4227,459,1846,2274,6073,0.0167473746911401,0.374444261485263
2013,34041,479,1818,262,1010,75,328,337,1338,0.0179858049252608,0.25186846038864
2013,35001,1956,7308,5456,12040,1081,2434,6537,14474,0.0328071734242402,0.451637418819953
2013,35003,5,111,11,71,1,1,12,72,0.0236920039486673,0.166666666666667
2013,35005,294,945,267,1230,36,204,303,1434,0.0352533372667601,0.211297071129707
2013,35006,155,799,82,317,0,105,82,422,0.0234145258835932,0.194312796208531
2013,35007,69,404,78,232,24,26,102,258,0.0262729124236253,0.395348837209302
2013,35009,49,328,475,1407,62,197,537,1604,0.0538978494623656,0.334788029925187
2013,35011,0,20,41,57,0,0,41,57,0.0423791821561338,0.719298245614035
2013,35013,381,2240,1158,3270,289,750,1447,4020,0.0318862881029245,0.359950248756219
2013,35015,148,567,281,1032,16,68,297,1100,0.0311977083865112,0.27
2013,35017,75,213,128,616,43,43,171,659,0.031881954523464,0.25948406676783
2013,35019,11,322,0,25,0,0,0,25,0.00779058896852602,0
2013,35021,0,10,14,31,0,1,14,32,0.0595903165735568,0.4375
2013,35023,12,60,42,67,0,18,42,85,0.0261618959679902,0.494117647058824
2013,35025,107,789,291,1117,12,206,303,1323,0.0333014498590415,0.229024943310658
2013,35027,250,491,61,590,0,19,61,609,0.0398455901596441,0.100164203612479
2013,35028,122,272,499,657,34,47,533,704,0.0552850636092351,0.757102272727273
2013,35029,70,282,162,576,4,116,166,692,0.0428854734754586,0.239884393063584
2013,35031,23,305,175,692,43,83,218,775,0.0186796500277182,0.281290322580645
2013,35033,0,81,0,94,0,0,0,94,0.0267729991455426,0
2013,35035,292,1047,318,1662,85,716,403,2378,0.0572763620598295,0.169470142977292
2013,35037,20,104,5,172,0,2,5,174,0.0281234847260385,0.028735632183908
2013,35039,48,595,25,268,33,78,58,346,0.012868193989884,0.167630057803468
2013,35041,56,320,76,327,16,49,92,376,0.0332331624535973,0.24468085106383
2013,35043,627,2358,1007,2447,206,346,1213,2793,0.0317350301102148,0.434300035803795
2013,35045,163,707,436,1928,20,177,456,2105,0.0265126706635095,0.216627078384798
2013,35047,65,275,96,212,0,37,96,249,0.0126749809111733,0.385542168674699
2013,35049,627,2205,1825,3427,192,697,2017,4124,0.0395405472779919,0.489088263821532
2013,35051,0,286,46,118,0,2,46,120,0.0127945409958418,0.383333333333333
2013,35053,20,128,15,81,0,0,15,81,0.00737369139736004,0.185185185185185
2013,35055,99,428,377,723,3,18,380,741,0.0307762595007684,0.512820512820513
2013,35057,40,546,56,407,0,235,56,642,0.0581996192548273,0.0872274143302181
2013,35059,9,248,12,212,0,0,12,212,0.0677532758069671,0.0566037735849057
2013,35061,66,1873,147,719,43,100,190,819,0.0164971296203042,0.231990231990232
2013,36001,2331,5827,1478,2832,613,1136,2091,3968,0.0195052892366983,0.526965725806452
2013,36003,79,530,128,345,24,46,152,391,0.0127898989238167,0.388746803069054
2013,36005,4457,23637,1809,7389,1901,9228,3710,16617,0.0191683450648173,0.223265330685443
2013,36007,504,2052,653,1600,123,343,776,1943,0.0146347709503939,0.399382398353062
2013,36009,222,1204,211,583,34,92,245,675,0.0125930486371523,0.362962962962963
2013,36011,293,1829,237,553,74,86,311,639,0.0114690837296958,0.486697965571205
2013,36013,180,1387,275,1234,78,287,353,1521,0.0168608453701959,0.232084155161078
2013,36015,304,1702,514,1319,18,41,532,1360,0.0223144699493002,0.391176470588235
2013,36017,149,659,124,351,12,29,136,380,0.0108265192740534,0.357894736842105
2013,36019,87,2317,83,558,45,222,128,780,0.0140573467659091,0.164102564102564
2013,36021,367,1216,103,396,29,92,132,488,0.010756006171479,0.270491803278689
2013,36023,146,546,120,256,28,30,148,286,0.00941222931613243,0.517482517482518
2013,36025,255,1154,55,358,30,42,85,400,0.011920727164357,0.2125
2013,36027,1157,5650,1037,2001,447,907,1484,2908,0.0145140199043712,0.510316368638239
2013,36029,2359,7002,2887,6155,1124,2695,4011,8850,0.0141080597671612,0.453220338983051
2013,36031,261,1402,281,669,71,110,352,779,0.0269279961284524,0.45186136071887
2013,36033,214,2710,89,357,16,69,105,426,0.0118146268408353,0.246478873239437
2013,36035,262,1471,119,369,29,69,148,438,0.0112837158976737,0.337899543378995
2013,36037,285,1336,62,350,4,47,66,397,0.00958381614522982,0.16624685138539
2013,36039,192,1375,98,365,15,24,113,389,0.0111012813561257,0.290488431876607
2013,36041,0,72,19,85,0,0,19,85,0.0227637921799679,0.223529411764706
2013,36043,189,1156,76,324,3,20,79,344,0.00770143506391743,0.229651162790698
2013,36045,344,1771,1404,4062,309,1941,1713,6003,0.0820160397852254,0.28535732133933
2013,36047,14850,27969,10996,17903,5533,14541,16529,32444,0.0193050216024168,0.509462458389841
2013,36049,110,338,35,137,9,91,44,228,0.0124149196841819,0.192982456140351
2013,36051,448,1899,148,309,0,44,148,353,0.00830529609674611,0.419263456090652
2013,36053,259,1253,164,621,82,123,246,744,0.0157094594594595,0.330645161290323
2013,36055,2134,6505,2388,5350,1461,2879,3849,8229,0.0165680449545884,0.467736055413781
2013,36057,191,1100,18,149,24,77,42,226,0.00659315012544489,0.185840707964602
2013,36059,8258,16670,2379,4988,1623,3818,4002,8806,0.00956686211051105,0.454462866227572
2013,36061,15134,27367,29075,34955,13638,18672,42713,53627,0.0447383415604318,0.796483114848863
2013,36063,939,3284,361,1173,45,110,406,1283,0.00856521042512284,0.316445830085737
2013,36065,704,4770,394,1273,207,538,601,1811,0.0113186085173935,0.331860850358918
2013,36067,1704,5156,1887,4074,867,1619,2754,5693,0.0183598373317767,0.483751976111014
2013,36069,1111,2744,325,685,49,166,374,851,0.0114294156358704,0.439482961222092
2013,36071,1603,4532,1479,3470,166,572,1645,4042,0.0171465901956459,0.406976744186047
2013,36073,150,1801,41,297,0,45,41,342,0.011607779248549,0.119883040935673
2013,36075,191,1562,166,687,20,78,186,765,0.00963585293043292,0.243137254901961
2013,36077,301,1020,178,453,29,39,207,492,0.01222633632365,0.420731707317073
2013,36079,932,2384,327,636,101,146,428,782,0.0113192253133775,0.547314578005115
2013,36081,11842,28986,6524,12734,5280,14657,11804,27391,0.017371203160822,0.43094447081158
2013,36083,1614,4492,500,1097,166,229,666,1326,0.0122855131008413,0.502262443438914
2013,36085,1495,4683,940,1703,222,727,1162,2430,0.00764352847922093,0.478189300411523
2013,36087,1234,2927,954,1684,337,916,1291,2600,0.0130917733310507,0.496538461538462
2013,36089,266,2028,397,1120,30,186,427,1306,0.0182562869564002,0.326952526799387
2013,36091,1555,4173,1521,2425,462,758,1983,3183,0.0206563568753934,0.622997172478794
2013,36093,794,2962,409,1015,148,264,557,1279,0.0121442881965874,0.435496481626271
2013,36095,91,562,19,176,10,30,29,206,0.00921865210775978,0.140776699029126
2013,36097,39,383,15,241,0,45,15,286,0.0217160212604404,0.0524475524475524
2013,36099,206,1760,68,331,3,8,71,339,0.013659991135109,0.209439528023599
2013,36101,404,1817,210,632,49,70,259,702,0.0102789369646387,0.368945868945869
2013,36103,4710,11330,2762,5775,1352,2998,4114,8773,0.00867088301078202,0.468938789467685
2013,36105,397,2249,138,798,30,158,168,956,0.017878181512165,0.175732217573222
2013,36107,293,687,119,588,2,32,121,620,0.0175418741511996,0.195161290322581
2013,36109,873,1849,1469,1983,1000,1204,2469,3187,0.0547237199079639,0.774709758393473
2013,36111,843,3676,553,1260,20,249,573,1509,0.0117958819942779,0.379721669980119
2013,36113,310,1432,271,671,41,113,312,784,0.0165634969260347,0.397959183673469
2013,36115,270,2249,153,634,15,55,168,689,0.015398368532797,0.243831640058055
2013,36117,645,2019,91,617,2,130,93,747,0.0116282689912827,0.124497991967871
2013,36119,6701,12732,3996,6413,2068,4330,6064,10743,0.0165300828119759,0.564460578981662
2013,36121,141,2080,30,198,0,34,30,232,0.00771815429655012,0.129310344827586
2013,36123,129,520,70,241,3,28,73,269,0.0163436417765356,0.271375464684015
2013,37001,604,1910,367,1270,210,768,577,2038,0.0201700299878267,0.283120706575074
2013,37003,50,637,22,275,0,33,22,308,0.0118730966423808,0.0714285714285714
2013,37005,0,62,13,133,0,0,13,133,0.0165464045782533,0.0977443609022556
2013,37007,92,972,12,229,0,0,12,229,0.0124727668845316,0.0524017467248908
2013,37009,95,526,33,111,2,66,35,177,0.00882133067530526,0.19774011299435
2013,37011,103,813,30,275,0,16,30,291,0.0223553814242913,0.103092783505155
2013,37013,148,532,181,575,10,54,191,629,0.018715781956677,0.303656597774245
2013,37015,32,684,0,80,0,2,0,82,0.00559765171684074,0
2013,37017,31,417,0,102,0,23,0,125,0.00521855299962426,0
2013,37019,841,2366,1217,2942,60,178,1277,3120,0.0374531835205993,0.409294871794872
2013,37021,1673,4487,2612,5791,158,395,2770,6186,0.0359254312097102,0.447785321694148
2013,37023,269,1860,196,789,3,43,199,832,0.0133220181576546,0.239182692307692
2013,37025,853,3862,577,2495,77,327,654,2822,0.0238852964078952,0.231750531537916
2013,37027,129,1548,147,569,0,43,147,612,0.0107169124085035,0.240196078431373
2013,37029,85,295,12,219,14,14,26,233,0.0345697329376855,0.111587982832618
2013,37031,372,1498,466,1211,94,329,560,1540,0.0310258683213796,0.363636363636364
2013,37033,44,1095,41,213,0,26,41,239,0.0140886583352983,0.171548117154812
2013,37035,524,2784,364,1281,7,81,371,1362,0.0129483681443524,0.272393538913363
2013,37037,491,1159,779,1240,101,118,880,1358,0.028809639985574,0.648011782032401
2013,37039,170,290,92,612,0,0,92,612,0.029972084822959,0.150326797385621
2013,37041,181,321,7,227,0,0,7,227,0.0219599496952694,0.0308370044052863
2013,37043,38,164,0,78,0,0,0,78,0.00999103368771615,0
2013,37045,190,1596,188,978,22,61,210,1039,0.015754598250163,0.202117420596728
2013,37047,163,1667,28,461,12,101,40,562,0.014269029604428,0.0711743772241993
2013,37049,384,2065,679,2398,133,675,812,3073,0.0459246196610575,0.264236902050114
2013,37051,1027,4204,2734,9830,866,3611,3600,13441,0.0687733768592758,0.267837214492969
2013,37053,16,108,104,473,26,57,130,530,0.0318241863816501,0.245283018867925
2013,37055,270,585,459,967,50,53,509,1020,0.0403896412449513,0.499019607843137
2013,37057,545,2679,290,963,11,95,301,1058,0.00942253571301343,0.284499054820416
2013,37059,222,824,91,241,15,36,106,277,0.00957417392506567,0.382671480144404
2013,37061,78,1722,81,485,0,128,81,613,0.0156705353034409,0.132137030995106
2013,37063,4026,8429,3710,6712,1243,1991,4953,8703,0.0474575346947678,0.569114098586694
2013,37065,115,1750,42,620,24,80,66,700,0.0186706497386109,0.0942857142857143
2013,37067,1669,5884,1871,3910,394,624,2265,4534,0.0194129862345058,0.499558888398765
2013,37069,294,1595,94,262,0,44,94,306,0.00739881038734949,0.30718954248366
2013,37071,577,3448,321,1434,75,330,396,1764,0.0125858858280357,0.224489795918367
2013,37073,0,83,33,191,0,13,33,204,0.0246883698414619,0.161764705882353
2013,37075,45,94,17,120,0,1,17,121,0.0201935914552737,0.140495867768595
2013,37077,298,1611,210,681,70,145,280,826,0.0208559525312461,0.338983050847458
2013,37079,24,1141,0,140,0,35,0,175,0.0119551851345812,0
2013,37081,1986,6680,2421,6247,740,1442,3161,7689,0.0237561174551387,0.411106775913643
2013,37083,129,977,88,558,16,28,104,586,0.0157743142480282,0.177474402730375
2013,37085,699,3346,761,2205,132,489,893,2694,0.0364739172228917,0.331477357089829
2013,37087,346,1138,348,1211,17,20,365,1231,0.028332067481415,0.296506904955321
2013,37089,410,2044,916,2242,37,246,953,2488,0.0315804170950586,0.383038585209003
2013,37091,63,436,187,1161,3,23,190,1184,0.0698154372309688,0.160472972972973
2013,37093,382,2313,308,958,144,532,452,1490,0.049881155635901,0.303355704697987
2013,37095,25,379,0,20,0,8,0,28,0.00670980110232447,0
2013,37097,701,2370,877,2868,217,468,1094,3336,0.0308908910762735,0.327937649880096
2013,37099,125,769,190,483,17,68,207,551,0.0216426411092345,0.37568058076225
2013,37101,487,4078,254,1739,76,159,330,1898,0.0169765923381723,0.173867228661749
2013,37103,27,383,2,37,0,0,2,37,0.00512394405207035,0.0540540540540541
2013,37105,152,1187,293,717,60,60,353,777,0.0201118186053735,0.454311454311454
2013,37107,118,916,28,380,26,77,54,457,0.0113261790874619,0.118161925601751
2013,37109,342,1601,320,1091,0,110,320,1201,0.022023765862246,0.266444629475437
2013,37111,88,910,73,262,23,89,96,351,0.0110380829585836,0.273504273504274
2013,37113,31,137,244,990,30,54,274,1044,0.0414006424237617,0.262452107279693
2013,37115,105,438,76,257,5,39,81,296,0.0202698075737862,0.273648648648649
2013,37117,34,346,16,125,0,18,16,143,0.00841919340594642,0.111888111888112
2013,37119,4324,11272,10899,22912,2551,4481,13450,27393,0.0442763810810723,0.491001350710035
2013,37121,77,287,16,81,0,32,16,113,0.0100124047492469,0.141592920353982
2013,37123,31,664,11,66,12,12,23,78,0.00414144632048423,0.294871794871795
2013,37125,346,1292,1004,1993,134,307,1138,2300,0.0356600204657509,0.494782608695652
2013,37127,346,2406,80,642,0,64,80,706,0.0108938849198389,0.113314447592068
2013,37129,1699,4931,1211,3432,260,635,1471,4067,0.0292686788433582,0.361691664617654
2013,37131,65,699,54,340,0,6,54,346,0.0224078751376206,0.15606936416185
2013,37133,247,2117,1540,6598,283,1712,1823,8310,0.0885059429983385,0.219374247894103
2013,37135,1691,3709,1849,2805,857,1162,2706,3967,0.0481677554093106,0.682127552306529
2013,37137,70,532,13,62,2,25,15,87,0.00884146341463415,0.172413793103448
2013,37139,103,1148,168,868,0,56,168,924,0.0350398179749716,0.181818181818182
2013,37141,257,2106,271,1023,44,89,315,1112,0.0299770858606281,0.283273381294964
2013,37143,1,223,84,199,0,0,84,199,0.0202565146579805,0.422110552763819
2013,37145,89,476,59,356,29,70,88,426,0.0156295861461697,0.206572769953052
2013,37147,655,2311,980,2284,133,353,1113,2637,0.0262049090728411,0.422070534698521
2013,37149,85,275,207,439,0,22,207,461,0.03010710553814,0.449023861171367
2013,37151,484,2675,153,592,17,56,170,648,0.00673925930548189,0.262345679012346
2013,37153,29,735,154,491,0,55,154,546,0.0177336061580435,0.282051282051282
2013,37155,267,1985,195,832,9,116,204,948,0.0113045552110661,0.215189873417722
2013,37157,156,1274,333,1069,66,179,399,1248,0.0190351265195308,0.319711538461538
2013,37159,472,2944,267,1133,38,110,305,1243,0.0133186182067547,0.245374094931617
2013,37161,211,889,197,851,0,8,197,859,0.0181572216702953,0.229336437718277
2013,37163,286,1517,81,609,0,76,81,685,0.0162153205188903,0.118248175182482
2013,37165,115,884,76,382,19,19,95,401,0.0169148352807188,0.236907730673317
2013,37167,289,1204,141,427,43,99,184,526,0.0127750522174188,0.349809885931559
2013,37169,99,712,16,155,12,75,28,230,0.00688087117812481,0.121739130434783
2013,37171,140,972,108,362,37,102,145,464,0.00911770485360582,0.3125
2013,37173,5,123,41,240,12,40,53,280,0.028874909765907,0.189285714285714
2013,37175,41,536,122,320,40,100,162,420,0.0172300623564161,0.385714285714286
2013,37177,0,451,0,40,0,0,0,40,0.0126422250316056,0
2013,37179,1319,3854,1086,2739,97,459,1183,3198,0.0249222640450752,0.369918699186992
2013,37181,84,535,60,184,0,26,60,210,0.0071061180292366,0.285714285714286
2013,37183,6852,14996,9907,17677,2191,4426,12098,22103,0.0367733058707852,0.547346514047867
2013,37185,123,601,12,250,74,147,86,397,0.0267196123300579,0.216624685138539
2013,37187,33,177,9,196,0,6,9,202,0.0228843321626827,0.0445544554455446
2013,37189,350,1184,333,621,98,134,431,755,0.026575149595213,0.570860927152318
2013,37191,387,2728,403,1746,141,570,544,2316,0.0287959417118416,0.234887737478411
2013,37193,30,583,120,188,0,26,120,214,0.00439181562583373,0.560747663551402
2013,37195,263,1622,216,954,2,54,218,1008,0.0184480234260615,0.216269841269841
2013,37197,104,432,42,239,0,28,42,267,0.0100903216053815,0.157303370786517
2013,37199,25,240,10,152,14,23,24,175,0.013458432669384,0.137142857142857
2013,38001,2,34,10,42,0,0,10,42,0.0237691001697793,0.238095238095238
2013,38003,94,183,37,111,0,6,37,117,0.0149463464486459,0.316239316239316
2013,38005,23,82,5,53,0,2,5,55,0.0142560912389839,0.0909090909090909
2013,38007,24,45,15,49,0,0,15,49,0.0734632683658171,0.306122448979592
2013,38009,16,78,20,77,19,41,39,118,0.0252244548952544,0.330508474576271
2013,38011,4,22,17,57,0,0,17,57,0.0251655629139073,0.298245614035088
2013,38013,4,60,4,61,0,0,4,61,0.0423317140874393,0.0655737704918033
2013,38015,518,1920,364,1487,52,90,416,1577,0.0280594996619337,0.263792010145847
2013,38017,530,1595,1728,4017,162,499,1890,4516,0.0472775620020728,0.4185119574845
2013,38019,3,83,6,13,0,2,6,15,0.00505731625084289,0.4
2013,38021,36,81,38,96,0,0,38,96,0.0268156424581006,0.395833333333333
2013,38023,21,57,0,19,0,0,0,19,0.0107163000564016,0
2013,38025,20,72,4,65,0,0,4,65,0.0242990654205607,0.0615384615384615
2013,38027,8,60,10,36,0,4,10,40,0.0225606316976875,0.25
2013,38029,23,52,12,50,0,7,12,57,0.0221617418351477,0.210526315789474
2013,38031,20,107,17,30,0,25,17,55,0.0228500207727462,0.309090909090909
2013,38033,0,11,11,27,0,1,11,28,0.0244755244755245,0.392857142857143
2013,38035,100,540,631,1558,164,338,795,1896,0.0489745311773519,0.419303797468354
2013,38037,0,47,6,21,6,6,12,27,0.015041782729805,0.444444444444444
2013,38039,4,58,7,28,1,6,8,34,0.0181236673773987,0.235294117647059
2013,38041,20,89,2,87,1,1,3,88,0.0466595970307529,0.0340909090909091
2013,38043,8,63,1,34,0,3,1,37,0.0197860962566845,0.027027027027027
2013,38045,14,57,22,55,0,0,22,55,0.0177820885871322,0.4
2013,38047,8,34,0,20,0,0,0,20,0.0140449438202247,0
2013,38049,31,137,20,75,0,8,20,83,0.0207085828343313,0.240963855421687
2013,38051,12,33,1,14,0,3,1,17,0.00780891134588884,0.0588235294117647
2013,38053,23,149,52,230,0,1,52,231,0.0489718041127835,0.225108225108225
2013,38055,68,241,43,168,4,10,47,178,0.0261533940640611,0.264044943820225
2013,38057,83,286,40,154,0,8,40,162,0.0261797026502909,0.246913580246914
2013,38059,137,732,180,637,0,30,180,667,0.0347703695980816,0.269865067466267
2013,38061,4,206,17,144,0,0,17,144,0.0266617293093871,0.118055555555556
2013,38063,12,69,12,35,0,0,12,35,0.0146137787056367,0.342857142857143
2013,38065,0,32,0,5,0,0,0,5,0.00382262996941896,0
2013,38067,29,177,10,109,4,9,14,118,0.0220272540601083,0.11864406779661
2013,38069,0,147,0,65,0,0,0,65,0.0201238390092879,0
2013,38071,97,246,54,161,0,6,54,167,0.0212144308943089,0.323353293413174
2013,38073,7,161,8,70,0,8,8,78,0.0201654601861427,0.102564102564103
2013,38075,22,61,3,13,0,5,3,18,0.0101010101010101,0.166666666666667
2013,38077,89,223,32,298,0,34,32,332,0.031688460437148,0.0963855421686747
2013,38079,17,76,29,43,0,0,29,43,0.00533631173988583,0.674418604651163
2013,38081,19,76,7,23,0,10,7,33,0.0120087336244541,0.212121212121212
2013,38083,1,12,3,7,0,0,3,7,0.00654817586529467,0.428571428571429
2013,38085,9,35,18,57,0,8,18,65,0.0293321299638989,0.276923076923077
2013,38087,11,11,0,7,0,0,0,7,0.0124777183600713,0
2013,38089,182,716,179,627,0,18,179,645,0.037983628761557,0.277519379844961
2013,38091,19,51,1,22,0,1,1,23,0.0161857846586911,0.0434782608695652
2013,38093,95,502,100,419,0,16,100,435,0.0298927982407916,0.229885057471264
2013,38095,21,106,4,16,0,5,4,21,0.0125,0.19047619047619
2013,38097,75,168,39,111,2,7,41,118,0.021380684906686,0.347457627118644
2013,38099,39,110,14,135,21,34,35,169,0.0213842844489434,0.207100591715976
2013,38101,196,795,835,2121,190,325,1025,2446,0.0621680010166476,0.419051512673753
2013,38103,5,30,60,78,1,1,61,79,0.0246182611405422,0.772151898734177
2013,38105,61,337,160,945,24,39,184,984,0.0591950911387836,0.186991869918699
2013,39001,3,316,34,136,0,22,34,158,0.0082545321561047,0.215189873417722
2013,39003,319,1636,195,723,0,69,195,792,0.0114307157186774,0.246212121212121
2013,39005,173,1046,189,524,0,0,189,524,0.0149466598208683,0.360687022900763
2013,39007,191,1478,157,945,13,196,170,1141,0.0164364223051326,0.148992112182296
2013,39009,311,888,292,533,108,148,400,681,0.0199320962360241,0.587371512481645
2013,39011,135,932,74,260,7,18,81,278,0.00897758832267648,0.29136690647482
2013,39013,98,1478,104,433,37,60,141,493,0.00974231286064343,0.286004056795132
2013,39015,29,766,27,356,2,5,29,361,0.0119421747328724,0.0803324099722992
2013,39017,1890,6559,1074,3097,224,579,1298,3676,0.0156532106966445,0.35310119695321
2013,39019,45,416,11,195,0,6,11,201,0.00990879960561992,0.054726368159204
2013,39021,123,1025,102,301,0,39,102,340,0.0127212182437236,0.3
2013,39023,273,1924,253,1207,63,168,316,1375,0.0147741436369106,0.229818181818182
2013,39025,1069,4006,883,2010,70,265,953,2275,0.0171738293487533,0.418901098901099
2013,39027,126,932,37,212,11,67,48,279,0.0100871325789074,0.172043010752688
2013,39029,145,1307,218,1524,0,170,218,1694,0.0222888871345491,0.128689492325856
2013,39031,53,427,46,127,7,12,53,139,0.00552420316350052,0.381294964028777
2013,39033,76,867,10,235,0,25,10,260,0.0086436170212766,0.0384615384615385
2013,39035,4464,12120,5462,10532,1682,3514,7144,14046,0.0160546080702809,0.508614552185676
2013,39037,105,716,73,463,0,25,73,488,0.0136836497209994,0.149590163934426
2013,39039,36,495,114,343,0,29,114,372,0.0143551748089836,0.306451612903226
2013,39041,2819,5476,1102,1725,167,369,1269,2094,0.0181525018204515,0.606017191977077
2013,39043,275,1657,94,458,0,70,94,528,0.00974709248661621,0.178030303030303
2013,39045,959,4148,567,1305,105,215,672,1520,0.0155817529472066,0.442105263157895
2013,39047,179,860,0,138,30,115,30,253,0.0128700783396073,0.118577075098814
2013,39049,5437,15858,7554,14976,2300,4735,9854,19711,0.0257631168260823,0.499923900360205
2013,39051,97,711,8,157,0,19,8,176,0.00616721564230149,0.0454545454545455
2013,39053,38,232,68,335,0,33,68,368,0.0177033722999952,0.184782608695652
2013,39055,279,1222,185,360,98,143,283,503,0.00796112816941534,0.562624254473161
2013,39057,1360,3075,1387,2679,364,778,1751,3457,0.032817854735663,0.506508533410472
2013,39059,50,669,28,240,0,46,28,286,0.0104570383912249,0.0979020979020979
2013,39061,3022,8698,4825,9450,1551,2159,6376,11609,0.0218396556524618,0.549229046429494
2013,39063,343,1377,266,769,31,45,297,814,0.0162397254808076,0.364864864864865
2013,39065,56,504,45,159,0,7,45,166,0.00855625998659863,0.271084337349398
2013,39067,13,203,3,161,0,0,3,161,0.0142971316934553,0.0186335403726708
2013,39069,33,401,40,199,0,1,40,200,0.0105268698352545,0.2
2013,39071,90,895,62,215,0,18,62,233,0.00800907465970026,0.266094420600858
2013,39073,115,864,0,86,0,0,0,86,0.00428158916658369,0
2013,39075,15,294,17,223,0,30,17,253,0.0105311355311355,0.0671936758893281
2013,39077,106,1309,26,511,10,38,36,549,0.0139026057889539,0.0655737704918033
2013,39079,95,582,24,186,0,23,24,209,0.00939790458204056,0.114832535885167
2013,39081,72,581,138,631,0,60,138,691,0.014238028517267,0.199710564399421
2013,39083,198,1407,96,411,0,57,96,468,0.0119102153000458,0.205128205128205
2013,39085,934,3288,616,1277,124,413,740,1690,0.0104094165183273,0.437869822485207
2013,39087,59,532,150,1235,0,19,150,1254,0.0292792266921945,0.119617224880383
2013,39089,823,3439,255,1027,90,164,345,1191,0.0106717561355878,0.289672544080605
2013,39091,83,883,24,244,13,32,37,276,0.00896394933419942,0.134057971014493
2013,39093,1182,5530,623,1917,182,536,805,2453,0.0119835659535802,0.328169588259274
2013,39095,1280,4629,1302,4198,303,525,1605,4723,0.0163788888156777,0.339826381537159
2013,39097,302,2479,62,264,24,60,86,324,0.0107673390714832,0.265432098765432
2013,39099,552,3494,488,2472,111,281,599,2753,0.0165277844483934,0.21758082092263
2013,39101,143,2468,108,538,0,65,108,603,0.0130683542109141,0.17910447761194
2013,39103,1068,3848,467,1074,83,272,550,1346,0.0113984722998493,0.408618127786033
2013,39105,52,378,30,113,0,0,30,113,0.00685887708649469,0.265486725663717
2013,39107,137,648,82,273,38,97,120,370,0.0136798905608755,0.324324324324324
2013,39109,576,2195,233,741,26,152,259,893,0.0126395946271107,0.29003359462486
2013,39111,11,92,37,124,0,19,37,143,0.0136047949766911,0.258741258741259
2013,39113,2149,8569,2072,5696,643,1380,2715,7076,0.0195660409183541,0.383691351045789
2013,39115,4,311,24,116,6,6,30,122,0.0116534530518674,0.245901639344262
2013,39117,91,491,6,116,0,0,6,116,0.00494880546075085,0.0517241379310345
2013,39119,135,1118,71,543,54,69,125,612,0.0106390376190807,0.204248366013072
2013,39121,23,1101,0,69,0,0,0,69,0.00636942675159236,0
2013,39123,223,936,81,322,0,22,81,344,0.0113700214840522,0.23546511627907
2013,39125,29,242,29,98,0,24,29,122,0.00929382189380666,0.237704918032787
2013,39127,77,699,21,158,0,12,21,170,0.00715096958734699,0.123529411764706
2013,39129,348,3138,57,317,1,62,58,379,0.00999709846746327,0.153034300791557
2013,39131,101,1001,31,230,0,12,31,242,0.0125773088716803,0.128099173553719
2013,39133,701,2779,553,1372,243,342,796,1714,0.0166963772563001,0.46441073512252
2013,39135,59,525,20,497,11,77,31,574,0.0199693849151127,0.054006968641115
2013,39137,69,390,14,59,35,53,49,112,0.00493522516964837,0.4375
2013,39139,397,3376,70,805,63,117,133,922,0.0107584597432905,0.144251626898048
2013,39141,168,2248,68,548,0,5,68,553,0.0101766654398233,0.122965641952984
2013,39143,268,1174,46,407,0,20,46,427,0.010342488979315,0.107728337236534
2013,39145,11,1112,137,675,0,54,137,729,0.0136394252357432,0.187928669410151
2013,39147,228,1156,37,288,29,97,66,385,0.0103575367894326,0.171428571428571
2013,39149,55,590,81,211,0,24,81,235,0.00729179595382897,0.34468085106383
2013,39151,1100,4904,535,2305,239,462,774,2767,0.0107504739999378,0.279725334297073
2013,39153,2474,7390,1804,3539,443,1065,2247,4604,0.0124223602484472,0.488053866203301
2013,39155,281,1945,353,1989,24,134,377,2123,0.014481977680155,0.177578897786152
2013,39157,220,1460,120,470,8,58,128,528,0.00830097316333108,0.242424242424242
2013,39159,810,2731,40,357,61,99,101,456,0.0131503056869304,0.221491228070175
2013,39161,86,471,23,290,0,0,23,290,0.0148855353659789,0.0793103448275862
2013,39163,10,257,0,53,0,5,0,58,0.0064053009387079,0
2013,39165,1853,5904,1781,3277,445,738,2226,4015,0.0282440170519296,0.554420921544209
2013,39167,63,458,89,1032,39,98,128,1130,0.0260747167547361,0.113274336283186
2013,39169,431,2042,96,545,52,104,148,649,0.00873086340032825,0.228043143297381
2013,39171,153,736,93,418,0,13,93,431,0.0166095032563875,0.215777262180974
2013,39173,652,2590,634,1219,339,579,973,1798,0.0229322109559339,0.541156840934372
2013,39175,109,655,70,237,0,13,70,250,0.0161415289256198,0.28
2013,40001,33,135,17,126,0,6,17,132,0.00920373727513596,0.128787878787879
2013,40003,48,373,17,132,0,0,17,132,0.0306051472293067,0.128787878787879
2013,40005,37,714,9,157,3,3,12,160,0.0166649307363816,0.075
2013,40007,19,86,16,191,3,9,19,200,0.0530785562632696,0.095
2013,40009,106,443,95,736,0,13,95,749,0.0502280042918455,0.126835781041389
2013,40011,26,403,27,288,0,38,27,326,0.0456582633053221,0.0828220858895705
2013,40013,149,459,147,1106,0,98,147,1204,0.0426723374091795,0.122093023255814
2013,40015,62,836,39,603,0,90,39,693,0.0355075062765794,0.0562770562770563
2013,40017,976,3596,437,1835,68,180,505,2015,0.025809839761243,0.250620347394541
2013,40019,119,760,108,440,17,78,125,518,0.0162934071464519,0.241312741312741
2013,40021,147,667,222,463,26,40,248,503,0.0171549401452884,0.493041749502982
2013,40023,0,180,11,170,0,0,11,170,0.0165902215282522,0.0647058823529412
2013,40025,9,38,1,9,0,0,1,9,0.00530035335689046,0.111111111111111
2013,40027,1655,7779,1318,3637,345,639,1663,4276,0.0262685833640496,0.388914873713751
2013,40029,23,101,0,36,0,7,0,43,0.0109386924446706,0
2013,40031,216,2019,1157,5281,308,1406,1465,6687,0.0872020238902509,0.219081800508449
2013,40033,6,82,13,146,0,15,13,161,0.0387951807228916,0.0807453416149068
2013,40035,39,801,14,210,0,7,14,217,0.020988490182803,0.0645161290322581
2013,40037,181,1700,63,540,9,54,72,594,0.0125477935740087,0.121212121212121
2013,40039,140,858,111,281,0,46,111,327,0.0197654738878143,0.339449541284404
2013,40041,103,859,60,876,34,80,94,956,0.0326502732240437,0.098326359832636
2013,40043,46,138,8,43,0,0,8,43,0.0130778588807786,0.186046511627907
2013,40045,14,66,7,42,3,3,10,45,0.0155333103210217,0.222222222222222
2013,40047,144,1132,451,1202,111,206,562,1408,0.0351350002495384,0.399147727272727
2013,40049,45,413,9,150,0,18,9,168,0.00905806869035423,0.0535714285714286
2013,40051,377,1669,46,431,13,30,59,461,0.0131470126907172,0.127982646420824
2013,40053,13,122,29,62,0,0,29,62,0.0194479297365119,0.467741935483871
2013,40055,3,558,12,94,0,0,12,94,0.0210667861945316,0.127659574468085
2013,40057,5,53,16,72,0,0,16,72,0.0377160817181771,0.222222222222222
2013,40059,0,27,13,32,0,7,13,39,0.0153785488958991,0.333333333333333
2013,40061,35,147,7,83,0,18,7,101,0.0117237376668601,0.0693069306930693
2013,40063,50,592,15,107,6,12,21,119,0.0122503603047148,0.176470588235294
2013,40065,84,463,164,512,33,175,197,687,0.0415381824777798,0.286754002911208
2013,40067,29,255,2,84,0,0,2,84,0.0190519392152416,0.0238095238095238
2013,40069,63,338,3,191,0,8,3,199,0.0271783665665119,0.0150753768844221
2013,40071,174,711,119,794,58,158,177,952,0.0312366702759458,0.185924369747899
2013,40073,64,362,26,87,0,10,26,97,0.00979896959288817,0.268041237113402
2013,40075,57,281,3,91,0,11,3,102,0.0157261794634598,0.0294117647058824
2013,40077,21,270,36,139,12,12,48,151,0.0208247138325748,0.317880794701987
2013,40079,47,1060,58,569,17,88,75,657,0.0196541821227713,0.114155251141553
2013,40081,27,806,45,407,14,48,59,455,0.0196901505971958,0.12967032967033
2013,40083,700,1855,91,464,42,60,133,524,0.018679595037787,0.25381679389313
2013,40085,23,110,13,194,0,24,13,218,0.0338983050847458,0.0596330275229358
2013,40087,262,1346,90,217,7,7,97,224,0.00972095647268151,0.433035714285714
2013,40089,24,514,55,414,3,20,58,434,0.020013834447775,0.133640552995392
2013,40091,20,369,29,166,0,24,29,190,0.0129198966408269,0.152631578947368
2013,40093,18,174,0,109,0,8,0,117,0.0222348916761688,0
2013,40095,28,330,35,351,0,2,35,353,0.0323912644521931,0.0991501416430595
2013,40097,36,650,57,642,1,13,58,655,0.0239865236020068,0.0885496183206107
2013,40099,68,317,27,179,6,6,33,185,0.0201196302338227,0.178378378378378
2013,40101,190,1855,105,807,21,83,126,890,0.0190802872762354,0.141573033707865
2013,40103,52,293,27,143,0,0,27,143,0.0182049649904519,0.188811188811189
2013,40105,75,378,40,157,0,0,40,157,0.0215807560137457,0.254777070063694
2013,40107,54,560,9,124,0,0,9,124,0.0148042024832856,0.0725806451612903
2013,40109,3124,12631,4896,13415,625,2595,5521,16010,0.0338996688377135,0.344846970643348
2013,40111,125,836,59,341,0,23,59,364,0.0139090561711884,0.162087912087912
2013,40113,195,1728,17,223,11,41,28,264,0.00806698038257043,0.106060606060606
2013,40115,79,404,84,653,0,9,84,662,0.0315749308404083,0.126888217522659
2013,40117,56,544,26,148,0,5,26,153,0.0135182894504329,0.169934640522876
2013,40119,350,1804,615,1573,196,270,811,1843,0.0442263390286043,0.440043407487792
2013,40121,102,1155,42,581,0,4,42,585,0.018413597733711,0.0717948717948718
2013,40123,79,713,69,314,8,51,77,365,0.0151849232433332,0.210958904109589
2013,40125,236,1922,37,528,13,47,50,575,0.0125952860772803,0.0869565217391304
2013,40127,27,304,24,178,6,13,30,191,0.0238362660676401,0.157068062827225
2013,40129,8,86,0,32,0,0,0,32,0.0126532226176354,0
2013,40131,691,2733,343,999,28,90,371,1089,0.0188957523598001,0.340679522497704
2013,40133,104,689,16,166,11,11,27,177,0.0106229744328412,0.152542372881356
2013,40135,37,652,19,621,0,10,19,631,0.0225373240945782,0.0301109350237718
2013,40137,209,1557,50,429,0,121,50,550,0.0179685713352282,0.0909090909090909
2013,40139,32,252,91,554,79,248,170,802,0.0629612184016329,0.211970074812968
2013,40141,7,175,36,86,0,6,36,92,0.0177025206850106,0.391304347826087
2013,40143,2299,9830,2842,9103,328,1059,3170,10162,0.025687693062149,0.31194646723086
2013,40145,462,2634,271,1022,6,92,277,1114,0.0227779254503445,0.248653500897666
2013,40147,214,1029,294,971,87,153,381,1124,0.0321703540456224,0.338967971530249
2013,40149,28,267,33,108,5,12,38,120,0.0155098875533152,0.316666666666667
2013,40151,31,354,50,109,0,0,50,109,0.0194851626742939,0.458715596330275
2013,40153,100,545,25,267,0,34,25,301,0.0220836390315481,0.0830564784053156
2013,41001,146,458,51,268,0,22,51,290,0.0246368193016736,0.175862068965517
2013,41003,536,1649,891,1375,391,540,1282,1915,0.0375151823845159,0.669451697127937
2013,41005,3493,10331,2521,6006,366,669,2887,6675,0.0254659214466932,0.43250936329588
2013,41007,275,824,460,1192,9,39,469,1231,0.0464773842784868,0.380991064175467
2013,41009,209,1009,204,903,34,75,238,978,0.0286879234988707,0.243353783231084
2013,41011,130,1029,246,1161,58,69,304,1230,0.0266689794236899,0.247154471544715
2013,41013,110,755,10,281,0,0,10,281,0.0184165683575829,0.0355871886120996
2013,41015,21,198,137,981,57,81,194,1062,0.0605714937546341,0.182674199623352
2013,41017,806,2954,1483,3786,129,199,1612,3985,0.035352460034421,0.404516938519448
2013,41019,276,1793,516,2190,36,195,552,2385,0.0306922156305095,0.231446540880503
2013,41021,3,78,8,21,0,0,8,21,0.014747191011236,0.380952380952381
2013,41023,17,168,25,108,0,12,25,120,0.0216998191681736,0.208333333333333
2013,41025,18,142,39,176,3,3,42,179,0.0344827586206897,0.23463687150838
2013,41027,118,302,137,439,0,5,137,444,0.0297986577181208,0.308558558558559
2013,41029,411,2988,1415,4838,135,345,1550,5183,0.0361202288613382,0.299054601582095
2013,41031,129,1050,64,361,2,12,66,373,0.0262472732390402,0.176943699731903
2013,41033,179,799,296,1937,0,106,296,2043,0.0340023966446974,0.144884973078806
2013,41035,219,1081,272,1508,19,163,291,1671,0.0367260818919097,0.174147217235189
2013,41037,11,299,109,252,0,0,109,252,0.0426468099509223,0.432539682539683
2013,41039,942,4097,2241,6252,535,1224,2776,7476,0.0314049031304085,0.371321562332798
2013,41041,118,618,230,888,20,38,250,926,0.0263750035603407,0.269978401727862
2013,41043,611,2558,294,1237,54,219,348,1456,0.018293295808624,0.239010989010989
2013,41045,51,775,96,556,0,21,96,577,0.0286807833780694,0.166377816291161
2013,41047,1300,6514,949,3541,143,687,1092,4228,0.0207305712184359,0.258278145695364
2013,41049,31,316,10,245,2,7,12,252,0.0354131534569983,0.0476190476190476
2013,41051,5165,13838,10335,18682,1986,3919,12321,22601,0.0428956713350023,0.545152869342065
2013,41053,508,2230,313,1179,71,104,384,1283,0.0265625970476802,0.299298519095869
2013,41055,3,41,9,35,0,5,9,40,0.0297619047619048,0.225
2013,41057,64,531,69,367,17,37,86,404,0.0215742817473032,0.212871287128713
2013,41059,200,1459,220,1513,49,84,269,1597,0.0326191302926939,0.168440826549781
2013,41061,41,285,71,367,6,12,77,379,0.0221469058610413,0.203166226912929
2013,41063,26,146,41,105,0,13,41,118,0.0224548049476689,0.347457627118644
2013,41065,64,440,269,803,26,46,295,849,0.0485559050614813,0.347467608951708
2013,41067,3619,10068,5332,12425,1386,2386,6718,14811,0.0412687974900457,0.453581797312808
2013,41069,4,71,0,5,0,0,0,5,0.00475737392959087,0
2013,41071,621,2548,622,1721,19,185,641,1906,0.0294149420497863,0.336306400839454
2013,42001,185,1533,336,1268,22,80,358,1348,0.0194261503653212,0.265578635014837
2013,42003,4020,9196,8316,14467,2430,3544,10746,18011,0.0207864241372266,0.596635389484204
2013,42005,151,1082,47,261,21,69,68,330,0.0066128288880428,0.206060606060606
2013,42007,833,2811,343,1194,12,138,355,1332,0.0108745346482921,0.266516516516517
2013,42009,70,277,58,322,0,31,58,353,0.00996218321386239,0.164305949008499
2013,42011,951,4619,600,2876,207,986,807,3862,0.0141011691337019,0.208959088555153
2013,42013,248,1171,195,869,13,50,208,919,0.0103691835537302,0.226332970620239
2013,42015,58,383,143,661,13,45,156,706,0.0160911680911681,0.220963172804533
2013,42017,2162,6450,2940,6109,369,903,3309,7012,0.0160429398023689,0.471905305191101
2013,42019,1715,3716,563,1500,149,259,712,1759,0.0138423280922927,0.404775440591245
2013,42021,362,1957,269,1021,14,151,283,1172,0.0115740512141891,0.241467576791809
2013,42023,34,89,0,16,0,0,0,16,0.00427693130179096,0
2013,42025,284,1192,43,559,39,53,82,612,0.0129878398166423,0.133986928104575
2013,42027,837,2727,1335,2049,545,820,1880,2869,0.033184510039789,0.655280585569885
2013,42029,3728,6946,3300,5703,943,1628,4243,7331,0.0218672632363908,0.578775064793343
2013,42031,76,438,38,215,11,29,49,244,0.00942995169082126,0.200819672131148
2013,42033,132,1960,160,822,16,128,176,950,0.0161361551788565,0.185263157894737
2013,42035,202,715,61,179,20,62,81,241,0.00964308578745198,0.336099585062241
2013,42037,264,877,108,424,39,62,147,486,0.0110711194131851,0.302469135802469
2013,42039,194,1157,232,757,18,83,250,840,0.0139692676112552,0.297619047619048
2013,42041,1230,5647,1207,2728,487,668,1694,3396,0.0207541404387948,0.498822143698469
2013,42043,1714,5857,1268,3040,402,832,1670,3872,0.0209796272214998,0.431301652892562
2013,42045,2842,8243,2372,4655,476,1149,2848,5804,0.0155944371601144,0.490696071674707
2013,42047,0,160,35,68,0,16,35,84,0.00360654329998712,0.416666666666667
2013,42049,542,2149,1360,2945,140,549,1500,3494,0.0188445192328436,0.429307384087006
2013,42051,268,1638,134,924,20,209,154,1133,0.0115253547632369,0.135922330097087
2013,42053,23,469,13,73,0,20,13,93,0.0156512958599798,0.139784946236559
2013,42055,207,1520,536,1836,163,353,699,2189,0.0212421154779233,0.319323892188214
2013,42057,33,291,19,83,3,9,22,92,0.00884955752212389,0.239130434782609
2013,42059,117,1202,120,517,0,37,120,554,0.0204337562702862,0.216606498194946
2013,42061,83,1392,79,351,22,32,101,383,0.0118286543747491,0.263707571801567
2013,42063,313,1161,235,736,96,139,331,875,0.0155180363920122,0.378285714285714
2013,42065,65,731,35,249,0,15,35,264,0.00834228654490299,0.132575757575758
2013,42067,30,314,6,68,3,37,9,105,0.00616885024381646,0.0857142857142857
2013,42069,773,2375,556,1692,195,430,751,2122,0.0142053822466194,0.353911404335533
2013,42071,1320,4303,1467,3517,315,923,1782,4440,0.0129151989202428,0.401351351351351
2013,42073,130,560,225,668,13,106,238,774,0.0120946948980389,0.30749354005168
2013,42075,433,2517,178,750,68,268,246,1018,0.0110565644278391,0.241650294695481
2013,42077,1846,6070,1577,4153,450,1516,2027,5669,0.0237598283290583,0.357558652319633
2013,42079,911,3800,686,2581,140,577,826,3158,0.0139333159791927,0.261557948068398
2013,42081,244,1594,281,1204,21,54,302,1258,0.0157462574475542,0.240063593004769
2013,42083,71,474,79,467,0,29,79,496,0.0163529062675151,0.159274193548387
2013,42085,195,1340,300,1237,18,82,318,1319,0.0164369563591955,0.24109173616376
2013,42087,60,534,44,204,0,114,44,318,0.009765984890363,0.138364779874214
2013,42089,283,1462,697,2794,62,236,759,3030,0.0270388449148232,0.25049504950495
2013,42091,7605,16552,4382,7596,1746,2683,6128,10279,0.0183698233787679,0.596166942309563
2013,42093,106,430,80,166,18,48,98,214,0.016148505885904,0.457943925233645
2013,42095,1455,4691,1553,4193,261,743,1814,4936,0.0241347949813708,0.367504051863857
2013,42097,370,2119,69,404,20,139,89,543,0.00797192941245559,0.16390423572744
2013,42099,170,804,50,253,4,41,54,294,0.00925838450637695,0.183673469387755
2013,42101,4809,11275,10088,16642,3366,7736,13454,24378,0.0244558920160712,0.551891049306752
2013,42103,173,583,307,1235,34,49,341,1284,0.0318871532520426,0.265576323987539
2013,42105,47,153,12,216,0,4,12,220,0.0178238677793081,0.0545454545454545
2013,42107,279,2358,164,867,29,333,193,1200,0.0111884982238259,0.160833333333333
2013,42109,116,618,37,203,11,50,48,253,0.00973376423514928,0.189723320158103
2013,42111,247,1346,70,506,15,57,85,563,0.00990970376498337,0.150976909413854
2013,42113,19,82,21,56,0,0,21,56,0.0115036976170912,0.375
2013,42115,59,534,83,528,17,52,100,580,0.0187459599224305,0.172413793103448
2013,42117,63,461,191,547,9,30,200,577,0.019902728432962,0.346620450606586
2013,42119,267,1030,256,1440,10,128,266,1568,0.0515060933547942,0.169642857142857
2013,42121,228,847,113,350,0,31,113,381,0.00976747763221986,0.296587926509186
2013,42123,122,604,103,360,6,16,109,376,0.0125333333333333,0.289893617021277
2013,42125,993,3188,798,2351,69,265,867,2616,0.0177775361530934,0.331422018348624
2013,42127,176,1887,268,1106,32,49,300,1155,0.0298187638766975,0.25974025974026
2013,42129,1243,5160,718,1713,84,263,802,1976,0.0074631939146265,0.40587044534413
2013,42131,58,419,56,169,4,4,60,173,0.00880093605331434,0.346820809248555
2013,42133,1462,5401,1409,4648,241,945,1650,5593,0.0187172665361511,0.295011621669945
2013,44001,473,894,335,625,62,115,397,740,0.0219636709011041,0.536486486486486
2013,44003,1023,3835,738,1578,166,315,904,1893,0.0158322600070254,0.477548864236661
2013,44005,345,807,2342,3259,270,452,2612,3711,0.0631240538195921,0.703853408784694
2013,44007,1149,3668,3720,7613,1265,2879,4985,10492,0.025228249291267,0.475123903926801
2013,44009,758,1425,762,1523,83,193,845,1716,0.0203532160690776,0.492424242424242
2013,45001,137,640,11,50,15,31,26,81,0.0047666686282587,0.320987654320988
2013,45003,306,1171,1106,3688,114,289,1220,3977,0.0359916016579486,0.306763892381192
2013,45005,59,392,0,91,0,0,0,91,0.01291696238467,0
2013,45007,629,2650,582,2457,163,582,745,3039,0.0237750639556261,0.245146429746627
2013,45009,15,199,79,152,0,20,79,172,0.0168677061880945,0.459302325581395
2013,45011,0,214,19,173,0,6,19,179,0.0123269747262585,0.106145251396648
2013,45013,388,1333,3512,7657,327,850,3839,8507,0.0742800761399158,0.451275420242154
2013,45015,1214,4763,1239,4134,274,661,1513,4795,0.0403609336464567,0.315537017726799
2013,45017,19,236,0,72,0,0,0,72,0.00675992864519763,0
2013,45019,2046,6633,5198,9691,470,761,5668,10452,0.0429134504844802,0.54228855721393
2013,45021,126,874,71,433,0,11,71,444,0.0121747237379692,0.15990990990991
2013,45023,41,346,133,315,0,50,133,365,0.016379465087058,0.364383561643836
2013,45025,208,543,196,440,0,72,196,512,0.0164255237239742,0.3828125
2013,45027,147,818,3,518,0,46,3,564,0.0239816310910792,0.00531914893617021
2013,45029,206,630,51,180,0,20,51,200,0.00767842745805659,0.255
2013,45031,103,1010,72,508,96,134,168,642,0.0139957707484031,0.261682242990654
2013,45033,10,417,16,166,15,15,31,181,0.0088660298799902,0.171270718232044
2013,45035,771,4269,1001,3242,115,282,1116,3524,0.0389723853444367,0.316685584562997
2013,45037,116,670,66,447,40,218,106,665,0.0350627438574291,0.159398496240602
2013,45039,144,492,7,51,26,35,33,86,0.00520518097082678,0.383720930232558
2013,45041,406,1935,507,1740,11,64,518,1804,0.0199606098829361,0.287139689578714
2013,45043,277,1236,337,784,92,198,429,982,0.0226989043502381,0.436863543788187
2013,45045,2016,6653,3871,9281,600,1196,4471,10477,0.0342309552125671,0.426744297031593
2013,45047,323,1344,190,657,29,135,219,792,0.0172816338999324,0.276515151515151
2013,45049,38,264,20,448,0,0,20,448,0.0318679755299474,0.0446428571428571
2013,45051,524,2372,1981,8460,177,856,2158,9316,0.0476741210787575,0.231644482610562
2013,45053,49,1064,38,383,0,168,38,551,0.0330831582107475,0.0689655172413793
2013,45055,303,1389,122,537,65,91,187,628,0.0149702026221692,0.297770700636943
2013,45057,102,761,198,1346,29,83,227,1429,0.0264791446624789,0.158852344296711
2013,45059,218,1623,132,435,0,60,132,495,0.0111118593844703,0.266666666666667
2013,45061,14,469,0,101,0,14,0,115,0.00905084212183221,0
2013,45063,1919,5642,1122,3702,294,555,1416,4257,0.0237500139476239,0.332628611698379
2013,45065,31,405,129,158,10,14,139,172,0.0211770499876878,0.808139534883721
2013,45067,27,229,73,255,0,0,73,255,0.0116025116025116,0.286274509803922
2013,45069,43,830,97,571,0,32,97,603,0.0301756493019066,0.160862354892206
2013,45071,152,1000,27,356,38,165,65,521,0.0206451101600888,0.124760076775432
2013,45073,247,954,405,1302,12,68,417,1370,0.0260386969247729,0.304379562043796
2013,45075,206,822,129,523,4,46,133,569,0.00953833774767828,0.233743409490334
2013,45077,480,1919,520,1768,240,335,760,2103,0.0287416802197652,0.361388492629577
2013,45079,2126,9550,3194,8224,610,1179,3804,9403,0.0390619807244932,0.404551738806764
2013,45081,63,313,26,198,0,39,26,237,0.017384288124404,0.109704641350211
2013,45083,691,3813,977,3383,366,744,1343,4127,0.0218193545658334,0.325417979161619
2013,45085,87,979,389,1354,71,385,460,1739,0.0252688172043011,0.264519838987924
2013,45087,57,460,67,232,0,21,67,253,0.0127674606378684,0.264822134387352
2013,45089,19,501,48,386,59,124,107,510,0.0219354838709677,0.209803921568627
2013,45091,467,1658,2495,6153,114,305,2609,6458,0.0426228426228426,0.403995044905543
2013,46003,10,77,3,8,0,16,3,24,0.0128342245989305,0.125
2013,46005,61,173,34,270,39,68,73,338,0.0284224688866465,0.215976331360947
2013,46007,0,68,25,32,0,0,25,32,0.0172972972972973,0.78125
2013,46009,36,347,8,123,0,3,8,126,0.0248275862068966,0.0634920634920635
2013,46011,270,638,238,635,29,79,267,714,0.0426701727126038,0.373949579831933
2013,46013,220,618,196,607,19,33,215,640,0.0261171189553152,0.3359375
2013,46015,17,35,33,47,0,13,33,60,0.0167364016736402,0.55
2013,46017,0,17,16,16,0,0,16,16,0.0163934426229508,1
2013,46019,195,479,24,150,0,0,24,150,0.021780165529258,0.16
2013,46021,0,18,8,27,0,0,8,27,0.0251630941286114,0.296296296296296
2013,46023,61,161,36,132,0,0,36,132,0.0229126887693109,0.272727272727273
2013,46025,3,95,41,90,0,0,41,90,0.035033086804204,0.455555555555556
2013,46027,10,152,144,302,13,65,157,367,0.0520124716553288,0.427792915531335
2013,46029,63,373,91,227,0,0,91,227,0.0125172318720706,0.400881057268722
2013,46031,10,48,9,71,0,0,9,71,0.0309098824553766,0.126760563380282
2013,46033,13,84,37,201,4,4,41,205,0.0321115288220551,0.2
2013,46035,116,674,152,301,0,44,152,345,0.0266512166859791,0.440579710144928
2013,46037,12,140,4,155,10,16,14,171,0.0418399804257402,0.0818713450292398
2013,46039,14,55,23,95,0,6,23,101,0.0330930537352556,0.227722772277228
2013,46041,22,81,5,14,0,0,5,14,0.00467601870407482,0.357142857142857
2013,46043,4,77,22,25,0,2,22,27,0.0126463700234192,0.814814814814815
2013,46045,12,110,6,35,0,2,6,37,0.0127894918769443,0.162162162162162
2013,46047,15,100,50,272,0,0,50,272,0.0508791619902731,0.183823529411765
2013,46049,13,59,6,32,0,4,6,36,0.0227129337539432,0.166666666666667
2013,46051,5,90,1,47,0,0,1,47,0.00921930168693605,0.0212765957446809
2013,46053,5,57,21,99,0,0,21,99,0.032184655396619,0.212121212121212
2013,46055,5,28,22,30,2,4,24,34,0.0242510699001427,0.705882352941177
2013,46057,13,135,4,93,0,0,4,93,0.0254237288135593,0.043010752688172
2013,46059,39,74,12,33,0,0,12,33,0.0130848532910389,0.363636363636364
2013,46061,7,52,0,41,0,0,0,41,0.0197876447876448,0
2013,46063,3,3,22,28,0,0,22,28,0.0318906605922551,0.785714285714286
2013,46065,156,531,155,342,25,44,180,386,0.0322472848788638,0.466321243523316
2013,46067,56,147,27,95,0,0,27,95,0.0183859105864138,0.284210526315789
2013,46069,0,5,6,12,0,0,6,12,0.0124610591900312,0.5
2013,46071,0,20,5,35,0,0,5,35,0.0189393939393939,0.142857142857143
2013,46073,18,67,2,3,0,0,2,3,0.002031144211239,0.666666666666667
2013,46075,0,8,0,14,0,0,0,14,0.0200860832137733,0
2013,46077,41,105,31,83,0,10,31,93,0.0250673854447439,0.333333333333333
2013,46079,76,200,61,148,0,5,61,153,0.0200813755085969,0.398692810457516
2013,46081,98,375,230,487,45,100,275,587,0.035882388899077,0.468483816013629
2013,46083,732,2312,313,717,0,35,313,752,0.0252756117235816,0.416223404255319
2013,46085,26,58,11,33,0,0,11,33,0.013918177983973,0.333333333333333
2013,46087,18,111,11,86,0,22,11,108,0.0281396560708702,0.101851851851852
2013,46089,0,85,5,53,0,0,5,53,0.0293141592920354,0.0943396226415094
2013,46091,45,123,0,47,5,14,5,61,0.0195387572069186,0.0819672131147541
2013,46093,143,821,84,661,14,114,98,775,0.0463045946107427,0.126451612903226
2013,46095,0,8,0,10,0,5,0,15,0.0120288692862871,0
2013,46097,14,67,1,5,0,2,1,7,0.00417661097852029,0.142857142857143
2013,46099,741,2714,1032,2717,88,390,1120,3107,0.0275690112600822,0.360476343739942
2013,46101,25,108,23,54,6,18,29,72,0.0167988800746617,0.402777777777778
2013,46103,326,1504,663,2473,116,317,779,2790,0.0410040857117663,0.27921146953405
2013,46105,20,32,22,147,0,2,22,149,0.0662222222222222,0.147651006711409
2013,46107,7,20,7,33,0,0,7,33,0.01875,0.212121212121212
2013,46109,11,45,44,171,0,0,44,171,0.0261988662478934,0.257309941520468
2013,46111,0,14,2,51,0,0,2,51,0.0303933253873659,0.0392156862745098
2013,46113,10,95,19,78,0,0,19,78,0.0116296406739228,0.243589743589744
2013,46115,28,141,10,39,11,22,21,61,0.0136099955377064,0.344262295081967
2013,46117,51,210,13,23,0,0,13,23,0.0109211775878443,0.565217391304348
2013,46119,27,35,3,15,0,7,3,22,0.0220440881763527,0.136363636363636
2013,46121,0,97,52,91,0,9,52,100,0.021308331557639,0.52
2013,46123,12,41,75,112,0,0,75,112,0.0279650436953808,0.669642857142857
2013,46125,39,140,9,65,3,3,12,68,0.0116239316239316,0.176470588235294
2013,46127,61,203,332,673,0,0,332,673,0.0685196497658318,0.493313521545319
2013,46129,29,130,51,98,6,6,57,104,0.0258064516129032,0.548076923076923
2013,46135,50,543,76,615,0,7,76,622,0.0395146432882282,0.122186495176849
2013,46137,18,63,0,28,0,0,0,28,0.0191780821917808,0
2013,47001,279,1771,336,829,151,235,487,1064,0.0200883585696485,0.457706766917293
2013,47003,121,854,71,431,14,23,85,454,0.0154474310990133,0.187224669603524
2013,47005,0,159,50,157,11,11,61,168,0.0139372822299652,0.363095238095238
2013,47007,25,544,0,111,0,0,0,111,0.0120325203252033,0
2013,47009,405,2421,499,1960,37,90,536,2050,0.0237013399928318,0.261463414634146
2013,47011,245,1051,268,1524,17,79,285,1603,0.0240009582416266,0.177791640673737
2013,47013,19,263,76,661,0,8,76,669,0.0233304272013949,0.113602391629297
2013,47015,53,604,26,123,0,0,26,123,0.0127105507905343,0.211382113821138
2013,47017,66,448,14,417,0,4,14,421,0.0215786776012301,0.0332541567695962
2013,47019,181,1277,40,406,45,61,85,467,0.011480971580293,0.182012847965739
2013,47021,180,1083,165,395,0,2,165,397,0.0149484147902704,0.415617128463476
2013,47023,76,405,13,171,0,47,13,218,0.0202113851288708,0.0596330275229358
2013,47025,155,329,130,669,11,67,141,736,0.0329100339831873,0.191576086956522
2013,47027,10,194,0,57,3,9,3,66,0.0117836100696304,0.0454545454545455
2013,47029,66,535,79,518,0,25,79,543,0.0213401454116722,0.14548802946593
2013,47031,173,1312,193,725,15,16,208,741,0.0206659973226238,0.280701754385965
2013,47033,57,340,39,104,0,0,39,104,0.010519927169735,0.375
2013,47035,103,759,218,1210,16,51,234,1261,0.0298751451112322,0.185567010309278
2013,47037,4163,11631,6815,13493,1286,2886,8101,16379,0.0382307288323511,0.4945967397277
2013,47039,30,223,0,119,0,0,0,119,0.0142055628506625,0
2013,47041,95,514,28,125,0,12,28,137,0.0105004981988197,0.204379562043796
2013,47043,106,1035,218,611,0,22,218,633,0.0188303188957639,0.344391785150079
2013,47045,148,708,110,509,33,46,143,555,0.02161467461152,0.257657657657658
2013,47047,198,763,107,415,8,58,115,473,0.0173514306676449,0.243128964059197
2013,47049,61,369,50,266,0,10,50,276,0.0219815227779548,0.181159420289855
2013,47051,211,681,161,569,32,124,193,693,0.0250234707878963,0.278499278499279
2013,47053,107,892,65,435,8,27,73,462,0.0137316094516273,0.158008658008658
2013,47055,96,341,111,340,0,0,111,340,0.016750418760469,0.326470588235294
2013,47057,37,623,73,249,0,3,73,252,0.0157411456055969,0.28968253968254
2013,47059,118,905,147,659,15,65,162,724,0.0148467138316415,0.223756906077348
2013,47061,11,153,14,45,0,2,14,47,0.00493905002101723,0.297872340425532
2013,47063,303,1181,94,654,0,102,94,756,0.0175564896309886,0.124338624338624
2013,47065,884,3254,2534,7384,279,718,2813,8102,0.0346529571778071,0.347198222661071
2013,47067,17,161,2,67,0,17,2,84,0.0174129353233831,0.0238095238095238
2013,47069,27,733,25,121,8,16,33,137,0.00729810355849137,0.240875912408759
2013,47071,23,304,87,374,0,12,87,386,0.0209543455838445,0.225388601036269
2013,47073,134,1111,218,798,15,44,233,842,0.0209411062475129,0.276722090261283
2013,47075,52,224,6,76,0,55,6,131,0.0105483533295756,0.0458015267175573
2013,47077,60,395,92,332,23,64,115,396,0.0207983193277311,0.29040404040404
2013,47079,28,463,17,300,15,15,32,315,0.0136742490015628,0.101587301587302
2013,47081,30,894,44,252,0,0,44,252,0.01484011542312,0.174603174603175
2013,47083,28,262,16,57,3,8,19,65,0.0112126962221839,0.292307692307692
2013,47085,87,448,13,118,0,37,13,155,0.0120810600155885,0.0838709677419355
2013,47087,25,162,30,118,17,17,47,135,0.0161020992366412,0.348148148148148
2013,47089,217,1380,92,384,8,27,100,411,0.011572249127154,0.24330900243309
2013,47091,28,605,12,228,0,3,12,231,0.0171683389074693,0.051948051948052
2013,47093,1359,5280,2797,6121,374,621,3171,6742,0.0232583812277058,0.470335212103233
2013,47095,15,743,1,65,0,10,1,75,0.0131463628396144,0.0133333333333333
2013,47097,48,1262,17,222,12,37,29,259,0.0140409844952835,0.111969111969112
2013,47099,23,377,21,387,10,58,31,445,0.0158656588705077,0.0696629213483146
2013,47101,0,259,0,169,25,73,25,242,0.0291742013261001,0.103305785123967
2013,47103,22,147,140,643,0,65,140,708,0.0308389232511543,0.19774011299435
2013,47105,259,1256,279,686,21,85,300,771,0.0214954834392773,0.389105058365759
2013,47107,135,984,64,525,7,76,71,601,0.0165815974617189,0.118136439267887
2013,47109,20,155,45,320,4,44,49,364,0.0200827586206897,0.134615384615385
2013,47111,16,353,4,71,0,164,4,235,0.0156718906302101,0.0170212765957447
2013,47113,531,1470,394,947,117,169,511,1116,0.0174555009853912,0.457885304659498
2013,47115,67,432,179,330,0,3,179,333,0.016788505167633,0.537537537537538
2013,47117,58,641,100,300,0,0,100,300,0.0144196106705119,0.333333333333333
2013,47119,465,2077,228,1140,24,177,252,1317,0.023746844572665,0.191343963553531
2013,47121,9,231,24,319,0,0,24,319,0.0374985306218408,0.0752351097178683
2013,47123,123,1084,94,735,3,23,97,758,0.0242863093140239,0.127968337730871
2013,47125,395,1509,1878,7163,645,1863,2523,9026,0.0846605511471289,0.279525814314203
2013,47127,28,214,0,48,0,0,0,48,0.0106928046335487,0
2013,47129,136,1514,0,166,0,4,0,170,0.0108688702768365,0
2013,47131,42,484,30,410,0,0,30,410,0.0187086470454027,0.0731707317073171
2013,47133,6,337,23,94,0,34,23,128,0.00838849203748607,0.1796875
2013,47135,24,105,2,76,2,4,4,80,0.0144743984078162,0.05
2013,47137,12,74,7,13,0,0,7,13,0.00343461030383091,0.538461538461538
2013,47139,16,430,52,418,0,4,52,422,0.0355458221024259,0.123222748815166
2013,47141,181,842,91,605,161,281,252,886,0.0191687760974449,0.284424379232506
2013,47143,88,661,40,604,39,54,79,658,0.0305591677503251,0.120060790273556
2013,47145,146,820,48,469,56,143,104,612,0.0157112417528817,0.169934640522876
2013,47147,274,1490,119,874,4,80,123,954,0.0215593220338983,0.128930817610063
2013,47149,1261,5148,1034,4172,362,763,1396,4935,0.0297892118987831,0.282877406281662
2013,47151,30,289,40,208,0,11,40,219,0.0148183232965695,0.182648401826484
2013,47153,8,317,115,238,0,0,115,238,0.0240306946688207,0.483193277310924
2013,47155,211,1999,522,1666,30,64,552,1730,0.0272085305820738,0.319075144508671
2013,47157,1203,4385,5139,14813,1017,1821,6156,16634,0.0280274309592411,0.370085367319947
2013,47159,34,327,11,79,0,0,11,79,0.00602823349866463,0.139240506329114
2013,47161,26,178,36,130,0,0,36,130,0.0141350440360987,0.276923076923077
2013,47163,363,2133,489,2529,36,144,525,2673,0.0236783360498902,0.196408529741863
2013,47165,842,3993,777,2567,83,298,860,2865,0.0260480593513897,0.300174520069808
2013,47167,144,1517,129,967,45,107,174,1074,0.0272720347375638,0.162011173184358
2013,47169,18,256,5,73,0,6,5,79,0.0150161566242159,0.0632911392405063
2013,47171,22,465,50,336,0,33,50,369,0.0276611694152924,0.13550135501355
2013,47173,4,241,22,139,0,2,22,141,0.0107502287282708,0.156028368794326
2013,47175,0,109,0,84,0,3,0,87,0.0215453194650817,0
2013,47177,90,534,78,351,0,88,78,439,0.0161688335604582,0.177676537585421
2013,47179,389,1946,702,1715,84,173,786,1888,0.0224124217998789,0.416313559322034
2013,47181,31,603,0,70,0,1,0,71,0.00576673164392463,0
2013,47183,102,719,86,367,6,35,92,402,0.0183561643835616,0.228855721393035
2013,47185,22,585,41,262,0,0,41,262,0.0144983675502186,0.156488549618321
2013,47187,2626,4766,2088,3727,262,345,2350,4072,0.03332051355487,0.577111984282908
2013,47189,849,3067,511,1575,59,274,570,1849,0.0233633641222628,0.308274743104381
2013,48001,137,3715,78,610,7,83,85,693,0.0166915554699167,0.122655122655123
2013,48003,37,650,10,227,0,23,10,250,0.026618398637138,0.04
2013,48005,294,1969,136,688,62,140,198,828,0.0148387096774194,0.239130434782609
2013,48007,273,1320,29,299,1,14,30,313,0.0180237245191754,0.0958466453674121
2013,48009,14,138,11,58,0,2,11,60,0.00986031224322103,0.183333333333333
2013,48011,5,56,8,14,0,0,8,14,0.0111376292760541,0.571428571428571
2013,48013,126,991,68,372,16,31,84,403,0.0140633724176438,0.208436724565757
2013,48015,106,610,65,167,0,18,65,185,0.00976356343677433,0.351351351351351
2013,48017,82,339,0,48,22,22,22,70,0.0169985429820301,0.314285714285714
2013,48019,173,605,40,126,0,39,40,165,0.0105782792665726,0.242424242424242
2013,48021,438,2378,117,697,0,66,117,763,0.0153604573913394,0.153342070773263
2013,48023,95,143,7,35,0,0,7,35,0.0125944584382872,0.2
2013,48025,190,3258,19,358,65,128,84,486,0.0223726004695484,0.172839506172839
2013,48027,1588,5345,2546,9424,945,4023,3491,13447,0.071791997010224,0.2596118093255
2013,48029,7848,23955,9735,22863,3355,7638,13090,30501,0.0279739969587301,0.429166256844038
2013,48031,51,247,16,75,0,0,16,75,0.00978984466779794,0.213333333333333
2013,48033,7,41,0,0,0,2,0,2,0.00476190476190476,0
2013,48035,76,576,44,177,0,13,44,190,0.014809041309431,0.231578947368421
2013,48037,259,1588,480,2389,19,79,499,2468,0.0397020735807474,0.202188006482982
2013,48039,2363,9709,854,2391,186,577,1040,2968,0.0144708486509152,0.350404312668464
2013,48041,1305,5587,1299,2091,969,1376,2268,3467,0.0355320064771353,0.654167868474185
2013,48043,154,352,44,119,0,10,44,129,0.0201028517999065,0.341085271317829
2013,48045,0,18,14,26,0,0,14,26,0.0227670753064799,0.538461538461538
2013,48047,0,160,19,89,0,38,19,127,0.0284945030289432,0.149606299212598
2013,48049,199,975,7,66,0,9,7,75,0.00294904057879836,0.0933333333333333
2013,48051,102,470,0,85,0,7,0,92,0.00779528893407897,0
2013,48053,424,1805,48,355,0,91,48,446,0.0147506283899987,0.10762331838565
2013,48055,198,2260,51,328,46,107,97,435,0.0179811507936508,0.222988505747126
2013,48057,101,476,1,17,23,75,24,92,0.00655504096900606,0.260869565217391
2013,48059,59,487,12,93,0,34,12,127,0.0134719422934125,0.094488188976378
2013,48061,639,2593,588,2091,315,1416,903,3507,0.0149512071383807,0.25748502994012
2013,48063,33,224,0,98,0,62,0,160,0.0196367206676485,0
2013,48065,36,240,0,0,0,0,0,0,0,NA
2013,48067,74,466,26,380,0,56,26,436,0.0205699188526137,0.0596330275229358
2013,48069,22,115,0,75,0,10,0,85,0.0176421751764218,0
2013,48071,245,1043,23,362,12,15,35,377,0.0165597821312484,0.0928381962864721
2013,48073,215,1494,27,269,0,65,27,334,0.010160932128624,0.0808383233532934
2013,48075,52,459,36,112,0,1,36,113,0.0234927234927235,0.31858407079646
2013,48077,65,342,6,50,0,6,6,56,0.0074329705335811,0.107142857142857
2013,48079,5,75,0,35,0,28,0,63,0.0335284725918042,0
2013,48081,27,146,0,0,0,0,0,0,0,NA
2013,48083,0,106,0,44,0,3,0,47,0.00788458312363697,0
2013,48085,9745,22781,6894,13184,2390,3967,9284,17151,0.0328973489927093,0.541309544632966
2013,48087,17,120,0,62,0,0,0,62,0.0299806576402321,0
2013,48089,90,478,61,106,0,0,61,106,0.00737545226829947,0.575471698113208
2013,48091,1547,4499,572,1548,121,381,693,1929,0.0248563255418395,0.359253499222395
2013,48093,90,288,31,66,0,46,31,112,0.0118480905532635,0.276785714285714
2013,48095,8,213,0,337,23,181,23,518,0.155883238037918,0.0444015444015444
2013,48097,102,952,201,672,11,49,212,721,0.0283478807894944,0.294036061026352
2013,48099,311,2559,277,2063,138,1174,415,3237,0.0707834947847193,0.128205128205128
2013,48101,12,24,0,6,0,0,0,6,0.00530503978779841,0
2013,48103,24,140,14,68,0,0,14,68,0.0245753523671847,0.205882352941176
2013,48105,0,153,0,6,0,11,0,17,0.0065359477124183,0
2013,48107,12,200,12,44,0,17,12,61,0.0157459989674755,0.19672131147541
2013,48109,18,32,0,16,0,5,0,21,0.0139813581890812,0
2013,48111,41,250,14,128,4,88,18,216,0.0535050780282388,0.0833333333333333
2013,48113,15096,42314,11866,24777,4696,11343,16562,36120,0.0238739045400737,0.458527131782946
2013,48115,28,602,12,183,0,7,12,190,0.021264689423615,0.0631578947368421
2013,48117,29,456,2,103,0,37,2,140,0.0125989920806336,0.0142857142857143
2013,48119,9,194,0,9,0,0,0,9,0.00248138957816377,0
2013,48121,9417,24023,4979,11212,1456,2662,6435,13874,0.0321706990182302,0.463817212051319
2013,48123,91,1079,53,148,1,1,54,149,0.0103042876901798,0.36241610738255
2013,48125,2,200,0,14,0,21,0,35,0.0197183098591549,0
2013,48127,39,348,2,9,0,0,2,9,0.00146532074242918,0.222222222222222
2013,48129,45,114,5,18,0,0,5,18,0.00744109136006614,0.277777777777778
2013,48131,28,596,0,34,0,0,0,34,0.00450928381962865,0
2013,48133,72,371,0,197,17,66,17,263,0.0211755233494364,0.064638783269962
2013,48135,398,3122,276,1745,51,523,327,2268,0.0269042337394275,0.144179894179894
2013,48137,11,60,25,43,0,0,25,43,0.0292318150917743,0.581395348837209
2013,48139,861,4130,393,1126,12,151,405,1277,0.0134336208710288,0.317149569303054
2013,48141,1048,3488,3247,11754,1797,6766,5044,18520,0.0386444398538522,0.272354211663067
2013,48143,139,801,72,353,0,17,72,370,0.0166404317517427,0.194594594594595
2013,48145,137,733,0,62,0,6,0,68,0.0056300712038417,0
2013,48147,243,2077,43,410,14,50,57,460,0.01953125,0.123913043478261
2013,48149,73,438,52,142,6,74,58,216,0.0121889283900457,0.268518518518519
2013,48151,22,107,0,10,0,0,0,10,0.0037397157816006,0
2013,48153,18,64,0,21,7,7,7,28,0.00689825080068983,0.25
2013,48155,0,41,0,8,0,0,0,8,0.00944510035419126,0
2013,48157,5672,15408,2623,5382,1494,3390,4117,8772,0.0229617879411349,0.469334245326037
2013,48159,81,348,11,60,0,0,11,60,0.00827700372465168,0.183333333333333
2013,48161,132,985,27,157,0,20,27,177,0.0129121680770353,0.152542372881356
2013,48163,152,893,0,34,0,420,0,454,0.0415941365093907,0
2013,48165,73,338,0,170,0,101,0,271,0.0271216973578863,0
2013,48167,2790,8991,1282,3698,389,679,1671,4377,0.0223487362777636,0.381768334475668
2013,48169,26,336,74,664,0,138,74,802,0.170059372349449,0.0922693266832918
2013,48171,220,740,56,230,0,55,56,285,0.0154975530179445,0.196491228070175
2013,48173,2,14,0,0,0,0,0,0,0,NA
2013,48175,42,249,5,97,0,2,5,99,0.0192046556741028,0.0505050505050505
2013,48177,138,455,0,104,0,0,0,104,0.00819349247616797,0
2013,48179,152,1262,33,214,0,19,33,233,0.0152937315392189,0.141630901287554
2013,48181,549,2574,208,1289,53,132,261,1421,0.0175412608475601,0.183673469387755
2013,48183,667,3470,181,1086,105,401,286,1487,0.0190182636721748,0.192333557498319
2013,48185,115,1502,41,224,0,32,41,256,0.013882863340564,0.16015625
2013,48187,1036,3869,392,1565,95,173,487,1738,0.0199531594415871,0.280207134637514
2013,48189,157,1947,34,358,0,17,34,375,0.0173587001805305,0.0906666666666667
2013,48191,37,144,0,9,0,0,0,9,0.004102096627165,0
2013,48193,74,335,2,80,0,0,2,80,0.0133089336216936,0.025
2013,48195,11,119,0,87,0,0,0,87,0.0253866355412898,0
2013,48197,6,115,0,13,0,0,0,13,0.00444140758455757,0
2013,48199,176,1418,46,326,8,60,54,386,0.0105959537730929,0.139896373056995
2013,48201,16948,49447,18748,45810,11726,24877,30474,70687,0.0271736059240898,0.431111802736005
2013,48203,198,1312,185,660,24,72,209,732,0.0170438670019559,0.28551912568306
2013,48205,22,558,55,193,0,3,55,196,0.0431908329660643,0.280612244897959
2013,48207,13,316,0,55,0,0,0,55,0.0131390348781653,0
2013,48209,2039,6779,661,1731,141,298,802,2029,0.0213801751298722,0.395268605224248
2013,48211,0,100,0,46,0,0,0,46,0.0181245074862096,0
2013,48213,336,2188,127,925,27,193,154,1118,0.0204983406978237,0.137745974955277
2013,48215,959,6632,750,5134,799,3967,1549,9101,0.0210371322373652,0.170201076804747
2013,48217,188,1094,70,333,0,24,70,357,0.015048052604957,0.196078431372549
2013,48219,208,1009,0,176,27,40,27,216,0.0154716710837333,0.125
2013,48221,475,1617,72,455,20,292,92,747,0.0200536912751678,0.123159303882195
2013,48223,153,975,134,335,0,37,134,372,0.0158784360594161,0.360215053763441
2013,48225,75,879,46,166,0,1,46,167,0.00988750740082889,0.275449101796407
2013,48227,132,1569,43,626,18,114,61,740,0.0309830849104003,0.0824324324324324
2013,48229,12,152,5,65,0,32,5,97,0.0437725631768953,0.0515463917525773
2013,48231,445,2676,158,786,44,299,202,1085,0.0191902934257769,0.186175115207373
2013,48233,93,370,36,253,2,4,38,257,0.0178447437855853,0.147859922178988
2013,48235,5,50,0,42,0,0,0,42,0.0374665477252453,0
2013,48237,25,825,0,134,0,5,0,139,0.0225979515525931,0
2013,48239,31,317,10,142,0,11,10,153,0.0161784921222375,0.065359477124183
2013,48241,87,863,6,105,12,44,18,149,0.00616721854304636,0.120805369127517
2013,48243,29,92,17,22,0,0,17,22,0.0125284738041002,0.772727272727273
2013,48245,952,6927,824,2758,125,474,949,3232,0.0195473624366465,0.293626237623762
2013,48247,5,125,0,70,0,1,0,71,0.0214371980676329,0
2013,48249,112,817,0,216,0,29,0,245,0.00965365065605422,0
2013,48251,767,4668,119,774,12,327,131,1101,0.0112106710110987,0.118982742960945
2013,48253,41,2464,1,301,0,29,1,330,0.022456617897244,0.00303030303030303
2013,48255,61,863,0,103,0,89,0,192,0.0185256657661135,0
2013,48257,708,3752,143,1013,108,321,251,1334,0.0199372291137349,0.188155922038981
2013,48259,474,1579,226,438,0,72,226,510,0.0212819228843265,0.443137254901961
2013,48261,0,1,0,0,0,0,0,0,0,NA
2013,48263,19,43,0,25,0,0,0,25,0.0379939209726444,0
2013,48265,614,2035,215,503,50,77,265,580,0.0162337662337662,0.456896551724138
2013,48267,54,364,0,15,0,0,0,15,0.00423489553924337,0
2013,48269,0,16,0,1,0,0,0,1,0.00380228136882129,0
2013,48271,18,102,73,81,0,118,73,199,0.0779780564263323,0.366834170854271
2013,48273,416,808,56,155,0,0,56,155,0.00858297801650147,0.361290322580645
2013,48275,8,175,0,24,0,0,0,24,0.00920951650038373,0
2013,48277,176,1177,97,601,35,94,132,695,0.020990637269707,0.189928057553957
2013,48279,19,483,0,142,0,64,0,206,0.0239062318672392,0
2013,48281,141,670,18,106,35,86,53,192,0.0142995456915171,0.276041666666667
2013,48283,14,450,5,28,0,101,5,129,0.0302603800140746,0.0387596899224806
2013,48285,94,495,3,18,0,0,3,18,0.00131964809384164,0.166666666666667
2013,48287,33,617,17,144,0,0,17,144,0.0130671506352087,0.118055555555556
2013,48289,66,363,0,122,0,32,0,154,0.0129793510324484,0
2013,48291,347,5359,61,497,66,173,127,670,0.0135176031473822,0.18955223880597
2013,48293,51,771,11,156,0,90,11,246,0.0153653966271081,0.0447154471544715
2013,48295,12,105,16,82,0,0,16,82,0.0387340576287199,0.195121951219512
2013,48297,40,462,6,154,12,79,18,233,0.0275902901124926,0.0772532188841202
2013,48299,275,666,12,180,0,8,12,188,0.0124610591900312,0.0638297872340425
2013,48301,0,0,0,6,0,0,0,6,0.0789473684210526,0
2013,48303,1387,5959,1297,3201,347,566,1644,3767,0.0227409929489037,0.436421555614547
2013,48305,40,181,13,29,1,2,14,31,0.00814289466771736,0.451612903225806
2013,48307,42,379,0,11,0,0,0,11,0.00191104933981932,0
2013,48309,1322,4540,776,2228,130,417,906,2645,0.0184875829145377,0.342533081285444
2013,48311,0,5,0,14,0,0,0,14,0.0318181818181818,0
2013,48313,161,778,6,11,0,10,6,21,0.00236593059936909,0.285714285714286
2013,48315,108,418,0,99,0,6,0,105,0.0132827324478178,0
2013,48317,45,244,0,26,0,3,0,29,0.00962495851310986,0
2013,48319,21,98,9,9,0,0,9,9,0.00302216252518469,1
2013,48321,79,789,44,199,0,83,44,282,0.0118912080961417,0.156028368794326
2013,48323,23,501,13,311,28,340,41,651,0.0212059024723932,0.0629800307219662
2013,48325,203,1443,19,146,13,29,32,175,0.00574825909867297,0.182857142857143
2013,48327,6,79,0,26,0,7,0,33,0.0230446927374302,0
2013,48329,946,3195,637,2129,111,246,748,2375,0.0267877284006316,0.314947368421053
2013,48331,131,967,58,90,0,44,58,134,0.00803887455756194,0.432835820895522
2013,48333,22,94,0,0,13,13,13,13,0.003813435024934,1
2013,48335,100,869,0,46,0,30,0,76,0.0120101137800253,0
2013,48337,147,549,24,43,10,36,34,79,0.00576474022183304,0.430379746835443
2013,48339,4047,14076,2759,7106,1445,2847,4204,9953,0.0327275357839253,0.4223852104893
2013,48341,116,690,23,251,0,37,23,288,0.0224859462835728,0.0798611111111111
2013,48343,21,492,0,74,6,32,6,106,0.0119275346011027,0.0566037735849057
2013,48345,8,40,0,12,0,0,0,12,0.0164835164835165,0
2013,48347,399,1216,123,533,17,77,140,610,0.0166589289128001,0.229508196721311
2013,48349,136,980,81,326,16,43,97,369,0.0120121097691982,0.262872628726287
2013,48351,63,698,0,22,0,6,0,28,0.00287091151440582,0
2013,48353,4,268,7,119,0,18,7,137,0.0140354471877881,0.0510948905109489
2013,48355,1591,7852,1529,3963,296,825,1825,4788,0.0217581968144328,0.381161236424394
2013,48357,51,286,31,251,6,6,37,257,0.0417072379097696,0.143968871595331
2013,48359,9,51,0,19,0,0,0,19,0.0147286821705426,0
2013,48361,329,1924,177,620,40,158,217,778,0.0142363080751706,0.27892030848329
2013,48363,159,798,19,121,0,7,19,128,0.00681685040208766,0.1484375
2013,48365,39,476,0,126,0,18,0,144,0.00903444381705251,0
2013,48367,576,4610,374,1160,0,122,374,1282,0.01631230039063,0.291731669266771
2013,48369,66,274,27,120,0,64,27,184,0.0303580267282627,0.146739130434783
2013,48371,42,951,1,122,0,22,1,144,0.0138474853351284,0.00694444444444444
2013,48373,190,1934,55,228,16,180,71,408,0.0125488266231969,0.174019607843137
2013,48375,847,4969,234,1544,50,686,284,2230,0.0294082738793865,0.127354260089686
2013,48377,92,267,18,31,8,21,26,52,0.0104669887278583,0.5
2013,48379,7,411,0,43,0,0,0,43,0.00539658634538153,0
2013,48381,896,3802,275,949,27,120,302,1069,0.0134622892188346,0.282507015902713
2013,48383,26,131,6,16,0,5,6,21,0.00984990619136961,0.285714285714286
2013,48385,37,203,0,2,0,0,0,2,0.000806776926179911,0
2013,48387,93,409,26,99,0,42,26,141,0.0152317165388355,0.184397163120567
2013,48389,66,799,1,162,0,130,1,292,0.0319090809747569,0.00342465753424658
2013,48391,3,209,0,17,1,1,1,18,0.00362976406533575,0.0555555555555556
2013,48393,4,35,6,25,0,0,6,25,0.0349162011173184,0.24
2013,48395,113,426,19,74,0,2,19,76,0.00692861701157808,0.25
2013,48397,828,2599,368,992,48,158,416,1150,0.0221725214977056,0.361739130434783
2013,48399,8,74,0,11,0,3,0,14,0.0019951546244834,0
2013,48401,276,4402,5,247,15,31,20,278,0.00764135125477584,0.0719424460431655
2013,48403,67,310,6,95,0,7,6,102,0.013030148185999,0.0588235294117647
2013,48405,16,276,10,18,0,0,10,18,0.00283152430391694,0.555555555555556
2013,48407,66,968,0,415,0,0,0,415,0.0227684204751193,0
2013,48409,316,2152,84,614,62,154,146,768,0.0186697782963827,0.190104166666667
2013,48411,20,259,0,48,0,0,0,48,0.0111757857974389,0
2013,48413,0,61,18,25,0,0,18,25,0.0128139415684264,0.72
2013,48415,61,745,0,74,0,18,0,92,0.0083175119790254,0
2013,48417,11,39,1,11,20,27,21,38,0.0165002171081198,0.552631578947368
2013,48419,17,346,3,162,0,31,3,193,0.0117318096164367,0.0155440414507772
2013,48421,13,122,11,26,6,6,17,32,0.0173818576860402,0.53125
2013,48423,1648,6035,1137,2501,136,340,1273,2841,0.0209558091332217,0.448081661386836
2013,48425,32,280,14,92,0,54,14,146,0.0257178087017791,0.0958904109589041
2013,48427,54,652,13,232,36,266,49,498,0.0147350356540521,0.0983935742971888
2013,48429,79,565,18,123,25,25,43,148,0.0233364869126459,0.290540540540541
2013,48431,3,21,0,25,0,0,0,25,0.0288350634371396,0
2013,48433,0,22,0,1,0,0,0,1,0.00099403578528827,0
2013,48435,43,124,0,0,0,0,0,0,0,NA
2013,48437,9,434,3,62,0,18,3,80,0.0161779575328615,0.0375
2013,48439,10587,34974,7866,22077,2542,6701,10408,28778,0.0248212238800563,0.361665160886789
2013,48441,602,2941,499,1370,31,428,530,1798,0.0222888877869787,0.294771968854283
2013,48443,10,63,0,0,0,0,0,0,0,NA
2013,48445,50,748,16,146,14,37,30,183,0.0224953902888752,0.163934426229508
2013,48447,7,23,0,3,0,1,0,4,0.00337268128161889,0
2013,48449,107,649,67,363,5,87,72,450,0.0233814818663618,0.16
2013,48451,712,3053,798,2538,148,345,946,2883,0.0409267066990333,0.3281304197017
2013,48453,10874,25131,11764,20190,3396,6242,15160,26432,0.0384621540959895,0.573547215496368
2013,48455,30,353,6,59,0,52,6,111,0.0106413574920909,0.0540540540540541
2013,48457,81,777,44,189,0,0,44,189,0.0122544252091033,0.232804232804233
2013,48459,96,1357,47,376,0,7,47,383,0.01437202146422,0.122715404699739
2013,48461,10,112,0,42,0,0,0,42,0.0195804195804196,0
2013,48463,101,418,0,185,0,43,0,228,0.0140126605617356,0
2013,48465,159,735,140,511,10,221,150,732,0.025237898220935,0.204918032786885
2013,48467,95,1299,4,167,9,48,13,215,0.00593676653320447,0.0604651162790698
2013,48469,315,1653,160,859,29,90,189,949,0.0167351473363077,0.199157007376185
2013,48471,432,4872,41,264,75,75,116,339,0.00771225771225771,0.342182890855457
2013,48473,123,1249,28,152,0,25,28,177,0.0071781977451537,0.15819209039548
2013,48475,24,305,5,141,0,0,5,141,0.0205150589262331,0.0354609929078014
2013,48477,201,657,34,70,0,65,34,135,0.00596843361775498,0.251851851851852
2013,48479,428,1923,242,959,584,1858,826,2817,0.0204866767512218,0.293219737309194
2013,48481,25,425,30,170,6,31,36,201,0.00755809581108521,0.17910447761194
2013,48483,5,178,3,77,0,0,3,77,0.0205717339032861,0.038961038961039
2013,48485,516,2920,282,2218,167,427,449,2645,0.0318778397792053,0.169754253308129
2013,48487,54,495,69,194,0,21,69,215,0.0249362096961262,0.32093023255814
2013,48489,27,1119,24,183,0,174,24,357,0.0264405273292845,0.0672268907563025
2013,48491,7063,19134,4045,9481,582,1797,4627,11278,0.0398785045737583,0.410267777974818
2013,48493,144,1315,83,312,20,77,103,389,0.013369994844475,0.264781491002571
2013,48495,61,291,0,84,5,29,5,113,0.0254963898916968,0.0442477876106195
2013,48497,523,1795,51,691,0,143,51,834,0.0211439002129601,0.0611510791366906
2013,48499,221,1679,82,393,0,20,82,413,0.0135383203304268,0.198547215496368
2013,48501,0,105,0,51,0,45,0,96,0.0199667221297837,0
2013,48503,73,358,59,189,0,14,59,203,0.0161534176812286,0.29064039408867
2013,48505,0,82,1,183,0,0,1,183,0.023392560398824,0.00546448087431694
2013,48507,9,267,4,43,0,39,4,82,0.0121158392434988,0.0487804878048781
2013,49001,0,131,0,107,0,0,0,107,0.0278791036998437,0
2013,49003,219,757,118,551,26,68,144,619,0.021248112041741,0.232633279483037
2013,49005,545,1361,519,1413,267,346,786,1759,0.0305450883011791,0.446844798180785
2013,49007,18,280,8,137,4,28,12,165,0.0124032173194016,0.0727272727272727
2013,49009,10,41,9,9,0,0,9,9,0.0152284263959391,1
2013,49011,2310,6237,1344,3681,325,792,1669,4473,0.0253416275749541,0.373127654817796
2013,49013,41,281,28,192,0,0,28,192,0.0175663311985361,0.145833333333333
2013,49015,48,235,46,246,0,0,46,246,0.0372557928214448,0.186991869918699
2013,49017,22,129,40,152,3,3,43,155,0.0459531574266232,0.27741935483871
2013,49019,1,61,85,175,0,2,85,177,0.0274631497284717,0.480225988700565
2013,49021,83,583,117,423,8,33,125,456,0.018535831876753,0.274122807017544
2013,49023,23,135,0,67,11,13,11,80,0.0140696447414703,0.1375
2013,49025,31,155,76,242,0,0,76,242,0.0479397781299525,0.31404958677686
2013,49027,128,242,49,150,2,31,51,181,0.023951303427286,0.281767955801105
2013,49029,25,148,38,67,0,0,38,67,0.0121906841339156,0.567164179104478
2013,49031,3,11,14,21,0,0,14,21,0.0181660899653979,0.666666666666667
2013,49033,0,55,0,27,0,0,0,27,0.0190007037297678,0
2013,49035,4184,11121,6286,15062,1299,3584,7585,18646,0.029246608861506,0.406789659980693
2013,49037,45,173,133,198,0,0,133,198,0.0238095238095238,0.671717171717172
2013,49039,154,1060,40,232,0,4,40,236,0.0153796024763767,0.169491525423729
2013,49041,28,502,19,143,0,0,19,143,0.0113393069542463,0.132867132867133
2013,49043,342,721,498,875,70,149,568,1024,0.042058569844334,0.5546875
2013,49045,249,1455,292,874,52,81,344,955,0.0287019505304601,0.36020942408377
2013,49047,128,671,157,534,13,20,170,554,0.0285331685208076,0.306859205776173
2013,49049,1814,6207,3070,7179,742,1584,3812,8763,0.0340468022115075,0.435010841036175
2013,49051,153,471,163,368,26,65,189,433,0.030343377715487,0.4364896073903
2013,49053,736,2109,1029,3124,196,318,1225,3442,0.0397928275798284,0.355897733875654
2013,49055,4,20,15,35,0,37,15,72,0.0408163265306122,0.208333333333333
2013,49057,947,4759,677,2411,14,390,691,2801,0.0199271495852364,0.246697607997144
2013,50001,175,568,278,475,38,117,316,592,0.0238777074174162,0.533783783783784
2013,50003,13,147,238,697,0,4,238,701,0.0268222689879472,0.339514978601997
2013,50005,95,413,223,479,29,66,252,545,0.0253323417309659,0.462385321100917
2013,50007,548,1445,1723,2624,251,414,1974,3038,0.0297592226162255,0.649769585253456
2013,50009,8,92,36,113,5,5,41,118,0.0251599147121535,0.347457627118644
2013,50011,168,531,98,302,8,26,106,328,0.00998447535843658,0.323170731707317
2013,50013,50,175,42,95,0,10,42,105,0.0203016241299304,0.4
2013,50015,107,414,338,543,46,113,384,656,0.0388648616624208,0.585365853658537
2013,50017,131,411,181,281,16,25,197,306,0.0148004836759371,0.643790849673203
2013,50019,77,429,121,373,9,12,130,385,0.0198433151221524,0.337662337662338
2013,50021,119,445,490,1041,26,66,516,1107,0.0254062241806665,0.466124661246612
2013,50023,330,695,456,742,34,59,490,801,0.0191493939611274,0.611735330836454
2013,50025,85,337,490,934,54,107,544,1041,0.0325393848462115,0.522574447646494
2013,50027,235,617,1009,1749,53,107,1062,1856,0.0443902322355361,0.572198275862069
2013,51001,84,197,118,328,80,136,198,464,0.0194647201946472,0.426724137931034
2013,51003,1123,2341,1749,2235,335,480,2084,2715,0.0405957026869421,0.767587476979742
2013,51005,32,523,25,56,0,0,25,56,0.00472215195210389,0.446428571428571
2013,51007,26,253,0,78,0,17,0,95,0.0105239836047413,0
2013,51009,49,500,84,226,0,30,84,256,0.0114659381018498,0.328125
2013,51011,3,142,9,60,0,0,9,60,0.00562060889929742,0.15
2013,51013,4441,6578,9573,11615,2082,2750,11655,14365,0.0890455114615489,0.811347024016707
2013,51015,264,1670,172,306,76,87,248,393,0.00743881433249418,0.631043256997455
2013,51017,0,210,0,21,0,0,0,21,0.00609933197792623,0
2013,51019,461,1764,118,474,41,49,159,523,0.0105780510497148,0.304015296367113
2013,51021,30,305,29,97,0,0,29,97,0.0188642551536367,0.298969072164948
2013,51023,139,728,56,148,0,0,56,148,0.00623210375610578,0.378378378378378
2013,51025,48,373,0,92,0,5,0,97,0.00797172912557528,0
2013,51027,42,215,14,194,0,0,14,194,0.0109246536772159,0.0721649484536082
2013,51029,50,715,3,89,0,16,3,105,0.00840537944284342,0.0285714285714286
2013,51031,340,1365,212,405,0,6,212,411,0.010782873334033,0.515815085158151
2013,51033,104,1045,78,317,0,12,78,329,0.0168183212350475,0.237082066869301
2013,51035,14,331,39,240,0,8,39,248,0.011326786937657,0.157258064516129
2013,51036,22,141,21,45,0,6,21,51,0.00935779816513761,0.411764705882353
2013,51037,31,186,2,12,0,2,2,14,0.00162620513416192,0.142857142857143
2013,51041,1800,5919,1958,4180,354,667,2312,4847,0.023047259482566,0.476996080049515
2013,51043,123,508,86,185,0,0,86,185,0.01823738170347,0.464864864864865
2013,51045,24,41,0,0,0,0,0,0,0,NA
2013,51047,267,1520,216,538,9,9,225,547,0.0173860530163372,0.411334552102377
2013,51049,84,248,0,56,11,11,11,67,0.0099009900990099,0.164179104477612
2013,51051,59,348,0,37,0,0,0,37,0.00326826252097871,0
2013,51053,28,612,37,146,0,8,37,154,0.00796895213454075,0.24025974025974
2013,51057,39,231,33,53,0,14,33,67,0.00869678089304258,0.492537313432836
2013,51059,11124,18179,17031,23946,6165,9884,23196,33830,0.0452040663616539,0.68566361217854
2013,51061,628,1755,288,685,41,125,329,810,0.0180884323358642,0.406172839506173
2013,51063,71,210,104,185,0,0,104,185,0.0165949049156799,0.562162162162162
2013,51065,253,987,49,220,0,0,49,220,0.0119747441759199,0.222727272727273
2013,51067,200,1164,133,455,0,31,133,486,0.012128471962267,0.273662551440329
2013,51069,684,2599,332,975,40,133,372,1108,0.0205806415662091,0.335740072202166
2013,51071,32,189,13,199,6,37,19,236,0.0195121951219512,0.0805084745762712
2013,51073,189,744,104,404,53,296,157,700,0.0269957578094871,0.224285714285714
2013,51075,112,609,151,175,8,12,159,187,0.0116794703641247,0.850267379679144
2013,51077,11,241,6,117,0,2,6,119,0.0103730822873082,0.0504201680672269
2013,51079,87,587,95,236,20,63,115,299,0.0237546675141019,0.384615384615385
2013,51081,26,667,0,97,0,0,0,97,0.0108331471967836,0
2013,51083,73,355,52,391,5,12,57,403,0.0158281292957857,0.141439205955335
2013,51085,912,2449,331,981,48,100,379,1081,0.0160402415681154,0.350601295097132
2013,51087,3478,10190,2229,3911,774,1602,3003,5513,0.026108782647818,0.544712497732632
2013,51089,93,866,10,529,0,35,10,564,0.0145962732919255,0.0177304964539007
2013,51091,8,40,6,25,0,0,6,25,0.0134264232008593,0.24
2013,51093,222,966,133,351,13,147,146,498,0.0198961246504195,0.293172690763052
2013,51095,625,1970,727,1362,136,216,863,1578,0.0323221564490691,0.546894803548796
2013,51097,20,88,14,65,0,0,14,65,0.012770137524558,0.215384615384615
2013,51099,112,786,209,639,6,63,215,702,0.04496253122398,0.306267806267806
2013,51101,73,351,39,114,0,16,39,130,0.0119573215599706,0.3
2013,51103,74,219,41,134,22,48,63,182,0.020497803806735,0.346153846153846
2013,51105,19,221,44,423,0,53,44,476,0.0257924681658087,0.092436974789916
2013,51107,5011,7549,3219,5266,850,2043,4069,7309,0.0352669265807149,0.556710904364482
2013,51109,126,570,67,254,9,25,76,279,0.011679993301796,0.272401433691756
2013,51111,54,360,22,122,0,7,22,129,0.0140095569070374,0.170542635658915
2013,51113,120,540,31,81,0,0,31,81,0.00860512057792415,0.382716049382716
2013,51115,72,197,6,39,0,0,6,39,0.00565217391304348,0.153846153846154
2013,51117,71,586,74,277,17,47,91,324,0.0137480375100777,0.280864197530864
2013,51119,24,231,59,108,0,0,59,108,0.0128510233222275,0.546296296296296
2013,51121,736,1953,1021,1531,349,498,1370,2029,0.0401535690961984,0.675209462789552
2013,51125,123,401,57,145,0,0,57,145,0.0130513051305131,0.393103448275862
2013,51127,269,1207,24,111,12,16,36,127,0.00948752427909757,0.283464566929134
2013,51131,64,247,11,65,0,1,11,66,0.00723604867887293,0.166666666666667
2013,51133,34,186,36,93,7,7,43,100,0.0102944204241301,0.43
2013,51135,161,742,9,88,0,19,9,107,0.00953399269357569,0.0841121495327103
2013,51137,351,1420,85,217,0,47,85,264,0.0110225042795708,0.321969696969697
2013,51139,50,342,44,145,15,15,59,160,0.00937316930287053,0.36875
2013,51141,56,465,0,104,0,0,0,104,0.00757299934464429,0
2013,51143,252,1429,35,426,0,19,35,445,0.00979852471650336,0.0786516853932584
2013,51145,350,1260,52,378,0,17,52,395,0.0197125461622916,0.131645569620253
2013,51147,44,503,232,389,5,26,237,415,0.032454836943771,0.571084337349398
2013,51149,150,1452,280,1230,73,223,353,1453,0.0583768581759743,0.24294562973159
2013,51153,4082,11700,3582,8225,857,1908,4439,10133,0.038826134935475,0.438073620842791
2013,51155,256,1181,76,194,0,0,76,194,0.00760307258190939,0.391752577319588
2013,51157,16,102,28,90,28,28,56,118,0.0214662543205385,0.474576271186441
2013,51159,47,247,0,78,0,12,0,90,0.0129477772982305,0
2013,51161,926,3356,552,1186,44,93,596,1279,0.0193447879484542,0.465989053948397
2013,51163,150,437,47,278,34,35,81,313,0.0189788988600534,0.258785942492013
2013,51165,477,1623,276,607,37,93,313,700,0.0134944961733464,0.447142857142857
2013,51167,57,339,24,210,0,1,24,211,0.0101701450812166,0.113744075829384
2013,51169,34,348,20,288,0,4,20,292,0.0173273201993829,0.0684931506849315
2013,51171,380,1131,106,862,24,80,130,942,0.0314020934728982,0.138004246284501
2013,51173,24,480,208,571,7,60,215,631,0.0276209236156708,0.340729001584786
2013,51175,66,670,9,101,3,29,12,130,0.00979210605604098,0.0923076923076923
2013,51177,589,2949,576,1794,64,193,640,1987,0.0248458854863516,0.322093608454957
2013,51179,1071,3692,1773,3900,217,534,1990,4434,0.0541914667383679,0.448804691023906
2013,51181,37,198,0,45,0,0,0,45,0.009076240419524,0
2013,51183,50,698,14,49,0,4,14,53,0.00580567422499726,0.264150943396226
2013,51185,47,517,58,562,0,32,58,594,0.0184237461617195,0.0976430976430976
2013,51187,200,1043,215,477,27,35,242,512,0.0198796350223258,0.47265625
2013,51191,270,806,248,808,72,98,320,906,0.0228695476575121,0.353200883002208
2013,51193,151,546,29,196,11,26,40,222,0.0175120296600142,0.18018018018018
2013,51195,20,670,56,527,0,44,56,571,0.0200907779458851,0.0980735551663748
2013,51197,27,282,0,121,0,29,0,150,0.00711001564203441,0
2013,51199,674,1771,762,1843,148,503,910,2346,0.0543470706789909,0.387894288150043
2013,51510,3772,6165,5880,7850,1517,2325,7397,10175,0.0932493859745592,0.726977886977887
2013,51515,28,298,20,64,0,0,20,64,0.0145256468452111,0.3125
2013,51520,74,611,146,691,0,6,146,697,0.0556353767560664,0.209469153515065
2013,51530,33,234,27,77,0,0,27,77,0.0177092916283349,0.350649350649351
2013,51540,891,2017,856,1086,253,562,1109,1648,0.064339814164129,0.672936893203884
2013,51550,1729,7518,1778,4507,192,584,1970,5091,0.034555080431684,0.386957375761147
2013,51570,75,474,66,202,0,15,66,217,0.0180562489598935,0.304147465437788
2013,51580,11,465,8,24,0,10,8,34,0.00851703406813627,0.235294117647059
2013,51590,202,1404,183,838,30,96,213,934,0.0316556515844772,0.228051391862955
2013,51595,81,221,0,36,0,26,0,62,0.0156486622917718,0
2013,51600,797,1347,344,414,240,293,584,707,0.0441406006118499,0.826025459688826
2013,51610,414,630,504,598,174,283,678,881,0.102537243947858,0.769580022701476
2013,51620,23,404,0,117,0,9,0,126,0.0222065562213606,0
2013,51630,546,1742,199,619,0,68,199,687,0.0464911687081275,0.289665211062591
2013,51640,19,315,17,71,4,4,21,75,0.0147434637310792,0.28
2013,51650,533,3306,654,2127,148,512,802,2639,0.0296323744076894,0.303902993558166
2013,51660,811,2358,437,841,129,292,566,1133,0.0500596474174877,0.499558693733451
2013,51670,82,654,65,181,9,9,74,190,0.0128473865711001,0.389473684210526
2013,51678,59,92,23,48,18,25,41,73,0.0316154179298398,0.561643835616438
2013,51680,583,2809,537,977,176,281,713,1258,0.0290122460275363,0.566772655007949
2013,51683,637,2195,77,434,11,151,88,585,0.0240691215799218,0.15042735042735
2013,51685,295,883,135,274,7,73,142,347,0.037124210976784,0.409221902017291
2013,51690,43,774,28,167,0,11,28,178,0.0183637676673888,0.157303370786517
2013,51700,1125,5004,1490,4846,289,831,1779,5677,0.0500586383556571,0.313369737537432
2013,51710,1703,6914,1724,4851,461,888,2185,5739,0.0392874990587156,0.38072834988674
2013,51720,20,176,0,72,0,0,0,72,0.0271800679501699,0
2013,51730,176,754,100,360,71,90,171,450,0.0205366922234392,0.38
2013,51735,78,381,110,126,0,0,110,126,0.0151333173192409,0.873015873015873
2013,51740,609,3740,327,1242,38,101,365,1343,0.0213002172844205,0.271779597915115
2013,51750,85,460,87,203,0,0,87,203,0.0303075544938788,0.428571428571429
2013,51760,2780,7375,2004,3570,259,602,2263,4172,0.0308265232233371,0.542425695110259
2013,51770,784,3361,632,1296,25,310,657,1606,0.0237268604015542,0.409090909090909
2013,51775,286,1160,78,183,108,153,186,336,0.0202129579498285,0.553571428571429
2013,51790,286,1168,61,231,20,35,81,266,0.0157433712121212,0.304511278195489
2013,51800,496,1961,540,1387,58,152,598,1539,0.0276182614313402,0.38856400259909
2013,51810,2232,9195,3775,10219,823,2055,4598,12274,0.0422524544565771,0.374613003095975
2013,51820,91,701,58,247,0,0,58,247,0.0171171171171171,0.234817813765182
2013,51830,405,834,186,325,61,106,247,431,0.0616595135908441,0.573085846867749
2013,51840,329,1741,107,425,12,37,119,462,0.026594519917108,0.257575757575758
2013,53001,54,239,25,122,0,26,25,148,0.0142746913580247,0.168918918918919
2013,53003,64,262,146,849,0,11,146,860,0.0560808607760026,0.169767441860465
2013,53005,955,3206,1413,3327,306,671,1719,3998,0.0349454141792023,0.429964982491246
2013,53007,366,1620,173,500,11,98,184,598,0.012303007859112,0.307692307692308
2013,53009,322,1357,423,1651,26,119,449,1770,0.0330273175100761,0.253672316384181
2013,53011,672,3473,2933,10746,423,1121,3356,11867,0.0418690968877787,0.282801044914469
2013,53013,16,141,2,27,2,17,4,44,0.0146813480146813,0.0909090909090909
2013,53015,306,1454,333,1563,76,143,409,1706,0.0245559489881107,0.239742086752638
2013,53017,201,1346,109,350,23,115,132,465,0.018512620431563,0.283870967741935
2013,53019,40,276,6,142,0,6,6,148,0.027255985267035,0.0405405405405405
2013,53021,360,2587,222,889,12,100,234,989,0.0215745729805196,0.236602628918099
2013,53023,8,8,0,83,0,0,0,83,0.0480602200347423,0
2013,53025,293,1251,179,827,40,119,219,946,0.0176190121433361,0.231501057082452
2013,53027,148,2101,95,651,0,94,95,745,0.0147099474785768,0.12751677852349
2013,53029,517,1639,618,2383,231,481,849,2864,0.0513022605954215,0.296438547486034
2013,53031,412,1050,171,752,29,76,200,828,0.0345633661713141,0.241545893719807
2013,53033,7327,22089,22763,39048,9304,13997,32067,53045,0.0385568703843694,0.604524460363842
2013,53035,953,3437,2345,5611,608,1422,2953,7033,0.041189355072973,0.419877719323191
2013,53037,365,1175,181,445,30,52,211,497,0.0203638449561583,0.424547283702213
2013,53039,145,346,45,255,4,22,49,277,0.01875169239101,0.176895306859206
2013,53041,415,2132,71,661,0,148,71,809,0.0155816640986133,0.0877626699629172
2013,53043,5,178,29,96,2,8,31,104,0.0138777688817721,0.298076923076923
2013,53045,255,1920,133,589,9,64,142,653,0.0149005111354509,0.217457886676876
2013,53047,71,704,138,402,28,122,166,524,0.0184767277856135,0.316793893129771
2013,53049,73,463,102,427,0,17,102,444,0.0281565096074577,0.22972972972973
2013,53051,31,168,66,253,0,7,66,260,0.0273943736171109,0.253846153846154
2013,53053,2846,14963,4608,12848,1061,3608,5669,16456,0.0312453125385677,0.344494409333982
2013,53055,120,298,181,336,10,39,191,375,0.0296888607394506,0.509333333333333
2013,53057,664,2451,479,1670,66,269,545,1939,0.0241220158491223,0.281072717895823
2013,53059,29,222,25,194,3,19,28,213,0.0268701904882049,0.131455399061033
2013,53061,4900,15572,3748,9877,708,2302,4456,12179,0.0250015396300782,0.365875687659085
2013,53063,1097,5425,2379,6970,334,1037,2713,8007,0.0256477605055879,0.338828525040589
2013,53065,86,678,141,502,27,122,168,624,0.0204221894943544,0.269230769230769
2013,53067,1471,5951,2058,4962,654,2017,2712,6979,0.0400360261131954,0.388594354492048
2013,53069,0,17,8,21,0,0,8,21,0.00699067909454061,0.380952380952381
2013,53071,327,1517,203,1070,75,123,278,1193,0.0313213788757909,0.233025984911987
2013,53073,602,1986,810,2313,359,773,1169,3086,0.0234900095147479,0.378807517822424
2013,53075,401,718,633,960,118,186,751,1146,0.0525929325378614,0.655322862129145
2013,53077,394,2128,551,2159,47,383,598,2542,0.01740070917131,0.235247836349331
2013,54001,8,155,13,210,0,0,13,210,0.0185070943861814,0.0619047619047619
2013,54003,245,1337,478,2482,11,113,489,2595,0.036413386655441,0.188439306358381
2013,54005,43,346,0,213,12,26,12,239,0.0139676231663842,0.0502092050209205
2013,54007,94,302,8,122,4,4,12,126,0.0120701216591628,0.0952380952380952
2013,54009,43,306,37,434,0,0,37,434,0.0252516436841799,0.0852534562211982
2013,54011,301,1333,558,2316,33,128,591,2444,0.0374140807984936,0.241816693944354
2013,54013,38,287,24,109,0,0,24,109,0.0197178002894356,0.220183486238532
2013,54015,0,178,0,9,0,0,0,9,0.00137783221065524,0
2013,54017,44,323,27,60,0,0,27,60,0.0103573278094252,0.45
2013,54019,32,436,56,290,5,8,61,298,0.00906629346800937,0.204697986577181
2013,54021,61,472,70,373,9,40,79,413,0.0669476414329713,0.191283292978208
2013,54023,0,91,11,20,0,23,11,43,0.00500873616773442,0.255813953488372
2013,54025,36,389,306,673,15,15,321,688,0.0266759722383777,0.46656976744186
2013,54027,25,228,11,299,0,0,11,299,0.0176661742983752,0.0367892976588629
2013,54029,89,378,138,744,0,35,138,779,0.0348389982110912,0.177150192554557
2013,54031,1,132,41,363,0,33,41,396,0.0401378471518346,0.103535353535354
2013,54033,133,871,235,679,9,9,244,688,0.014042249209103,0.354651162790698
2013,54035,89,572,36,250,0,0,36,250,0.0122735529481074,0.144
2013,54037,96,476,456,1375,86,193,542,1568,0.0435084214323372,0.345663265306122
2013,54039,717,2636,589,2226,23,154,612,2380,0.0172977687331928,0.257142857142857
2013,54041,33,210,23,285,6,6,29,291,0.0246047180180942,0.0996563573883162
2013,54043,6,392,0,56,0,27,0,83,0.00546700039520485,0
2013,54045,67,430,14,409,38,38,52,447,0.0170033093689376,0.116331096196868
2013,54047,8,164,1,267,0,0,1,267,0.0170074527039939,0.00374531835205993
2013,54049,172,530,169,507,2,18,171,525,0.0133645597332179,0.325714285714286
2013,54051,40,378,69,392,8,8,77,400,0.0168940321831313,0.1925
2013,54053,65,394,63,469,0,0,63,469,0.0241727656942583,0.134328358208955
2013,54055,92,812,219,908,0,58,219,966,0.0220764677651576,0.226708074534162
2013,54057,30,320,27,371,0,0,27,371,0.0190843621399177,0.0727762803234501
2013,54059,35,156,13,306,0,31,13,337,0.01808910359635,0.0385756676557863
2013,54061,412,1142,1125,1916,193,284,1318,2200,0.0383850368147399,0.599090909090909
2013,54063,49,178,25,162,0,9,25,171,0.0173656951355743,0.146198830409357
2013,54065,33,115,43,626,6,6,49,632,0.0491293532338308,0.0775316455696203
2013,54067,51,302,15,325,0,26,15,351,0.0187580162462591,0.0427350427350427
2013,54069,134,497,293,799,34,81,327,880,0.0286560943046013,0.371590909090909
2013,54071,15,75,4,43,0,9,4,52,0.00926585887384177,0.0769230769230769
2013,54073,12,359,4,65,0,0,4,65,0.0118851709636131,0.0615384615384615
2013,54075,29,186,21,109,3,3,24,112,0.0170342205323194,0.214285714285714
2013,54077,61,706,123,606,0,25,123,631,0.0256545779801594,0.194928684627575
2013,54079,295,907,131,376,32,82,163,458,0.0116726559115121,0.35589519650655
2013,54081,268,1474,124,1088,5,135,129,1223,0.0218342170567547,0.105478331970564
2013,54083,106,787,56,141,0,13,56,154,0.00728304563726649,0.363636363636364
2013,54085,0,121,22,70,0,0,22,70,0.0094365057967107,0.314285714285714
2013,54087,51,212,9,107,0,5,9,112,0.0105880128568728,0.0803571428571429
2013,54089,23,393,54,606,0,7,54,613,0.0583642768732743,0.0880913539967374
2013,54091,62,397,0,45,7,26,7,71,0.00581681140422743,0.0985915492957746
2013,54093,17,99,2,69,0,0,2,69,0.0131880733944954,0.0289855072463768
2013,54095,20,88,0,72,0,34,0,106,0.0160411622276029,0
2013,54097,33,290,45,356,0,0,45,356,0.0215118738292344,0.126404494382022
2013,54099,75,310,36,484,12,12,48,496,0.0167805670207727,0.0967741935483871
2013,54101,19,163,0,13,0,0,0,13,0.00198170731707317,0
2013,54103,1,125,13,88,0,6,13,94,0.00794388574326037,0.138297872340426
2013,54105,0,108,0,32,0,0,0,32,0.00773507372492144,0
2013,54107,149,576,253,1256,0,67,253,1323,0.0215553057334181,0.191232048374906
2013,54109,0,201,17,44,0,0,17,44,0.00263931377841761,0.386363636363636
2013,55001,97,747,43,299,4,28,47,327,0.0201441508039179,0.143730886850153
2013,55003,48,258,25,113,0,6,25,119,0.0109798855877468,0.210084033613445
2013,55005,117,915,57,378,29,40,86,418,0.0129151861578866,0.205741626794258
2013,55007,100,359,129,207,0,2,129,209,0.0182293938072394,0.617224880382775
2013,55009,729,3342,839,1883,247,480,1086,2363,0.0143930903420719,0.459585272958104
2013,55011,73,219,16,137,4,9,20,146,0.0152353125326098,0.136986301369863
2013,55013,29,234,99,283,2,12,101,295,0.0252568493150685,0.342372881355932
2013,55015,306,1240,53,130,14,17,67,147,0.00448389458272328,0.45578231292517
2013,55017,295,2052,59,413,0,0,59,413,0.00951569052117414,0.142857142857143
2013,55019,69,484,39,143,3,32,42,175,0.0080036588154585,0.24
2013,55021,372,1653,123,371,8,42,131,413,0.0104195574841688,0.317191283292978
2013,55023,34,405,60,189,0,2,60,191,0.0161508540503974,0.31413612565445
2013,55025,2503,6565,5443,7997,1119,1949,6562,9946,0.0306983835970752,0.659762718680877
2013,55027,459,3285,132,611,11,22,143,633,0.0101153760107386,0.225908372827804
2013,55029,134,389,106,396,18,21,124,417,0.0195115103874228,0.297362110311751
2013,55031,68,362,280,964,18,27,298,991,0.0326265885296635,0.300706357214934
2013,55033,263,965,87,317,3,45,90,362,0.0137485757690847,0.248618784530387
2013,55035,446,1618,412,782,61,130,473,912,0.0148488252820788,0.518640350877193
2013,55037,26,98,0,34,1,7,1,41,0.0121122599704579,0.024390243902439
2013,55039,406,1673,179,513,42,135,221,648,0.0092660117541075,0.341049382716049
2013,55041,18,160,4,33,3,9,7,42,0.00642791551882461,0.166666666666667
2013,55043,126,919,118,266,9,54,127,320,0.010137489704112,0.396875
2013,55045,185,740,95,262,5,13,100,275,0.0107619457597934,0.363636363636364
2013,55047,124,446,18,53,4,8,22,61,0.00452858203414996,0.360655737704918
2013,55049,99,474,74,131,18,42,92,173,0.0105154388524192,0.531791907514451
2013,55051,2,81,51,181,0,2,51,183,0.0392114848939361,0.278688524590164
2013,55053,56,834,31,152,0,13,31,165,0.0114902506963788,0.187878787878788
2013,55055,341,1647,158,499,71,117,229,616,0.011014358002396,0.371753246753247
2013,55057,95,698,26,300,0,10,26,310,0.0162712576107495,0.0838709677419355
2013,55059,447,1700,853,2797,77,196,930,2993,0.0276699208638414,0.31072502505847
2013,55061,90,323,42,98,25,44,67,142,0.00987482614742698,0.471830985915493
2013,55063,472,1693,789,1631,127,153,916,1784,0.0243872431752628,0.513452914798206
2013,55065,48,294,20,140,0,9,20,149,0.0131104267487901,0.134228187919463
2013,55067,54,403,16,190,0,4,16,194,0.0134610047182903,0.0824742268041237
2013,55069,34,431,31,155,13,65,44,220,0.0105784488147329,0.2
2013,55071,221,671,151,359,5,45,156,404,0.00707183867805629,0.386138613861386
2013,55073,370,1728,446,963,32,110,478,1073,0.0117537517800416,0.445479962721342
2013,55075,67,489,39,305,4,31,43,336,0.0111705841284617,0.12797619047619
2013,55077,61,449,25,100,0,23,25,123,0.0109158679446219,0.203252032520325
2013,55078,2,77,11,32,0,0,11,32,0.012573673870334,0.34375
2013,55079,3465,9490,4006,8447,906,2172,4912,10619,0.0174030328705745,0.462567096713438
2013,55081,186,869,312,707,34,66,346,773,0.0257178028412683,0.447606727037516
2013,55083,128,621,39,162,7,27,46,189,0.00701819532120312,0.243386243386243
2013,55085,131,695,106,412,11,23,117,435,0.0160956116332421,0.268965517241379
2013,55087,1136,3856,709,1281,168,266,877,1547,0.0130794659993067,0.566903684550743
2013,55089,663,1605,649,1127,71,124,720,1251,0.0209211318482842,0.575539568345324
2013,55091,34,140,10,33,0,0,10,33,0.00628691179272242,0.303030303030303
2013,55093,45,386,134,491,14,30,148,521,0.0208258384298677,0.284069097888676
2013,55095,89,470,111,519,20,96,131,615,0.019932585726324,0.213008130081301
2013,55097,198,1202,128,316,9,35,137,351,0.00795359271260565,0.39031339031339
2013,55099,26,218,4,91,0,4,4,95,0.00891683874601089,0.0421052631578947
2013,55101,829,3835,346,1124,77,204,423,1328,0.0101266594986999,0.318524096385542
2013,55103,61,409,33,98,5,11,38,109,0.00876628599002735,0.348623853211009
2013,55105,288,1568,757,1833,115,131,872,1964,0.0183463956431981,0.443991853360489
2013,55107,66,315,22,136,0,14,22,150,0.0143485747082456,0.146666666666667
2013,55109,387,1100,731,1862,46,160,777,2022,0.0359109153553795,0.384272997032641
2013,55111,225,1008,165,609,8,39,173,648,0.0150624113804886,0.266975308641975
2013,55113,57,229,65,186,0,9,65,195,0.0160718701063216,0.333333333333333
2013,55115,132,1080,38,221,0,13,38,234,0.00795323227516824,0.162393162393162
2013,55117,321,1803,238,870,29,131,267,1001,0.0126789107029766,0.266733266733267
2013,55119,114,334,56,168,2,27,58,195,0.0137121158849589,0.297435897435897
2013,55121,73,360,54,171,3,97,57,268,0.0133826026165984,0.212686567164179
2013,55123,117,499,33,87,6,13,39,100,0.00496795667941776,0.39
2013,55125,126,422,81,259,6,27,87,286,0.0171999037767621,0.304195804195804
2013,55127,474,1688,544,1594,54,147,598,1741,0.0260589732076037,0.343480758184951
2013,55129,46,327,60,207,14,33,74,240,0.0203994900127497,0.308333333333333
2013,55131,626,2438,270,903,31,76,301,979,0.0107097536428478,0.307456588355465
2013,55133,3155,8372,1979,3508,299,512,2278,4020,0.0148265624135578,0.566666666666667
2013,55135,272,1397,35,354,3,37,38,391,0.0105274494493955,0.0971867007672634
2013,55137,124,859,58,168,3,25,61,193,0.0106700574966829,0.316062176165803
2013,55139,914,4544,447,1040,60,176,507,1216,0.0108937146133448,0.416940789473684
2013,55141,257,1313,189,446,11,96,200,542,0.0103529951100244,0.3690036900369
2013,56001,163,393,387,1139,130,158,517,1297,0.0647367107561767,0.398612181958365
2013,56003,31,178,19,211,2,19,21,230,0.0293442204644042,0.091304347826087
2013,56005,130,577,273,1378,42,52,315,1430,0.0489022638670406,0.22027972027972
2013,56007,36,374,59,553,0,29,59,582,0.0537396121883656,0.101374570446735
2013,56009,66,289,91,289,0,0,91,289,0.0307283359914939,0.314878892733564
2013,56011,2,115,0,96,2,2,2,98,0.019560878243513,0.0204081632653061
2013,56013,117,575,191,859,0,56,191,915,0.0341099720410065,0.208743169398907
2013,56015,57,392,121,452,0,10,121,462,0.049752315313375,0.261904761904762
2013,56017,16,57,47,277,37,43,84,320,0.089938167509837,0.2625
2013,56019,76,231,10,51,7,7,17,58,0.00935936743585606,0.293103448275862
2013,56021,174,656,869,2683,46,297,915,2980,0.0484560724564627,0.307046979865772
2013,56023,42,352,87,414,0,0,87,414,0.0347490347490347,0.210144927536232
2013,56025,258,1028,842,1801,28,150,870,1951,0.0378798174934472,0.44592516658124
2013,56027,10,97,23,101,6,19,29,120,0.0655021834061135,0.241666666666667
2013,56029,117,233,156,765,3,52,159,817,0.0409134157944814,0.194614443084455
2013,56031,17,180,19,164,0,20,19,184,0.029749393694422,0.103260869565217
2013,56033,135,474,277,654,1,14,278,668,0.0325885452239243,0.416167664670659
2013,56035,28,135,177,554,0,0,177,554,0.0790074158585282,0.319494584837545
2013,56037,66,280,332,1403,23,59,355,1462,0.0520377291332977,0.24281805745554
2013,56039,0,174,348,557,12,21,360,578,0.0363430583501006,0.622837370242215
2013,56041,94,376,185,493,14,16,199,509,0.0387632320463026,0.390962671905697
2013,56043,26,116,47,106,6,6,53,112,0.0194681035981227,0.473214285714286
2013,56045,27,256,12,74,5,5,17,79,0.0157810627247303,0.215189873417722
2013,72001,NA,NA,NA,NA,NA,NA,NA,NA,NA,NA
2013,72003,NA,NA,NA,NA,NA,NA,NA,NA,NA,NA
2013,72005,NA,NA,NA,NA,NA,NA,NA,NA,NA,NA
2013,72007,NA,NA,NA,NA,NA,NA,NA,NA,NA,NA
2013,72009,NA,NA,NA,NA,NA,NA,NA,NA,NA,NA
2013,72011,NA,NA,NA,NA,NA,NA,NA,NA,NA,NA
2013,72013,NA,NA,NA,NA,NA,NA,NA,NA,NA,NA
2013,72015,NA,NA,NA,NA,NA,NA,NA,NA,NA,NA
2013,72017,NA,NA,NA,NA,NA,NA,NA,NA,NA,NA
2013,72019,NA,NA,NA,NA,NA,NA,NA,NA,NA,NA
2013,72021,NA,NA,NA,NA,NA,NA,NA,NA,NA,NA
2013,72023,NA,NA,NA,NA,NA,NA,NA,NA,NA,NA
2013,72025,NA,NA,NA,NA,NA,NA,NA,NA,NA,NA
2013,72027,NA,NA,NA,NA,NA,NA,NA,NA,NA,NA
2013,72029,NA,NA,NA,NA,NA,NA,NA,NA,NA,NA
2013,72031,NA,NA,NA,NA,NA,NA,NA,NA,NA,NA
2013,72033,NA,NA,NA,NA,NA,NA,NA,NA,NA,NA
2013,72035,NA,NA,NA,NA,NA,NA,NA,NA,NA,NA
2013,72037,NA,NA,NA,NA,NA,NA,NA,NA,NA,NA
2013,72039,NA,NA,NA,NA,NA,NA,NA,NA,NA,NA
2013,72041,NA,NA,NA,NA,NA,NA,NA,NA,NA,NA
2013,72043,NA,NA,NA,NA,NA,NA,NA,NA,NA,NA
2013,72045,NA,NA,NA,NA,NA,NA,NA,NA,NA,NA
2013,72047,NA,NA,NA,NA,NA,NA,NA,NA,NA,NA
2013,72049,NA,NA,NA,NA,NA,NA,NA,NA,NA,NA
2013,72051,NA,NA,NA,NA,NA,NA,NA,NA,NA,NA
2013,72053,NA,NA,NA,NA,NA,NA,NA,NA,NA,NA
2013,72054,NA,NA,NA,NA,NA,NA,NA,NA,NA,NA
2013,72055,NA,NA,NA,NA,NA,NA,NA,NA,NA,NA
2013,72057,NA,NA,NA,NA,NA,NA,NA,NA,NA,NA
2013,72059,NA,NA,NA,NA,NA,NA,NA,NA,NA,NA
2013,72061,NA,NA,NA,NA,NA,NA,NA,NA,NA,NA
2013,72063,NA,NA,NA,NA,NA,NA,NA,NA,NA,NA
2013,72065,NA,NA,NA,NA,NA,NA,NA,NA,NA,NA
2013,72067,NA,NA,NA,NA,NA,NA,NA,NA,NA,NA
2013,72069,NA,NA,NA,NA,NA,NA,NA,NA,NA,NA
2013,72071,NA,NA,NA,NA,NA,NA,NA,NA,NA,NA
2013,72073,NA,NA,NA,NA,NA,NA,NA,NA,NA,NA
2013,72075,NA,NA,NA,NA,NA,NA,NA,NA,NA,NA
2013,72077,NA,NA,NA,NA,NA,NA,NA,NA,NA,NA
2013,72079,NA,NA,NA,NA,NA,NA,NA,NA,NA,NA
2013,72081,NA,NA,NA,NA,NA,NA,NA,NA,NA,NA
2013,72083,NA,NA,NA,NA,NA,NA,NA,NA,NA,NA
2013,72085,NA,NA,NA,NA,NA,NA,NA,NA,NA,NA
2013,72087,NA,NA,NA,NA,NA,NA,NA,NA,NA,NA
2013,72089,NA,NA,NA,NA,NA,NA,NA,NA,NA,NA
2013,72091,NA,NA,NA,NA,NA,NA,NA,NA,NA,NA
2013,72093,NA,NA,NA,NA,NA,NA,NA,NA,NA,NA
2013,72095,NA,NA,NA,NA,NA,NA,NA,NA,NA,NA
2013,72097,NA,NA,NA,NA,NA,NA,NA,NA,NA,NA
2013,72099,NA,NA,NA,NA,NA,NA,NA,NA,NA,NA
2013,72101,NA,NA,NA,NA,NA,NA,NA,NA,NA,NA
2013,72103,NA,NA,NA,NA,NA,NA,NA,NA,NA,NA
2013,72105,NA,NA,NA,NA,NA,NA,NA,NA,NA,NA
2013,72107,NA,NA,NA,NA,NA,NA,NA,NA,NA,NA
2013,72109,NA,NA,NA,NA,NA,NA,NA,NA,NA,NA
2013,72111,NA,NA,NA,NA,NA,NA,NA,NA,NA,NA
2013,72113,NA,NA,NA,NA,NA,NA,NA,NA,NA,NA
2013,72115,NA,NA,NA,NA,NA,NA,NA,NA,NA,NA
2013,72117,NA,NA,NA,NA,NA,NA,NA,NA,NA,NA
2013,72119,NA,NA,NA,NA,NA,NA,NA,NA,NA,NA
2013,72121,NA,NA,NA,NA,NA,NA,NA,NA,NA,NA
2013,72123,NA,NA,NA,NA,NA,NA,NA,NA,NA,NA
2013,72125,NA,NA,NA,NA,NA,NA,NA,NA,NA,NA
2013,72127,NA,NA,NA,NA,NA,NA,NA,NA,NA,NA
2013,72129,NA,NA,NA,NA,NA,NA,NA,NA,NA,NA
2013,72131,NA,NA,NA,NA,NA,NA,NA,NA,NA,NA
2013,72133,NA,NA,NA,NA,NA,NA,NA,NA,NA,NA
2013,72135,NA,NA,NA,NA,NA,NA,NA,NA,NA,NA
2013,72137,NA,NA,NA,NA,NA,NA,NA,NA,NA,NA
2013,72139,NA,NA,NA,NA,NA,NA,NA,NA,NA,NA
2013,72141,NA,NA,NA,NA,NA,NA,NA,NA,NA,NA
2013,72143,NA,NA,NA,NA,NA,NA,NA,NA,NA,NA
2013,72145,NA,NA,NA,NA,NA,NA,NA,NA,NA,NA
2013,72147,NA,NA,NA,NA,NA,NA,NA,NA,NA,NA
2013,72149,NA,NA,NA,NA,NA,NA,NA,NA,NA,NA
2013,72151,NA,NA,NA,NA,NA,NA,NA,NA,NA,NA
2013,72153,NA,NA,NA,NA,NA,NA,NA,NA,NA,NA
2014,01001,222,1747,442,907,20,48,462,955,0.0263571881986035,0.483769633507853
2014,01003,1092,3613,1564,4865,203,425,1767,5290,0.0396947481371983,0.334026465028355
2014,01005,47,1183,0,184,0,65,0,249,0.0132193671692504,0
2014,01007,50,1051,0,117,49,63,49,180,0.0114773959063955,0.272222222222222
2014,01009,132,1529,85,446,0,59,85,505,0.0129314759807436,0.168316831683168
2014,01011,112,340,0,177,0,18,0,195,0.0267746807634217,0
2014,01013,39,163,29,49,10,37,39,86,0.0061249198775016,0.453488372093023
2014,01015,372,2431,268,1349,35,179,303,1528,0.0194236465099724,0.198298429319372
2014,01017,119,601,119,405,6,14,125,419,0.0175895218504681,0.298329355608592
2014,01019,74,400,45,286,2,8,47,294,0.0156333085185579,0.159863945578231
2014,01021,76,554,70,584,0,25,70,609,0.0207192188616337,0.114942528735632
2014,01023,67,169,40,152,5,5,45,157,0.0164157256378084,0.286624203821656
2014,01025,4,157,33,112,0,17,33,129,0.00749128919860627,0.255813953488372
2014,01027,0,317,0,90,0,0,0,90,0.00935550935550936,0
2014,01029,10,175,0,54,0,0,0,54,0.00523864959254948,0
2014,01031,142,855,687,1584,141,308,828,1892,0.0550592206733987,0.437632135306554
2014,01033,303,1233,58,425,43,92,101,517,0.0136020416217212,0.195357833655706
2014,01035,0,52,0,12,0,0,0,12,0.0013437849944009,0
2014,01037,22,485,14,37,0,34,14,71,0.00863957167193964,0.197183098591549
2014,01039,72,561,43,353,0,2,43,355,0.0134073570511368,0.12112676056338
2014,01041,30,357,27,133,0,27,27,160,0.0167943738847486,0.16875
2014,01043,99,1152,71,549,0,89,71,638,0.011520404478151,0.11128526645768
2014,01045,120,1361,516,1862,35,132,551,1994,0.0601889583144677,0.276328986960883
2014,01047,24,610,38,504,13,44,51,548,0.0197841077295209,0.0930656934306569
2014,01049,207,1213,79,521,0,108,79,629,0.0133599541216202,0.125596184419714
2014,01051,510,3861,238,759,98,165,336,924,0.0171225261285301,0.363636363636364
2014,01053,10,770,86,253,0,62,86,315,0.0121649803043176,0.273015873015873
2014,01055,220,2245,173,610,19,118,192,728,0.0101624881344575,0.263736263736264
2014,01057,54,290,0,322,0,7,0,329,0.0275659824046921,0
2014,01059,72,790,0,364,2,135,2,499,0.0235800018901805,0.00400801603206413
2014,01061,53,635,97,380,0,0,97,380,0.0202850584529974,0.255263157894737
2014,01063,13,155,54,90,0,9,54,99,0.0168138586956522,0.545454545454545
2014,01065,23,214,0,105,0,1,0,106,0.0102277113083751,0
2014,01067,58,316,59,178,4,23,63,201,0.0163321686844885,0.313432835820896
2014,01069,238,1385,391,1740,55,118,446,1858,0.0266483083057241,0.240043057050592
2014,01071,86,534,35,388,0,8,35,396,0.0106537530266344,0.0883838383838384
2014,01073,3083,10291,3407,7692,573,1251,3980,8943,0.0201817554042557,0.445040814044504
2014,01075,22,223,0,62,0,0,0,62,0.00613132911392405,0
2014,01077,315,1515,312,1039,58,113,370,1152,0.0183556405353728,0.321180555555556
2014,01079,202,751,73,170,6,38,79,208,0.00888471231472385,0.379807692307692
2014,01081,784,2940,1638,3512,358,632,1996,4144,0.0484140428763362,0.481660231660232
2014,01083,478,2163,199,906,107,207,306,1113,0.0186751233262861,0.274932614555256
2014,01085,10,228,41,50,0,0,41,50,0.00687096330905593,0.82
2014,01087,41,239,27,75,28,46,55,121,0.00959632008882544,0.454545454545455
2014,01089,964,3138,2682,6164,518,999,3200,7163,0.0311732961963617,0.446740192656708
2014,01091,80,459,51,115,0,43,51,158,0.0113318511080829,0.322784810126582
2014,01093,114,664,121,363,0,38,121,401,0.0184681987749275,0.301745635910224
2014,01095,220,1805,77,879,2,51,79,930,0.0148785716571209,0.0849462365591398
2014,01097,529,2405,1342,4685,279,742,1621,5427,0.0199837243299174,0.298691726552423
2014,01099,25,402,0,115,16,31,16,146,0.00967335851056781,0.10958904109589
2014,01101,1292,4962,1834,3895,603,928,2437,4823,0.0327720700152207,0.505287165664524
2014,01103,306,2294,271,881,17,27,288,908,0.0111398741243298,0.317180616740088
2014,01105,8,145,49,78,0,41,49,119,0.0190339091490723,0.411764705882353
2014,01107,0,232,36,223,0,0,36,223,0.0164430025070049,0.161434977578475
2014,01109,103,444,112,392,11,67,123,459,0.0238095238095238,0.26797385620915
2014,01111,5,98,0,484,0,7,0,491,0.0316264090177134,0
2014,01113,22,713,423,1893,109,344,532,2237,0.0600778837115617,0.237818506928923
2014,01115,378,2573,7,683,6,132,13,815,0.0138839202057887,0.0159509202453988
2014,01117,2296,5938,1254,2388,239,389,1493,2777,0.0205619932620044,0.537630536550234
2014,01119,6,123,0,97,0,0,0,97,0.0117319787131108,0
2014,01121,183,2124,76,891,43,136,119,1027,0.018355346642598,0.11587147030185
2014,01123,114,742,60,285,0,42,60,327,0.0113066629784586,0.18348623853211
2014,01125,895,3203,821,1830,167,306,988,2136,0.0178245086994618,0.462546816479401
2014,01127,213,1186,80,477,0,37,80,514,0.0111980131151827,0.155642023346304
2014,01129,25,306,0,40,1,2,1,42,0.00365535248041775,0.0238095238095238
2014,01131,28,179,1,13,0,18,1,31,0.00415215644253951,0.032258064516129
2014,01133,14,565,0,244,0,0,0,244,0.0140958983246678,0
2014,02013,13,66,24,301,4,19,28,320,0.125786163522013,0.0875
2014,02016,10,80,42,311,9,80,51,391,0.0957394711067581,0.130434782608696
2014,02020,946,3553,3144,7713,531,1327,3675,9040,0.0480557106025569,0.406526548672566
2014,02050,39,238,99,226,0,2,99,228,0.0246406570841889,0.434210526315789
2014,02060,9,30,9,24,0,3,9,27,0.0404191616766467,0.333333333333333
2014,02068,17,45,26,96,9,9,35,105,0.0743626062322946,0.333333333333333
2014,02070,16,110,30,59,3,5,33,64,0.0232304900181488,0.515625
2014,02090,252,1350,1254,3687,289,849,1543,4536,0.0751279460721798,0.340167548500882
2014,02100,12,34,8,28,0,18,8,46,0.0245202558635394,0.173913043478261
2014,02105,29,64,15,55,16,18,31,73,0.0453134698944755,0.424657534246575
2014,02110,93,265,382,992,32,102,414,1094,0.0498450883907418,0.378427787934186
2014,02122,116,944,337,1179,34,94,371,1273,0.0329485453980743,0.291437549096622
2014,02130,57,218,74,375,12,38,86,413,0.0446100669691078,0.208232445520581
2014,02150,8,171,139,371,71,110,210,481,0.0567216981132075,0.436590436590437
2014,02164,0,26,10,13,0,0,10,13,0.015625,0.769230769230769
2014,02170,474,2190,455,1742,30,134,485,1876,0.0317234848484848,0.258528784648188
2014,02180,48,185,49,165,6,43,55,208,0.03888577304169,0.264423076923077
2014,02185,80,407,38,228,21,39,59,267,0.0427405154474148,0.220973782771536
2014,02188,39,134,52,116,0,0,52,116,0.0291384074353178,0.448275862068966
2014,02195,19,32,28,87,0,9,28,96,0.0423280423280423,0.291666666666667
2014,02198,13,75,27,148,0,5,27,153,0.035705950991832,0.176470588235294
2014,02220,23,121,109,262,3,34,112,296,0.047981844707408,0.378378378378378
2014,02230,2,23,16,49,2,2,18,51,0.0697674418604651,0.352941176470588
2014,02240,65,184,78,256,16,16,94,272,0.0608637279033341,0.345588235294118
2014,02261,40,233,32,146,0,59,32,205,0.0316749072929543,0.15609756097561
2014,02270,5,78,21,32,0,0,21,32,0.00906772456786625,0.65625
2014,02275,4,28,16,48,2,4,18,52,0.0276448697501329,0.346153846153846
2014,02282,4,10,0,21,0,0,0,21,0.048951048951049,0
2014,02290,15,131,28,65,3,10,31,75,0.0212826333711691,0.413333333333333
2014,04001,114,1076,175,730,75,142,250,872,0.0203895526924966,0.286697247706422
2014,04003,286,3277,1496,4035,311,913,1807,4948,0.0556555385584451,0.36519805982215
2014,04005,600,2076,1095,2395,46,203,1141,2598,0.0327616645649433,0.439183987682833
2014,04007,213,1499,266,729,4,35,270,764,0.0199378898196717,0.353403141361257
2014,04009,38,787,91,559,8,38,99,597,0.0265015314955387,0.165829145728643
2014,04011,29,264,17,124,0,8,17,132,0.0236813778256189,0.128787878787879
2014,04012,10,210,123,443,0,36,123,479,0.0306697400435395,0.25678496868476
2014,04013,5951,22188,33458,87225,5759,15487,39217,102712,0.0402698667603443,0.381815172521224
2014,04015,338,3173,1650,9966,25,513,1675,10479,0.0704248069517531,0.159843496516843
2014,04017,392,2523,241,1030,12,128,253,1158,0.0174505342154041,0.218480138169257
2014,04019,1828,8352,7841,19361,1713,3763,9554,23124,0.0353309488049601,0.413163812489189
2014,04021,2218,14501,2343,11087,702,3642,3045,14729,0.056950303330253,0.206735012560255
2014,04023,164,766,90,427,73,298,163,725,0.0249767457884039,0.224827586206897
2014,04025,1245,5426,2128,6048,98,412,2226,6460,0.0403480172634551,0.344582043343653
2014,04027,275,2394,1087,4678,155,1498,1242,6176,0.0499034413658805,0.20110103626943
2014,05001,24,377,23,172,28,51,51,223,0.017098604508511,0.228699551569507
2014,05003,49,153,4,157,0,0,4,157,0.0107277075503929,0.0254777070063694
2014,05005,62,525,188,897,0,43,188,940,0.0299936183790683,0.2
2014,05007,861,3514,2171,5214,981,1516,3152,6730,0.0448762402645898,0.468350668647845
2014,05009,44,499,146,836,0,38,146,874,0.0338628438589694,0.167048054919908
2014,05011,70,139,4,39,0,17,4,56,0.00726423660656376,0.0714285714285714
2014,05013,0,160,0,34,0,0,0,34,0.00901856763925729,0
2014,05015,105,656,150,745,21,96,171,841,0.0431237821761871,0.20332936979786
2014,05017,22,281,10,111,5,5,15,116,0.0147096119705808,0.129310344827586
2014,05019,106,410,42,221,0,35,42,256,0.0192597050857659,0.1640625
2014,05021,8,314,16,183,0,0,16,183,0.016570083303151,0.087431693989071
2014,05023,134,616,37,397,13,39,50,436,0.023095666913868,0.114678899082569
2014,05025,10,107,3,28,0,0,3,28,0.00480109739368999,0.107142857142857
2014,05027,42,186,63,142,21,21,84,163,0.0108032873806999,0.515337423312883
2014,05029,141,524,79,205,0,7,79,212,0.0146317896335151,0.372641509433962
2014,05031,232,2190,405,1127,78,112,483,1239,0.0197588747488279,0.389830508474576
2014,05033,88,1164,82,967,0,73,82,1040,0.0255033227886903,0.0788461538461538
2014,05035,22,701,175,975,6,39,181,1014,0.0324034129038443,0.178500986193294
2014,05037,50,365,12,118,0,0,12,118,0.00990764063811923,0.101694915254237
2014,05039,69,227,0,59,0,0,0,59,0.0108336393683437,0
2014,05041,17,211,0,70,23,29,23,99,0.0118947494893668,0.232323232323232
2014,05043,84,494,58,118,0,14,58,132,0.0112445693841043,0.439393939393939
2014,05045,526,2714,352,1253,34,48,386,1301,0.0183169780506005,0.296694850115296
2014,05047,43,513,29,242,0,19,29,261,0.021541762958072,0.111111111111111
2014,05049,39,325,0,188,0,2,0,190,0.0211935303959844,0
2014,05051,390,1783,552,1913,72,187,624,2100,0.0304608288246472,0.297142857142857
2014,05053,90,435,5,166,0,0,5,166,0.0135410718655682,0.0301204819277108
2014,05055,134,732,22,490,41,42,63,532,0.0187225057188105,0.118421052631579
2014,05057,2,217,0,244,0,0,0,244,0.0166223857210982,0
2014,05059,45,1134,26,215,0,0,26,215,0.0092852515655366,0.12093023255814
2014,05061,20,248,3,61,0,58,3,119,0.0132516703786192,0.0252100840336134
2014,05063,114,836,64,459,0,8,64,467,0.0188298858916979,0.137044967880086
2014,05065,22,517,53,219,28,33,81,252,0.0250347705146036,0.321428571428571
2014,05067,60,1838,8,145,0,7,8,152,0.0120405576679341,0.0526315789473684
2014,05069,63,1124,151,713,31,52,182,765,0.0155582672361196,0.237908496732026
2014,05071,41,484,28,208,0,42,28,250,0.0148262365081248,0.112
2014,05073,8,140,14,90,0,16,14,106,0.0206305955624757,0.132075471698113
2014,05075,8,386,9,89,0,7,9,96,0.00824317362184441,0.09375
2014,05077,0,230,1,94,0,28,1,122,0.0174037089871612,0.00819672131147541
2014,05079,3,591,0,125,0,0,0,125,0.0125426449929761,0
2014,05081,108,278,18,237,6,47,24,284,0.0312706452323277,0.0845070422535211
2014,05083,1,404,8,141,0,18,8,159,0.0104832860816246,0.050314465408805
2014,05085,278,1578,234,1084,50,294,284,1378,0.0303966118145321,0.206095791001451
2014,05087,26,124,0,173,0,8,0,181,0.0168654491241148,0
2014,05089,33,454,49,513,0,4,49,517,0.0409310426727892,0.0947775628626693
2014,05091,30,864,19,983,0,20,19,1003,0.0343575514678176,0.0189431704885344
2014,05093,83,687,141,740,5,29,146,769,0.0267617887593527,0.189856957087126
2014,05095,5,149,2,116,0,0,2,116,0.0211524434719183,0.0172413793103448
2014,05097,20,311,41,131,0,0,41,131,0.0193215339233038,0.312977099236641
2014,05099,23,224,6,65,40,65,46,130,0.021605451221539,0.353846153846154
2014,05101,32,106,15,67,4,8,19,75,0.0125965737319449,0.253333333333333
2014,05103,74,434,56,116,11,13,67,129,0.00735000854652157,0.51937984496124
2014,05105,105,376,6,44,0,37,6,81,0.0112343966712899,0.0740740740740741
2014,05107,7,176,24,217,0,0,24,217,0.0164431310146245,0.110599078341014
2014,05109,67,417,30,95,0,9,30,104,0.0135381411090862,0.288461538461538
2014,05111,42,756,10,161,0,38,10,199,0.012212335072108,0.050251256281407
2014,05113,17,193,26,309,0,0,26,309,0.0217866459846295,0.0841423948220065
2014,05115,183,1325,150,518,8,81,158,599,0.0151718548162407,0.263772954924875
2014,05117,24,147,0,37,0,0,0,37,0.00606259216778633,0
2014,05119,1575,6327,2213,5112,363,1173,2576,6285,0.0241647122150025,0.409864757358791
2014,05121,28,257,91,443,0,15,91,458,0.037193438362839,0.198689956331878
2014,05123,42,519,72,885,0,55,72,940,0.0498911947348867,0.0765957446808511
2014,05125,490,2780,347,889,0,76,347,965,0.0125499070136423,0.359585492227979
2014,05127,11,155,39,110,0,0,39,110,0.0150891632373114,0.354545454545455
2014,05129,0,103,0,47,0,10,0,57,0.00973693201229928,0
2014,05131,348,1917,630,2469,34,90,664,2559,0.03079792995547,0.259476357952325
2014,05133,46,184,19,320,51,133,70,453,0.0426754592557701,0.154525386313466
2014,05135,62,472,24,225,0,0,24,225,0.0182852498984153,0.106666666666667
2014,05137,164,378,24,170,59,94,83,264,0.0288840262582057,0.314393939393939
2014,05139,198,516,69,526,2,6,71,532,0.0190640005733534,0.133458646616541
2014,05141,40,361,18,260,17,27,35,287,0.0229949523275379,0.121951219512195
2014,05143,1085,3989,1335,3491,338,639,1673,4130,0.032620629191119,0.405084745762712
2014,05145,199,1267,247,889,4,106,251,995,0.019931491756976,0.252261306532663
2014,05147,0,72,2,30,0,0,2,30,0.00602772754671489,0.0666666666666667
2014,05149,66,544,0,116,11,11,11,127,0.00874234184621739,0.0866141732283465
2014,06001,19535,35778,9691,14478,5981,10017,15672,24495,0.0229574263689402,0.639804041641151
2014,06003,28,38,7,99,2,2,9,101,0.119952494061758,0.0891089108910891
2014,06005,235,1711,38,184,7,44,45,228,0.00793512685762016,0.197368421052632
2014,06007,688,3676,526,1834,120,341,646,2175,0.0153360174301771,0.297011494252874
2014,06009,286,1288,23,293,24,24,47,317,0.00942807007108229,0.148264984227129
2014,06011,56,298,25,104,0,95,25,199,0.0150256720024162,0.125628140703518
2014,06013,12648,26325,4202,7365,2826,5273,7028,12638,0.0173335564376099,0.556100648836841
2014,06015,172,1662,111,374,7,53,118,427,0.0220671834625323,0.276346604215457
2014,06017,1242,4651,567,1475,288,464,855,1939,0.0151676340368279,0.440948942753997
2014,06019,2342,12309,1036,3618,691,2572,1727,6190,0.0110003767495753,0.278998384491115
2014,06021,191,815,32,199,3,20,35,219,0.0123061362103844,0.159817351598174
2014,06023,755,2552,645,1640,0,7,645,1647,0.0181216028871333,0.391621129326047
2014,06025,326,2905,298,1282,210,739,508,2021,0.0190681963995924,0.251360712518555
2014,06027,87,473,75,236,1,41,76,277,0.0208898944193062,0.274368231046931
2014,06029,2251,20159,1627,5841,518,2246,2145,8087,0.0159671613913366,0.265240509459627
2014,06031,525,6653,373,1457,145,478,518,1935,0.021051371874932,0.267700258397933
2014,06033,667,2473,156,741,21,145,177,886,0.0192730199473581,0.199774266365688
2014,06035,159,4345,48,417,0,73,48,490,0.0201945268710847,0.0979591836734694
2014,06037,27433,67109,33698,59670,20865,43562,54563,103232,0.015741994276692,0.528547349659021
2014,06039,469,5153,39,262,65,271,104,533,0.0056767954330021,0.195121951219512
2014,06041,4228,9084,1398,2475,859,1208,2257,3683,0.0195291372819344,0.612815639424382
2014,06043,141,529,49,229,8,38,57,267,0.019574780058651,0.213483146067416
2014,06045,330,1906,303,1053,42,155,345,1208,0.019765691471955,0.285596026490066
2014,06047,812,4985,223,1069,85,258,308,1327,0.00882947861496287,0.232102486812359
2014,06049,3,184,42,251,0,0,42,251,0.0370479704797048,0.167330677290837
2014,06051,191,429,37,116,5,30,42,146,0.0150826446280992,0.287671232876712
2014,06053,2016,7500,2337,4777,926,1819,3263,6596,0.0248124769593054,0.494693753790176
2014,06055,1613,3284,483,870,85,352,568,1222,0.0127904542599958,0.46481178396072
2014,06057,976,2577,512,1069,144,290,656,1359,0.0184619146594938,0.48270787343635
2014,06059,21417,47281,11404,21035,6755,13737,18159,34772,0.0170139475029786,0.522230530311745
2014,06061,3436,10255,1549,3073,306,923,1855,3996,0.0161259730668808,0.464214214214214
2014,06063,175,531,43,267,0,27,43,294,0.0200778528989961,0.146258503401361
2014,06065,12110,55849,5495,18008,2347,7104,7842,25112,0.0177995397012949,0.312280981204205
2014,06067,8500,30358,4364,10697,1938,5041,6302,15738,0.0166403566183429,0.400432075231923
2014,06069,481,1779,33,161,22,109,55,270,0.00757660792457066,0.203703703703704
2014,06071,9196,50109,3641,14066,2178,6305,5819,20371,0.0162064071435163,0.285651170781994
2014,06073,11074,26235,19349,38590,8402,19121,27751,57711,0.0276375941390734,0.480861534196254
2014,06075,13312,20172,10859,13287,5414,8271,16273,21558,0.0333025920038558,0.754847388440486
2014,06077,3374,15646,1038,3285,513,1804,1551,5089,0.0118818862523611,0.304775004912556
2014,06079,2519,7170,918,1854,264,660,1182,2514,0.0138643019042734,0.470167064439141
2014,06081,11394,20199,3880,5518,2617,4731,6497,10249,0.0196347014467876,0.633915503951605
2014,06083,2292,6562,1844,3865,788,2282,2632,6147,0.0231122374164827,0.428176346185131
2014,06085,15001,26780,13514,17650,14218,19740,27732,37390,0.0300369537275064,0.7416956405456
2014,06087,2219,6204,991,1684,352,647,1343,2331,0.0135306136664422,0.576147576147576
2014,06089,1065,4325,499,2195,185,384,684,2579,0.020848996354053,0.265219077161691
2014,06091,24,63,0,12,0,0,0,12,0.0049771878888428,0
2014,06093,316,967,134,611,28,50,162,661,0.0206795144537605,0.245083207261725
2014,06095,2685,11053,1097,3764,686,1647,1783,5411,0.0193112752008394,0.329513953058584
2014,06097,3817,10008,1848,3767,455,854,2303,4621,0.0135318750183021,0.498376974680805
2014,06099,1810,9719,401,2673,222,1157,623,3830,0.0118697856620427,0.16266318537859
2014,06101,383,2601,56,386,135,361,191,747,0.0123948429488775,0.255689424364123
2014,06103,229,2142,115,538,0,67,115,605,0.0142302716688228,0.190082644628099
2014,06105,81,437,8,165,0,0,8,165,0.0159005492917028,0.0484848484848485
2014,06107,960,5970,602,2675,138,958,740,3633,0.0140788851600102,0.203688411780897
2014,06109,340,2603,37,445,0,9,37,454,0.0110629172961645,0.0814977973568282
2014,06111,5055,12517,3220,7438,1362,2849,4582,10287,0.0189006845917254,0.445416545154078
2014,06113,1957,5743,806,1465,1001,1724,1807,3189,0.0267443810801744,0.566635308874255
2014,06115,216,3111,205,865,34,269,239,1134,0.0253884386334124,0.210758377425044
2014,08001,3731,16334,1933,5564,297,1492,2230,7056,0.0243773514505146,0.316043083900227
2014,08003,170,704,66,231,0,13,66,244,0.0261325907679126,0.270491803278689
2014,08005,8351,23784,5850,12784,1132,2507,6982,15291,0.0385888849071555,0.456608462494278
2014,08007,11,68,217,477,0,20,217,497,0.0549596372885105,0.436619718309859
2014,08009,17,65,15,73,0,0,15,73,0.027027027027027,0.205479452054795
2014,08011,35,555,7,53,0,0,7,53,0.0109708134961706,0.132075471698113
2014,08013,3111,7090,4954,7520,1241,1820,6195,9340,0.0477222097324695,0.663276231263383
2014,08014,1157,3652,1173,1672,62,131,1235,1803,0.0456721635382628,0.684969495285635
2014,08015,399,666,85,286,0,17,85,303,0.0212736080881837,0.280528052805281
2014,08017,29,85,5,7,0,0,5,7,0.00509832483612527,0.714285714285714
2014,08019,109,245,78,149,0,0,78,149,0.021000704721635,0.523489932885906
2014,08021,26,178,29,85,15,22,44,107,0.0201848707790983,0.411214953271028
2014,08023,14,68,4,22,7,7,11,29,0.0110983543819365,0.379310344827586
2014,08025,24,244,0,33,0,0,0,33,0.00852713178294574,0
2014,08027,34,115,26,43,0,0,26,43,0.012576776835332,0.604651162790698
2014,08029,58,583,144,483,0,28,144,511,0.02338886854632,0.281800391389432
2014,08031,10970,28387,11450,17691,1879,3435,13329,21126,0.0478918387101893,0.630928713433684
2014,08033,24,60,4,22,0,0,4,22,0.0167810831426392,0.181818181818182
2014,08035,4538,8843,4217,6975,641,880,4858,7855,0.0407539612539042,0.618459579885423
2014,08037,494,1006,605,851,43,276,648,1127,0.0316724278447573,0.574977817213842
2014,08039,254,859,219,494,13,54,232,548,0.0337085563142031,0.423357664233577
2014,08041,1836,6296,8281,22068,1458,5392,9739,27460,0.0673607158977177,0.354661325564457
2014,08043,280,1509,112,999,10,52,122,1051,0.0293936681955476,0.116079923882017
2014,08045,429,1222,270,1012,77,95,347,1107,0.0298157724628313,0.313459801264679
2014,08047,43,252,108,211,0,0,108,211,0.0503099666189795,0.511848341232227
2014,08049,198,273,277,421,0,0,277,421,0.0403063666826233,0.657957244655582
2014,08051,101,375,198,273,12,12,210,285,0.0291769041769042,0.736842105263158
2014,08053,5,36,28,39,0,0,28,39,0.052,0.717948717948718
2014,08055,34,167,113,145,1,7,114,152,0.0301169011293838,0.75
2014,08057,0,31,5,21,0,9,5,30,0.028328611898017,0.166666666666667
2014,08059,6789,17383,4603,9713,852,1549,5455,11262,0.029476119684248,0.484372225182028
2014,08061,6,20,9,15,0,0,9,15,0.0167597765363128,0.6
2014,08063,44,233,6,158,0,9,6,167,0.0299874304183875,0.0359281437125748
2014,08065,128,199,224,255,0,0,224,255,0.0503355704697987,0.87843137254902
2014,08067,260,883,872,1733,41,86,913,1819,0.0500219997800022,0.501924134139637
2014,08069,1900,4533,4054,7998,378,808,4432,8806,0.0437378312870028,0.503293209175562
2014,08071,44,185,50,244,8,8,58,252,0.0240412135088724,0.23015873015873
2014,08073,13,232,15,57,0,0,15,57,0.0139740132385389,0.263157894736842
2014,08075,67,785,12,252,16,89,28,341,0.0227272727272727,0.0821114369501466
2014,08077,586,2209,771,3010,115,269,886,3279,0.0332127989303838,0.270204330588594
2014,08079,7,22,4,7,0,0,4,7,0.0107361963190184,0.571428571428571
2014,08081,125,283,29,184,8,28,37,212,0.0244577757268113,0.174528301886792
2014,08083,131,437,218,780,0,0,218,780,0.0436192819595124,0.279487179487179
2014,08085,311,924,538,1402,8,35,546,1437,0.0501290727691342,0.379958246346555
2014,08087,86,983,44,221,4,135,48,356,0.0196641626159965,0.134831460674157
2014,08089,70,534,6,135,0,3,6,138,0.0110444177671068,0.0434782608695652
2014,08091,113,162,67,174,0,0,67,174,0.0477759472817133,0.385057471264368
2014,08093,240,661,224,385,11,27,235,412,0.0330870542884677,0.570388349514563
2014,08095,17,274,5,46,16,64,21,110,0.0384346610761705,0.190909090909091
2014,08097,486,845,331,591,0,35,331,626,0.046394426739791,0.528753993610224
2014,08099,47,289,0,198,0,3,0,201,0.025611620795107,0
2014,08101,477,2447,651,2244,41,291,692,2535,0.0236615143369176,0.272978303747535
2014,08103,5,83,50,233,14,14,64,247,0.0552943810163421,0.259109311740891
2014,08105,51,397,44,360,0,0,44,360,0.0453115166771554,0.122222222222222
2014,08107,416,651,112,312,24,63,136,375,0.0225076526018846,0.362666666666667
2014,08109,25,204,46,114,0,0,46,114,0.0262491365415611,0.403508771929825
2014,08111,3,3,4,24,0,0,4,24,0.04642166344294,0.166666666666667
2014,08113,16,122,170,355,24,47,194,402,0.0709745762711864,0.482587064676617
2014,08115,14,101,0,78,0,3,0,81,0.0482142857142857,0
2014,08117,307,799,710,1290,23,98,733,1388,0.0664241960183767,0.528097982708934
2014,08119,165,596,55,450,15,30,70,480,0.0276195408251338,0.145833333333333
2014,08121,41,237,22,97,0,3,22,100,0.0295945546019532,0.22
2014,08123,1818,6842,1120,4835,210,600,1330,5435,0.0329601688336891,0.244710211591536
2014,08125,111,480,23,186,7,15,30,201,0.0300134388532179,0.149253731343284
2014,09001,1751,4637,9909,15648,2476,5078,12385,20726,0.0328710201815947,0.59755862202065
2014,09003,3693,9438,4816,8880,1519,3642,6335,12522,0.0202958967343737,0.505909599105574
2014,09005,991,2628,854,1614,106,327,960,1941,0.0143042433711144,0.494590417310665
2014,09007,1490,3571,878,1629,121,235,999,1864,0.0157457700137691,0.535944206008584
2014,09009,3022,8862,4756,8540,1506,2940,6262,11480,0.019485865109608,0.545470383275261
2014,09011,934,4173,1968,4682,271,722,2239,5404,0.028628643476971,0.414322723908216
2014,09013,887,3935,686,1450,321,435,1007,1885,0.0196321446425596,0.5342175066313
2014,09015,412,2157,246,1432,85,267,331,1699,0.0212157538523014,0.194820482636845
2014,10001,467,1936,653,2604,160,470,813,3074,0.028301018247436,0.264476252439818
2014,10003,296,1823,5377,11412,1048,1944,6425,13356,0.0366966427352682,0.481057202755316
2014,10005,276,1409,1672,5038,70,320,1742,5358,0.0361267876286992,0.325121313923106
2014,11001,0,0,21415,29642,4975,5850,26390,35492,0.0801678709616214,0.743547841767159
2014,12001,1524,4823,2546,3944,1209,1734,3755,5678,0.0381296461692398,0.661324410003522
2014,12003,45,1196,30,332,16,16,46,348,0.0198155107618722,0.132183908045977
2014,12005,639,2699,1119,4342,367,996,1486,5338,0.0446455454819176,0.278381416260772
2014,12007,83,1691,14,96,0,0,14,96,0.00484848484848485,0.145833333333333
2014,12009,1772,6693,3015,11711,499,1518,3514,13229,0.0330366552290765,0.265628543351727
2014,12011,10185,31243,9103,24864,5952,16847,15055,41711,0.0330406665325321,0.360935964134161
2014,12013,66,631,0,165,0,0,0,165,0.0158898305084746,0
2014,12015,838,4413,1320,6100,246,785,1566,6885,0.0522822711084449,0.227450980392157
2014,12017,303,2339,483,2783,47,155,530,2938,0.0266724768726566,0.180394826412526
2014,12019,922,5996,1088,3027,213,593,1301,3620,0.0280268190334619,0.35939226519337
2014,12021,1166,5442,3963,9452,1029,2459,4992,11911,0.0480204805676504,0.419108387205105
2014,12023,274,3034,264,1133,0,114,264,1247,0.0269744100023795,0.211708099438653
2014,12027,46,1508,65,469,0,403,65,872,0.0370307457108884,0.0745412844036697
2014,12029,30,673,0,231,16,16,16,247,0.0210966860266484,0.0647773279352227
2014,12031,3955,12604,5384,16239,975,3001,6359,19240,0.0327545671681429,0.330509355509356
2014,12033,1052,4132,2012,7378,246,711,2258,8089,0.0404893358227259,0.279144517245642
2014,12035,620,2061,628,2417,24,232,652,2649,0.0361105809863955,0.246130615326538
2014,12037,18,880,66,153,9,15,75,168,0.0191431175934366,0.446428571428571
2014,12039,72,1772,28,183,103,171,131,354,0.0109900344602775,0.370056497175141
2014,12041,31,579,48,183,8,28,56,211,0.0185282753775904,0.265402843601896
2014,12043,51,624,51,216,16,16,67,232,0.0242804814233386,0.288793103448276
2014,12045,68,944,53,285,0,9,53,294,0.0249025919024225,0.180272108843537
2014,12047,26,931,6,84,0,14,6,98,0.0103758602435151,0.0612244897959184
2014,12049,25,665,40,452,26,131,66,583,0.0338088610531199,0.113207547169811
2014,12051,300,1422,162,531,31,339,193,870,0.0368191628930551,0.22183908045977
2014,12053,561,4314,615,3726,153,314,768,4040,0.0314426249922172,0.19009900990099
2014,12055,362,2189,413,2549,45,412,458,2961,0.0399293381520039,0.15467747382641
2014,12057,6367,19266,7794,19618,3178,7504,10972,27122,0.0318499311847958,0.404542437873313
2014,12059,53,732,54,306,0,15,54,321,0.0231018351925153,0.168224299065421
2014,12061,635,3295,870,3736,214,501,1084,4237,0.0400419604211163,0.255841397215011
2014,12063,179,1997,121,529,13,41,134,570,0.01614456466323,0.235087719298246
2014,12065,62,970,24,97,0,10,24,107,0.0099460866332032,0.224299065420561
2014,12067,36,519,0,62,0,10,0,72,0.0121951219512195,0
2014,12069,1995,8010,1378,6690,294,672,1672,7362,0.0331552921466723,0.227112197772344
2014,12071,1769,9948,6159,20381,879,3887,7038,24268,0.0510709580750113,0.290011537827592
2014,12073,1849,5512,2153,4125,653,1003,2806,5128,0.0316441636018068,0.547191887675507
2014,12075,142,1519,30,642,0,41,30,683,0.0236479468180874,0.0439238653001464
2014,12077,66,617,10,197,9,9,19,206,0.0362867711819623,0.0922330097087379
2014,12079,49,948,0,139,0,17,0,156,0.0117771402687604,0
2014,12081,1523,6976,3814,10242,608,2073,4422,12315,0.0503088386685622,0.359074299634592
2014,12083,1235,7475,1531,7292,252,832,1783,8124,0.0329180088737616,0.219473165928114
2014,12085,1359,4647,1510,3911,88,362,1598,4273,0.0374112435101605,0.373976129183244
2014,12086,4820,16797,8664,18529,10650,27776,19314,46305,0.025738670093672,0.417103984450923
2014,12087,584,2226,1001,2579,205,742,1206,3321,0.0570167908525907,0.363143631436314
2014,12089,354,1794,395,1535,157,220,552,1755,0.0329534145746099,0.314529914529915
2014,12091,669,2861,1773,5979,284,743,2057,6722,0.0526934654458798,0.306010116036894
2014,12093,52,672,47,492,9,83,56,575,0.0215347739785027,0.0973913043478261
2014,12095,7324,24219,6587,19203,4037,10446,10624,29649,0.0381020552671924,0.358325744544504
2014,12097,993,6391,897,4335,717,2637,1614,6972,0.0373251387914835,0.231497418244406
2014,12099,6920,18462,10999,24957,3217,9509,14216,34466,0.0352402278048731,0.412464457726455
2014,12101,2048,9619,2216,8855,345,1468,2561,10323,0.0303223456565289,0.248086796473893
2014,12103,4838,15305,6357,19521,1518,4310,7875,23831,0.0342219465051424,0.330451932357014
2014,12105,2198,10543,2114,10468,565,2385,2679,12853,0.0305957518728085,0.20843382867813
2014,12107,120,1662,143,750,15,122,158,872,0.0170362410862557,0.181192660550459
2014,12109,2536,6700,2493,4947,356,907,2849,5854,0.0413438517440834,0.486675777246327
2014,12111,1458,7039,1285,6035,176,1000,1461,7035,0.0350202106688437,0.207675906183369
2014,12113,785,4090,1861,5153,143,497,2004,5650,0.0522785102937775,0.354690265486726
2014,12115,2205,8169,4005,11008,625,1941,4630,12949,0.0425862891158141,0.357556568074755
2014,12117,3720,11658,2252,5682,744,2406,2996,8088,0.0274238283501624,0.370425321463897
2014,12119,560,2827,2237,5656,62,538,2299,6194,0.067577298217286,0.371165644171779
2014,12121,72,1682,111,599,0,31,111,630,0.0210357607933487,0.176190476190476
2014,12123,41,1553,31,199,9,15,40,214,0.0129563480050857,0.186915887850467
2014,12125,29,1319,0,59,0,0,0,59,0.00542229574487639,0
2014,12127,2132,9418,2706,12003,384,1324,3090,13327,0.0367255381240682,0.231860133563443
2014,12129,190,2077,42,270,0,56,42,326,0.0148729412838177,0.128834355828221
2014,12131,422,2089,599,1406,44,44,643,1450,0.0344999881034524,0.443448275862069
2014,12133,95,1355,29,181,0,21,29,202,0.0116098626357837,0.143564356435644
2014,13001,199,401,4,155,0,16,4,171,0.0140232901426931,0.0233918128654971
2014,13003,2,99,9,119,0,7,9,126,0.0243243243243243,0.0714285714285714
2014,13005,22,306,9,23,0,0,9,23,0.00315111659131388,0.391304347826087
2014,13007,5,50,0,5,0,0,0,5,0.00220848056537102,0
2014,13009,215,1089,132,337,0,30,132,367,0.0131891037159491,0.359673024523161
2014,13011,81,566,7,46,0,61,7,107,0.00871903520208605,0.0654205607476635
2014,13013,349,2294,51,464,4,4,55,468,0.0102925005498131,0.117521367521368
2014,13015,355,2027,89,893,87,99,176,992,0.0150743841840534,0.17741935483871
2014,13017,174,494,50,136,0,44,50,180,0.0159716060337178,0.277777777777778
2014,13019,66,485,8,180,17,25,25,205,0.0160457107075767,0.121951219512195
2014,13021,904,3654,363,1102,180,293,543,1395,0.0140438126686264,0.389247311827957
2014,13023,133,408,0,43,0,19,0,62,0.00787801778907243,0
2014,13025,0,374,1,407,0,0,1,407,0.0335255354200988,0.00245700245700246
2014,13027,59,648,0,160,0,13,0,173,0.0160482374768089,0
2014,13029,379,901,430,876,176,248,606,1124,0.0551439925428053,0.53914590747331
2014,13031,165,1110,196,455,36,46,232,501,0.0132466090267312,0.463073852295409
2014,13033,24,385,26,105,11,11,37,116,0.00795010622986773,0.318965517241379
2014,13035,95,1513,12,147,0,7,12,154,0.0096630482524942,0.0779220779220779
2014,13037,56,718,2,75,0,0,2,75,0.0167075072399198,0.0266666666666667
2014,13039,108,462,305,1547,24,210,329,1757,0.0563954421441181,0.187250996015936
2014,13043,22,352,8,126,0,0,8,126,0.0176125244618395,0.0634920634920635
2014,13045,730,3132,255,962,60,309,315,1271,0.018471689338449,0.247836349331235
2014,13047,123,1033,380,1621,1,10,381,1631,0.0371983761346531,0.233599019006744
2014,13049,0,857,5,565,1,14,6,579,0.0631131458469588,0.0103626943005181
2014,13051,1140,4224,2639,6535,326,1318,2965,7853,0.0438653819298981,0.377562714886031
2014,13053,12,216,723,1378,309,544,1032,1922,0.362983947119924,0.536940686784599
2014,13055,13,300,66,229,0,17,66,246,0.0139337298215803,0.268292682926829
2014,13057,2105,6056,1202,3361,204,417,1406,3778,0.0260616428906487,0.372154579142403
2014,13059,851,2947,1048,1631,294,478,1342,2109,0.0330911772551112,0.636320531057373
2014,13061,0,84,0,82,0,3,0,85,0.0431910569105691,0
2014,13063,1167,9901,659,4239,106,655,765,4894,0.0304428962428465,0.156313853698406
2014,13065,24,157,0,68,0,0,0,68,0.0153602891348543,0
2014,13067,8099,20260,6733,14487,1528,2731,8261,17218,0.0369697594324633,0.479788593332559
2014,13069,49,635,84,257,0,147,84,404,0.0148819390724574,0.207920792079208
2014,13071,175,782,70,728,0,141,70,869,0.0296840307429547,0.0805523590333717
2014,13073,906,2884,1431,3268,186,586,1617,3854,0.0449058538404176,0.419564089257914
2014,13075,27,312,36,144,0,67,36,211,0.0188224799286351,0.170616113744076
2014,13077,849,3870,520,1890,238,306,758,2196,0.0255342899002349,0.345173041894353
2014,13079,42,279,0,54,0,7,0,61,0.00701794753796595,0
2014,13081,18,359,11,158,8,26,19,184,0.011971372804164,0.103260869565217
2014,13083,5,205,91,354,0,0,91,354,0.0320217096336499,0.257062146892655
2014,13085,208,740,40,146,12,12,52,158,0.0100419473751112,0.329113924050633
2014,13087,83,725,16,435,0,15,16,450,0.0249694817445345,0.0355555555555556
2014,13089,9705,23168,6053,12788,1732,4257,7785,17045,0.0361625479479955,0.456732179524787
2014,13091,0,348,0,67,0,0,0,67,0.0046219646799117,0
2014,13093,6,193,0,9,0,0,0,9,0.000888713340574701,0
2014,13095,427,2333,218,887,7,14,225,901,0.0154360116498201,0.249722530521643
2014,13097,961,4304,528,2409,81,328,609,2737,0.0318496538081108,0.222506393861893
2014,13099,13,141,12,37,0,0,12,37,0.00524673851389677,0.324324324324324
2014,13101,7,166,0,11,0,63,0,74,0.0295291300877893,0
2014,13103,125,725,186,734,0,40,186,774,0.0226501229076437,0.24031007751938
2014,13105,0,176,30,218,0,0,30,218,0.0160223430839336,0.137614678899083
2014,13107,63,522,9,250,0,0,9,250,0.0169480035251847,0.036
2014,13109,41,387,9,130,0,0,9,130,0.0185475816806962,0.0692307692307692
2014,13111,75,399,28,599,9,30,37,629,0.0351848744196454,0.0588235294117647
2014,13113,925,2870,674,1395,138,308,812,1703,0.0235915053957084,0.476805637110981
2014,13115,310,1874,213,750,61,118,274,868,0.0137592137592138,0.315668202764977
2014,13117,1791,4127,1473,3050,223,720,1696,3770,0.0311995696611081,0.449867374005305
2014,13119,34,585,41,136,11,26,52,162,0.0106515878756,0.320987654320988
2014,13121,13432,29365,11223,19912,2955,4427,14178,24339,0.0382299166886568,0.582521878466658
2014,13123,178,1111,129,462,0,81,129,543,0.0267079828832817,0.237569060773481
2014,13125,11,48,0,28,0,0,0,28,0.0135004821600771,0
2014,13127,469,1727,440,1274,104,243,544,1517,0.0275357583678211,0.358602504943968
2014,13129,233,1040,120,592,0,78,120,670,0.0185610992603263,0.17910447761194
2014,13131,7,386,103,658,0,10,103,668,0.0399354337298978,0.154191616766467
2014,13133,77,287,50,106,0,42,50,148,0.0123953098827471,0.337837837837838
2014,13135,5694,16217,4589,12123,1770,4000,6359,16123,0.0305348860552366,0.394405507659865
2014,13137,168,1215,19,382,24,33,43,415,0.0142050316618176,0.103614457831325
2014,13139,1004,3963,507,2094,58,337,565,2431,0.0206793300271358,0.23241464417935
2014,13141,20,428,0,73,0,31,0,104,0.0160741885625966,0
2014,13143,53,791,20,263,0,19,20,282,0.0148358585858586,0.0709219858156028
2014,13145,239,1256,19,147,30,31,49,178,0.00787366744813553,0.275280898876405
2014,13147,53,684,55,301,0,23,55,324,0.0182504365459359,0.169753086419753
2014,13149,34,453,4,100,3,3,7,103,0.01319666880205,0.0679611650485437
2014,13151,1401,5536,760,2483,269,493,1029,2976,0.0226175909529636,0.345766129032258
2014,13153,516,3343,783,2356,263,530,1046,2886,0.0309420934695672,0.362439362439362
2014,13155,37,279,13,124,0,0,13,124,0.0190154884220212,0.104838709677419
2014,13157,246,1709,56,399,32,115,88,514,0.012806138974014,0.171206225680934
2014,13159,124,541,0,89,8,37,8,126,0.0137180185084377,0.0634920634920635
2014,13161,33,187,0,78,0,10,0,88,0.00916475734222037,0
2014,13163,41,475,63,187,7,7,70,194,0.017885129528902,0.360824742268041
2014,13165,48,366,0,73,0,0,0,73,0.0122999157540017,0
2014,13167,20,605,9,62,0,0,9,62,0.00895177591683511,0.145161290322581
2014,13169,197,1055,0,52,0,36,0,88,0.00456029434627144,0
2014,13171,79,608,0,210,0,26,0,236,0.020343073872942,0
2014,13173,33,552,3,146,38,55,41,201,0.0299285288862418,0.203980099502488
2014,13175,99,605,85,342,9,53,94,395,0.0124077273441181,0.237974683544304
2014,13177,278,1401,73,364,41,45,114,409,0.0219585525609363,0.278728606356968
2014,13179,269,1237,517,2708,209,1085,726,3793,0.105217897861244,0.191405220142368
2014,13181,5,102,25,79,0,0,25,79,0.0140719629497684,0.316455696202532
2014,13183,116,723,22,585,25,98,47,683,0.0728377946038179,0.068814055636896
2014,13185,308,2126,680,2086,48,539,728,2625,0.0410066547942638,0.277333333333333
2014,13187,322,1258,171,401,0,80,171,481,0.0252838519764508,0.355509355509356
2014,13189,59,384,68,226,0,0,68,226,0.0158108297187631,0.300884955752212
2014,13191,88,368,2,125,0,0,2,125,0.0121879875195008,0.016
2014,13193,9,540,0,24,0,101,0,125,0.0127122953320452,0
2014,13195,120,518,37,217,7,32,44,249,0.0129377532993869,0.176706827309237
2014,13197,25,404,40,65,7,7,47,72,0.0119780402595242,0.652777777777778
2014,13199,140,721,41,61,0,7,41,68,0.00461831024178212,0.602941176470588
2014,13201,0,128,5,21,0,4,5,25,0.00609904854842645,0.2
2014,13205,17,951,4,194,0,0,4,194,0.0125331093739906,0.0206185567010309
2014,13207,220,1276,58,424,0,5,58,429,0.023122945076268,0.135198135198135
2014,13209,25,255,11,62,0,0,11,62,0.0105424247576943,0.17741935483871
2014,13211,75,305,45,198,0,39,45,237,0.0193311582381729,0.189873417721519
2014,13213,6,677,17,183,0,19,17,202,0.00786328778854763,0.0841584158415842
2014,13215,705,4107,2345,6720,442,1162,2787,7882,0.0626694548027765,0.353590459274296
2014,13217,254,3053,169,1029,71,121,240,1150,0.0180135022947636,0.208695652173913
2014,13219,267,843,222,329,14,37,236,366,0.0166409020641993,0.644808743169399
2014,13221,211,716,45,146,0,15,45,161,0.0156098506883847,0.279503105590062
2014,13223,1022,4163,737,1697,18,238,755,1935,0.0212663069162206,0.390180878552972
2014,13225,180,928,0,173,0,7,0,180,0.010919017288444,0
2014,13227,111,708,40,218,18,39,58,257,0.0120685606949988,0.22568093385214
2014,13229,108,571,56,89,11,11,67,100,0.00808603541683513,0.67
2014,13231,51,791,60,123,3,3,63,126,0.0107133747130346,0.5
2014,13233,104,934,12,131,0,64,12,195,0.0072715068799642,0.0615384615384615
2014,13235,3,353,0,21,0,23,0,44,0.00503432494279176,0
2014,13237,148,639,74,259,0,80,74,339,0.0220459127267998,0.218289085545723
2014,13239,0,25,6,62,0,0,6,62,0.0386774797255147,0.0967741935483871
2014,13241,62,221,75,199,3,3,78,202,0.0167969399634126,0.386138613861386
2014,13243,28,266,0,43,0,0,0,43,0.00876120619396903,0
2014,13245,582,3490,1764,4984,224,737,1988,5721,0.0446186242395882,0.347491697255725
2014,13247,508,3207,260,1582,12,189,272,1771,0.0318880766322158,0.153585544889893
2014,13249,15,145,9,50,0,0,9,50,0.0150105073551486,0.18
2014,13251,29,335,0,45,0,1,0,46,0.00482534354348054,0
2014,13253,33,100,10,65,0,0,10,65,0.01064875491481,0.153846153846154
2014,13255,279,2094,150,788,0,32,150,820,0.0193784709913742,0.182926829268293
2014,13257,21,293,13,219,27,36,40,255,0.0149454929082171,0.156862745098039
2014,13259,19,430,15,325,8,63,23,388,0.090316573556797,0.0592783505154639
2014,13261,116,787,28,161,16,20,44,181,0.0092621021389827,0.243093922651934
2014,13263,23,133,0,47,0,8,0,55,0.0115984816533108,0
2014,13265,11,43,1,4,0,5,1,9,0.00728744939271255,0.111111111111111
2014,13267,78,1991,5,273,0,27,5,300,0.0173661360347323,0.0166666666666667
2014,13269,28,346,7,129,0,7,7,136,0.0237554585152838,0.0514705882352941
2014,13271,21,205,0,24,0,9,0,33,0.00272637144745539,0
2014,13273,12,345,0,31,0,0,0,31,0.0050761421319797,0
2014,13275,121,738,111,410,0,95,111,505,0.0167440318302387,0.21980198019802
2014,13277,76,691,224,433,4,39,228,472,0.0186061179438663,0.483050847457627
2014,13279,22,275,10,121,0,43,10,164,0.00946882217090069,0.0609756097560976
2014,13281,28,164,128,307,0,17,128,324,0.041591784338896,0.395061728395062
2014,13283,6,269,0,12,0,6,0,18,0.0039275583678813,0
2014,13285,160,1432,173,1238,110,263,283,1501,0.0344503098462245,0.188540972684877
2014,13287,7,151,0,27,0,48,0,75,0.0134989200863931,0
2014,13289,39,221,0,0,1,2,1,2,0.000329760923330585,0.5
2014,13291,47,279,84,344,27,27,111,371,0.0226758755577287,0.299191374663073
2014,13293,57,433,20,209,0,0,20,209,0.011481623908147,0.0956937799043062
2014,13295,117,1497,403,1301,0,40,403,1341,0.0284290862836549,0.300521998508576
2014,13297,409,1736,124,1060,0,22,124,1082,0.0194268888250503,0.11460258780037
2014,13299,162,1348,33,275,22,82,55,357,0.0149147727272727,0.15406162464986
2014,13301,8,60,20,46,0,0,20,46,0.0119325551232166,0.434782608695652
2014,13303,31,717,1,25,0,28,1,53,0.00373686808150603,0.0188679245283019
2014,13305,196,728,143,530,0,30,143,560,0.0274388750061247,0.255357142857143
2014,13307,0,12,0,78,0,9,0,87,0.0454308093994778,0
2014,13309,13,150,0,8,0,0,0,8,0.00128803735308324,0
2014,13311,170,530,15,155,0,0,15,155,0.00803358557064372,0.0967741935483871
2014,13313,120,1588,313,1060,57,180,370,1240,0.0191713048855906,0.298387096774194
2014,13315,41,705,4,90,0,8,4,98,0.0151141270820481,0.0408163265306122
2014,13317,26,247,60,133,0,0,60,133,0.0183625569515394,0.451127819548872
2014,13319,5,169,0,24,0,19,0,43,0.00668636292955994,0
2014,13321,43,447,6,275,0,0,6,275,0.0190932444629591,0.0218181818181818
2014,15001,196,963,1329,3555,260,772,1589,4327,0.0329683726104216,0.367229027039519
2014,15003,428,1968,8651,22701,3115,8136,11766,30837,0.0466837534119243,0.381554625936375
2014,15005,0,0,2,2,0,0,2,2,0.0298507462686567,1
2014,15007,179,561,602,1105,64,348,666,1453,0.0301271019511083,0.458362009635237
2014,15009,189,1059,1290,3470,330,943,1620,4413,0.0398396663326382,0.367097212780421
2014,16001,1280,5789,4337,9386,449,1015,4786,10401,0.0389008572326197,0.46014806268628
2014,16003,18,116,20,66,3,3,23,69,0.0233977619532045,0.333333333333333
2014,16005,183,1453,460,1212,51,93,511,1305,0.0254862901335833,0.391570881226054
2014,16007,37,64,23,120,0,0,23,120,0.0306122448979592,0.191666666666667
2014,16009,30,90,19,162,0,5,19,167,0.0260855982505467,0.11377245508982
2014,16011,126,718,123,645,0,7,123,652,0.0241714243345444,0.188650306748466
2014,16013,44,167,215,416,68,76,283,492,0.0329471639991964,0.57520325203252
2014,16015,44,325,48,172,0,4,48,176,0.0341548612458762,0.272727272727273
2014,16017,148,611,234,871,13,37,247,908,0.0304228372311197,0.272026431718062
2014,16019,383,1702,566,1531,108,239,674,1770,0.0275220798606792,0.380790960451977
2014,16021,9,110,77,273,7,24,84,297,0.0391562294001318,0.282828282828283
2014,16023,7,48,11,33,0,1,11,34,0.0183189655172414,0.323529411764706
2014,16025,0,19,0,5,0,0,0,5,0.00614250614250614,0
2014,16027,700,4894,779,3554,37,310,816,3864,0.0330044843049327,0.211180124223602
2014,16029,10,63,24,77,0,28,24,105,0.0236433235757712,0.228571428571429
2014,16031,147,658,73,342,2,59,75,401,0.02939236238364,0.187032418952618
2014,16033,0,4,4,15,0,0,4,15,0.0314465408805031,0.266666666666667
2014,16035,62,355,38,153,0,0,38,153,0.0229007633587786,0.248366013071895
2014,16037,18,114,2,26,3,3,5,29,0.0089589125733704,0.172413793103448
2014,16039,68,333,95,626,73,447,168,1073,0.0681140100298356,0.156570363466915
2014,16041,16,57,46,287,3,28,49,315,0.042315959161741,0.155555555555556
2014,16043,40,191,112,201,0,0,112,201,0.0245481191988276,0.557213930348259
2014,16045,83,680,120,377,0,13,120,390,0.0334965215150734,0.307692307692308
2014,16047,17,236,12,101,5,20,17,121,0.012660876844198,0.140495867768595
2014,16049,131,528,55,342,0,5,55,347,0.0291890982503365,0.15850144092219
2014,16051,77,385,66,149,21,80,87,229,0.0151304922365378,0.379912663755459
2014,16053,44,466,18,167,0,105,18,272,0.020211026898499,0.0661764705882353
2014,16055,160,1308,1027,4112,3,97,1030,4209,0.0437985827115787,0.244713708719411
2014,16057,156,491,419,1143,124,158,543,1301,0.0613852977257714,0.417371252882398
2014,16059,7,42,32,222,0,8,32,230,0.0380794701986755,0.139130434782609
2014,16061,25,134,12,53,0,0,12,53,0.0190784737221022,0.226415094339623
2014,16063,61,155,8,55,0,0,8,55,0.0176,0.145454545454545
2014,16065,97,605,338,921,51,127,389,1048,0.0682069638789457,0.37118320610687
2014,16067,40,469,0,154,0,90,0,244,0.0194051216796564,0
2014,16069,94,564,194,843,0,4,194,847,0.0309949866432466,0.229043683589138
2014,16071,14,41,3,126,0,0,3,126,0.0450966356478167,0.0238095238095238
2014,16073,71,447,10,205,0,0,10,205,0.0281709495671293,0.0487804878048781
2014,16075,63,395,115,775,0,66,115,841,0.057916121479237,0.136741973840666
2014,16077,8,109,3,84,0,15,3,99,0.0210952482420626,0.0303030303030303
2014,16079,36,236,46,165,0,2,46,167,0.018126560295235,0.275449101796407
2014,16081,66,110,246,430,57,57,303,487,0.0740797079403712,0.62217659137577
2014,16083,271,1773,281,1323,10,216,291,1539,0.0308423014489268,0.189083820662768
2014,16085,28,349,133,298,0,0,133,298,0.0420132525024672,0.446308724832215
2014,16087,18,217,12,85,0,0,12,85,0.0121759060306546,0.141176470588235
2014,17001,90,383,145,583,7,50,152,633,0.0137803417873082,0.240126382306477
2014,17003,9,133,30,129,0,0,30,129,0.0244735344336938,0.232558139534884
2014,17005,66,415,178,332,0,0,178,332,0.0273498640744707,0.536144578313253
2014,17007,162,1079,97,404,23,23,120,427,0.0123642681337773,0.281030444964871
2014,17009,20,663,0,38,27,27,27,65,0.01272762874486,0.415384615384615
2014,17011,158,490,65,281,0,11,65,292,0.0121006174630144,0.222602739726027
2014,17013,0,56,12,32,0,9,12,41,0.0113259668508287,0.292682926829268
2014,17015,24,196,17,68,6,31,23,99,0.00903449534586603,0.232323232323232
2014,17017,66,403,34,162,43,93,77,255,0.0282266991365951,0.301960784313725
2014,17019,924,2298,2126,3567,1246,1640,3372,5207,0.0446351269105154,0.647589782984444
2014,17021,121,938,41,175,44,54,85,229,0.00945031363486299,0.37117903930131
2014,17023,19,130,25,272,13,29,38,301,0.0267531774953337,0.12624584717608
2014,17025,8,105,13,33,0,0,13,33,0.00352338244714926,0.393939393939394
2014,17027,112,1059,88,237,0,7,88,244,0.00921833087763044,0.360655737704918
2014,17029,251,896,163,585,14,16,177,601,0.0188667399152409,0.29450915141431
2014,17031,14063,29052,32587,52360,14182,23743,46769,76103,0.0216607597646044,0.614548703730471
2014,17033,41,538,8,104,0,3,8,107,0.00769507371449119,0.0747663551401869
2014,17035,51,307,36,171,0,0,36,171,0.0226460071513707,0.210526315789474
2014,17037,768,2354,263,551,110,204,373,755,0.0126018159967953,0.494039735099338
2014,17039,64,373,18,80,0,6,18,86,0.00739466895958727,0.209302325581395
2014,17041,12,292,58,133,0,13,58,146,0.0110698309197058,0.397260273972603
2014,17043,11110,22486,5149,8252,2287,4274,7436,12526,0.0200866906030658,0.593645217946671
2014,17045,71,348,77,303,0,15,77,318,0.0246473414974423,0.242138364779874
2014,17047,9,94,13,31,0,2,13,33,0.00712435233160622,0.393939393939394
2014,17049,95,407,90,279,32,52,122,331,0.014387551073633,0.368580060422961
2014,17051,73,749,48,154,0,0,48,154,0.0101603219634492,0.311688311688312
2014,17053,87,393,3,41,15,22,18,63,0.00649149922720247,0.285714285714286
2014,17055,117,546,5,221,9,53,14,274,0.00992322178762857,0.0510948905109489
2014,17057,64,1118,34,249,14,45,48,294,0.0112286598174388,0.163265306122449
2014,17059,22,63,2,53,0,0,2,53,0.0135549872122762,0.0377358490566038
2014,17061,32,186,9,80,0,0,9,80,0.00835247442054709,0.1125
2014,17063,115,994,61,221,40,40,101,261,0.00794520547945205,0.386973180076628
2014,17065,25,154,9,19,0,6,9,25,0.00426839679016561,0.36
2014,17067,20,150,115,326,0,21,115,347,0.0257075122240332,0.331412103746398
2014,17069,18,96,8,30,0,0,8,30,0.00974342318934719,0.266666666666667
2014,17071,43,136,55,165,0,1,55,166,0.0317278287461774,0.331325301204819
2014,17073,160,795,64,328,32,40,96,368,0.0106669758543726,0.260869565217391
2014,17075,123,528,28,139,15,29,43,168,0.00824094967134308,0.255952380952381
2014,17077,306,1256,387,924,119,222,506,1146,0.0329803154138368,0.441535776614311
2014,17079,33,136,22,93,0,11,22,104,0.0153098778153982,0.211538461538462
2014,17081,144,1001,68,344,14,37,82,381,0.0141357177308648,0.215223097112861
2014,17083,74,429,68,116,3,21,71,137,0.00880349569464079,0.518248175182482
2014,17085,94,268,78,276,0,23,78,299,0.0181410023055454,0.260869565217391
2014,17087,11,841,40,109,9,9,49,118,0.0127857839419222,0.415254237288136
2014,17089,3784,10888,1329,3572,300,1254,1629,4826,0.01458746433235,0.337546622461666
2014,17091,323,1940,180,606,50,201,230,807,0.0110383126564445,0.285006195786865
2014,17093,1002,3257,212,1207,62,107,274,1314,0.0178646690141803,0.208523592085236
2014,17095,169,1355,71,316,8,111,79,427,0.0116851841716381,0.185011709601874
2014,17097,4492,9268,3986,9067,1427,2606,5413,11673,0.0258898886821286,0.463719695022702
2014,17099,444,2246,187,602,0,61,187,663,0.00851900393184797,0.282051282051282
2014,17101,16,1204,34,201,0,60,34,261,0.0211644502108336,0.130268199233716
2014,17103,161,1500,83,275,9,84,92,359,0.0143830128205128,0.256267409470752
2014,17105,134,1625,51,252,8,41,59,293,0.010829791166143,0.201365187713311
2014,17107,114,2397,29,125,1,36,30,161,0.00765245496458957,0.186335403726708
2014,17109,199,578,155,258,11,30,166,288,0.0159203980099502,0.576388888888889
2014,17111,1484,4724,980,2940,103,286,1083,3226,0.0159415706350932,0.335709857408555
2014,17113,971,2132,1340,2249,654,755,1994,3004,0.0291746790202591,0.663781624500666
2014,17115,520,2004,412,1035,32,133,444,1168,0.0156335747078743,0.38013698630137
2014,17117,69,932,88,265,9,82,97,347,0.0105397442517389,0.279538904899135
2014,17119,858,3399,932,2655,148,232,1080,2887,0.0158432250594052,0.374090751645307
2014,17121,70,476,62,314,0,57,62,371,0.0138914891227019,0.16711590296496
2014,17123,73,286,58,80,2,10,60,90,0.0101902173913043,0.666666666666667
2014,17125,16,313,20,135,0,45,20,180,0.0175867122618466,0.111111111111111
2014,17127,18,164,11,294,6,16,17,310,0.029037092544024,0.0548387096774194
2014,17129,42,306,8,95,0,0,8,95,0.0107856494096276,0.0842105263157895
2014,17131,43,228,34,104,0,5,34,109,0.00952880496546901,0.311926605504587
2014,17133,145,721,246,572,16,41,262,613,0.0264178589898293,0.427406199021207
2014,17135,48,2172,58,284,0,6,58,290,0.0136734405205337,0.2
2014,17137,285,1149,20,368,52,71,72,439,0.0181788065758417,0.164009111617312
2014,17139,53,295,34,72,0,18,34,90,0.00887049083382614,0.377777777777778
2014,17141,142,852,70,272,2,104,72,376,0.0104709125845888,0.191489361702128
2014,17143,997,2885,1063,2281,402,590,1465,2871,0.023229095028116,0.510275165447579
2014,17145,119,895,10,44,0,6,10,50,0.00322643092211396,0.2
2014,17147,103,431,46,83,0,2,46,85,0.00734404700190081,0.541176470588235
2014,17149,19,348,29,143,0,48,29,191,0.0169371286689722,0.151832460732984
2014,17151,13,60,16,54,0,0,16,54,0.0169385194479297,0.296296296296296
2014,17153,0,54,0,43,0,0,0,43,0.0104141438604989,0
2014,17155,2,108,3,22,16,27,19,49,0.0116306669831474,0.387755102040816
2014,17157,33,920,57,247,0,30,57,277,0.011573977353445,0.205776173285199
2014,17159,188,407,50,131,0,0,50,131,0.0116465149359886,0.381679389312977
2014,17161,274,1628,370,1650,65,387,435,2037,0.0202139483189775,0.213549337260677
2014,17163,502,2533,1469,3998,296,715,1765,4713,0.0265462799722878,0.374496074687036
2014,17165,23,457,11,116,11,33,22,149,0.00870022188485344,0.147651006711409
2014,17167,1219,3226,917,1861,242,842,1159,2703,0.0199176178440634,0.428782833888272
2014,17169,15,94,0,23,0,0,0,23,0.0042287185144328,0
2014,17171,8,163,5,16,0,4,5,20,0.00547045951859956,0.25
2014,17173,51,505,26,73,0,2,26,75,0.00476856561546287,0.346666666666667
2014,17175,2,81,48,63,0,0,48,63,0.0150753768844221,0.761904761904762
2014,17177,218,853,112,364,0,27,112,391,0.011869706444856,0.286445012787724
2014,17179,535,2601,416,1163,33,125,449,1288,0.0136890211499628,0.34860248447205
2014,17181,69,317,41,179,0,0,41,179,0.0143429487179487,0.229050279329609
2014,17183,81,975,101,763,14,117,115,880,0.0161928420277854,0.130681818181818
2014,17185,26,80,20,50,0,16,20,66,0.00800873680378595,0.303030303030303
2014,17187,57,332,45,168,0,15,45,183,0.0158978368517071,0.245901639344262
2014,17189,30,284,8,91,9,11,17,102,0.00987415295256534,0.166666666666667
2014,17191,11,223,15,136,0,19,15,155,0.0133207287727741,0.0967741935483871
2014,17193,11,293,42,141,0,0,42,141,0.0135498750720738,0.297872340425532
2014,17195,107,673,42,242,16,60,58,302,0.00757252827160803,0.19205298013245
2014,17197,4481,12790,2165,4138,582,1442,2747,5580,0.012875298808458,0.492293906810036
2014,17199,363,1620,258,722,5,52,263,774,0.0166172871312637,0.339793281653747
2014,17201,932,3138,757,2649,257,558,1014,3207,0.0163759472211442,0.316183348924228
2014,17203,313,1141,90,195,20,37,110,232,0.00899957329609372,0.474137931034483
2014,18001,47,467,20,132,0,44,20,176,0.0084327535815246,0.113636363636364
2014,18003,795,3067,1055,3626,144,518,1199,4144,0.0179414133192481,0.289333976833977
2014,18005,301,1227,389,961,366,573,755,1534,0.0290222491297109,0.492177314211213
2014,18007,48,520,25,72,0,16,25,88,0.0148272957034541,0.284090909090909
2014,18009,9,213,6,43,0,7,6,50,0.00568310979768129,0.12
2014,18011,610,1452,383,731,17,64,400,795,0.0204249415512679,0.50314465408805
2014,18013,134,465,25,167,15,15,40,182,0.0164067429910755,0.21978021978022
2014,18015,81,582,32,126,5,20,37,146,0.0106081522923781,0.253424657534247
2014,18017,138,707,28,127,30,149,58,276,0.0106399383191982,0.210144927536232
2014,18019,356,1588,325,1683,19,23,344,1706,0.022226854626469,0.201641266119578
2014,18021,91,539,37,195,0,8,37,203,0.0110874433338795,0.182266009852217
2014,18023,143,720,6,137,0,44,6,181,0.00840336134453781,0.0331491712707182
2014,18025,10,206,6,94,0,4,6,98,0.01339896089691,0.0612244897959184
2014,18027,117,433,59,147,5,9,64,156,0.00783368484483278,0.41025641025641
2014,18029,68,409,169,944,25,50,194,994,0.0293310513736021,0.195171026156942
2014,18031,6,295,74,207,0,11,74,218,0.0124599908550526,0.339449541284404
2014,18033,128,792,30,421,56,75,86,496,0.0176997466366913,0.173387096774194
2014,18035,605,2377,287,1105,29,134,316,1239,0.017404374271306,0.255044390637611
2014,18037,124,470,173,373,0,69,173,442,0.0154135862742363,0.391402714932127
2014,18039,391,2615,586,1776,86,200,672,1976,0.0157467765328403,0.340080971659919
2014,18041,46,455,44,107,5,36,49,143,0.00857828434313137,0.342657342657343
2014,18043,246,1454,354,1250,18,97,372,1347,0.0263574992662166,0.276169265033408
2014,18045,79,367,5,99,0,13,5,112,0.00958575830195139,0.0446428571428571
2014,18047,142,480,48,218,0,33,48,251,0.0161612259352263,0.191235059760956
2014,18049,76,585,24,220,0,10,24,230,0.0163085868254981,0.104347826086957
2014,18051,99,488,47,242,0,12,47,254,0.0111320506639786,0.18503937007874
2014,18053,243,852,62,709,22,106,84,815,0.0180090597724008,0.103067484662577
2014,18055,17,763,39,195,37,41,76,236,0.0103481539945628,0.322033898305085
2014,18057,4227,7831,2892,4529,436,889,3328,5418,0.0291016516718142,0.614248800295312
2014,18059,371,1754,217,613,35,58,252,671,0.0140650219045423,0.375558867362146
2014,18061,94,447,66,530,0,20,66,550,0.0203079422515969,0.12
2014,18063,1160,5148,668,1327,227,360,895,1687,0.0170098207263708,0.530527563722584
2014,18065,142,1850,22,309,0,17,22,326,0.00937482026801633,0.0674846625766871
2014,18067,177,1205,194,839,18,148,212,987,0.0173535410366411,0.214792299898683
2014,18069,95,695,53,245,9,38,62,283,0.0114181964898124,0.219081272084806
2014,18071,133,575,73,283,9,31,82,314,0.0107715001200645,0.261146496815287
2014,18073,138,573,22,339,0,26,22,365,0.0166567790809109,0.0602739726027397
2014,18075,36,259,10,113,0,0,10,113,0.00811606693959635,0.0884955752212389
2014,18077,138,995,80,370,27,83,107,453,0.0206849315068493,0.236203090507726
2014,18079,66,631,0,342,12,78,12,420,0.0225297714837464,0.0285714285714286
2014,18081,850,4537,403,1936,208,334,611,2270,0.0240708339960766,0.269162995594714
2014,18083,132,585,48,466,41,80,89,546,0.0218557361300136,0.163003663003663
2014,18085,387,1585,402,913,97,181,499,1094,0.0214236757074317,0.456124314442413
2014,18087,113,750,33,236,0,30,33,266,0.0124368804937348,0.12406015037594
2014,18089,444,2342,1501,7908,324,871,1825,8779,0.0269626135215403,0.207882446747921
2014,18091,354,3622,355,1341,25,107,380,1448,0.0188159467747804,0.262430939226519
2014,18093,219,956,30,136,11,29,41,165,0.00515383414024676,0.248484848484848
2014,18095,415,2525,141,1078,78,142,219,1220,0.013639971825632,0.179508196721311
2014,18097,4469,13697,3841,10073,1132,2577,4973,12650,0.0211899541191428,0.393122529644269
2014,18099,163,891,136,312,2,28,138,340,0.0110053732116269,0.405882352941176
2014,18101,59,284,28,156,0,11,28,167,0.023422159887798,0.167664670658683
2014,18103,111,1485,27,303,0,5,27,308,0.0122528543581175,0.0876623376623377
2014,18105,815,2530,1660,2401,870,1057,2530,3458,0.0443862554070879,0.731636784268363
2014,18107,88,576,111,280,0,13,111,293,0.0115281712307208,0.378839590443686
2014,18109,357,2681,102,400,12,34,114,434,0.00923306031273269,0.262672811059908
2014,18111,30,280,32,191,15,15,47,206,0.0210418794688458,0.228155339805825
2014,18113,131,1204,108,274,7,55,115,329,0.0105645109498427,0.349544072948328
2014,18115,12,73,18,154,0,24,18,178,0.040695016003658,0.101123595505618
2014,18117,26,361,22,69,0,3,22,72,0.00537795040334628,0.305555555555556
2014,18119,25,713,5,87,0,0,5,87,0.0058295363173412,0.0574712643678161
2014,18121,130,760,0,136,0,2,0,138,0.0113870781417609,0
2014,18123,86,613,44,262,0,0,44,262,0.0191003863818619,0.16793893129771
2014,18125,8,154,18,63,0,0,18,63,0.00700389105058366,0.285714285714286
2014,18127,747,2969,727,2044,47,186,774,2230,0.020022266915673,0.347085201793722
2014,18129,69,375,49,197,9,46,58,243,0.0138516787322579,0.238683127572016
2014,18131,10,244,32,44,12,31,44,75,0.00830748781568454,0.586666666666667
2014,18133,138,1821,0,194,12,32,12,226,0.00914202499898871,0.0530973451327434
2014,18135,33,419,41,223,0,18,41,241,0.0136373924852875,0.170124481327801
2014,18137,78,464,77,248,0,0,77,248,0.0129119591815484,0.310483870967742
2014,18139,36,296,50,158,25,32,75,190,0.0161867439086727,0.394736842105263
2014,18141,560,2776,1613,3719,416,844,2029,4563,0.026528298595971,0.444663598509752
2014,18143,35,373,42,146,13,30,55,176,0.0108421117476745,0.3125
2014,18145,238,1304,46,405,24,77,70,482,0.0159049661771985,0.145228215767635
2014,18147,78,409,45,105,0,25,45,130,0.00891632373113855,0.346153846153846
2014,18149,98,537,2,187,0,18,2,205,0.0130133942741065,0.00975609756097561
2014,18151,144,527,108,671,0,26,108,697,0.0302753887585788,0.154949784791966
2014,18153,24,790,11,36,0,5,11,41,0.00273406241664444,0.268292682926829
2014,18155,40,187,2,83,2,11,4,94,0.013399857448325,0.0425531914893617
2014,18157,733,2781,1127,2271,704,1084,1831,3355,0.0343082114735658,0.54575260804769
2014,18159,11,290,41,45,0,2,41,47,0.00424609269130003,0.872340425531915
2014,18161,0,108,31,108,0,5,31,113,0.02253689668927,0.274336283185841
2014,18163,735,2560,702,2348,26,249,728,2597,0.021494785631518,0.280323450134771
2014,18165,31,132,12,87,11,35,23,122,0.0109820865964533,0.188524590163934
2014,18167,317,1588,396,1354,78,194,474,1548,0.0222666532414666,0.306201550387597
2014,18169,8,603,47,162,0,15,47,177,0.00805717407137655,0.265536723163842
2014,18171,20,186,2,31,0,0,2,31,0.00522589345920432,0.0645161290322581
2014,18173,355,1290,197,530,41,134,238,664,0.0162121249114925,0.358433734939759
2014,18175,85,565,28,179,0,15,28,194,0.0102320675105485,0.144329896907216
2014,18177,187,942,259,1223,13,27,272,1250,0.0268493856860555,0.2176
2014,18179,131,497,37,171,0,12,37,183,0.00976052056109659,0.202185792349727
2014,18181,150,579,18,101,11,86,29,187,0.0110402644940371,0.155080213903743
2014,18183,209,926,69,261,0,8,69,269,0.0118241758241758,0.256505576208178
2014,19001,46,268,24,56,0,2,24,58,0.0107149455015703,0.413793103448276
2014,19003,4,65,15,23,1,11,16,34,0.0119131044148563,0.470588235294118
2014,19005,27,155,13,210,20,58,33,268,0.0268510169321711,0.123134328358209
2014,19007,53,238,10,195,0,0,10,195,0.0216378162450067,0.0512820512820513
2014,19009,19,118,2,10,0,5,2,15,0.00348432055749129,0.133333333333333
2014,19011,118,555,26,74,0,12,26,86,0.00488275705444842,0.302325581395349
2014,19013,453,1552,374,1186,131,240,505,1426,0.0172524348194302,0.35413744740533
2014,19015,300,925,87,205,0,33,87,238,0.0131086142322097,0.365546218487395
2014,19017,149,498,62,197,27,59,89,256,0.0160140122607281,0.34765625
2014,19019,76,286,38,127,7,48,45,175,0.0125890223724912,0.257142857142857
2014,19021,100,333,106,351,5,146,111,497,0.0382131324004306,0.223340040241449
2014,19023,76,282,4,29,0,6,4,35,0.00333619292727099,0.114285714285714
2014,19025,107,548,2,32,1,3,3,35,0.00488008923591746,0.0857142857142857
2014,19027,82,395,56,140,0,12,56,152,0.0107314317989269,0.368421052631579
2014,19029,66,251,7,52,8,19,15,71,0.00735827546896051,0.211267605633803
2014,19031,67,337,3,55,0,0,3,55,0.00428615960099751,0.0545454545454545
2014,19033,281,835,163,335,2,7,165,342,0.0110383113320208,0.482456140350877
2014,19035,28,279,35,65,7,26,42,91,0.0105666511843939,0.461538461538462
2014,19037,30,136,16,76,2,16,18,92,0.0108070010572066,0.195652173913043
2014,19039,17,117,0,106,0,15,0,121,0.0196908055329536,0
2014,19041,103,291,69,153,0,37,69,190,0.0163300386764074,0.363157894736842
2014,19043,36,261,39,154,3,8,42,162,0.0128418549346017,0.259259259259259
2014,19045,183,495,104,607,16,56,120,663,0.0197756964743781,0.180995475113122
2014,19047,53,206,16,103,12,54,28,157,0.0140003566969859,0.178343949044586
2014,19049,1373,2703,714,1149,41,124,755,1273,0.027090870397957,0.593087195600943
2014,19051,14,216,1,61,0,2,1,63,0.0113965267727931,0.0158730158730159
2014,19053,66,219,22,35,0,0,22,35,0.00685199686765858,0.628571428571429
2014,19055,48,407,27,87,0,0,27,87,0.00724275724275724,0.310344827586207
2014,19057,81,624,93,450,33,83,126,533,0.0191231343283582,0.236397748592871
2014,19059,70,221,98,185,4,4,102,189,0.0149916712937257,0.53968253968254
2014,19061,271,820,467,1703,164,206,631,1909,0.0302152579930358,0.330539549502357
2014,19063,24,108,25,261,8,18,33,279,0.0407656341320865,0.118279569892473
2014,19065,78,454,42,148,0,5,42,153,0.0109020949123557,0.274509803921569
2014,19067,62,244,48,312,2,44,50,356,0.0318198069360029,0.140449438202247
2014,19069,49,159,37,75,0,0,37,75,0.0101474766608037,0.493333333333333
2014,19071,11,62,14,61,5,15,19,76,0.0148698884758364,0.25
2014,19073,25,313,0,76,4,16,4,92,0.0142238713667285,0.0434782608695652
2014,19075,84,259,15,40,0,2,15,42,0.00487861540248577,0.357142857142857
2014,19077,14,163,44,77,2,11,46,88,0.0114867510768829,0.522727272727273
2014,19079,34,348,45,163,2,3,47,166,0.0155722326454034,0.283132530120482
2014,19081,39,214,13,27,8,15,21,42,0.00529901589704769,0.5
2014,19083,69,313,17,101,2,2,19,103,0.00848644640355936,0.184466019417476
2014,19085,28,174,38,117,0,23,38,140,0.0137768155874828,0.271428571428571
2014,19087,94,487,37,207,4,4,41,211,0.015427359801126,0.194312796208531
2014,19089,15,121,0,89,0,0,0,89,0.0137388082741587,0
2014,19091,42,196,7,96,0,21,7,117,0.0172362993517973,0.0598290598290598
2014,19093,31,109,10,57,0,0,10,57,0.0114205570026047,0.175438596491228
2014,19095,88,508,50,248,0,0,50,248,0.0218540712019739,0.201612903225806
2014,19097,83,383,29,123,0,8,29,131,0.0094755877034358,0.221374045801527
2014,19099,109,1053,36,281,4,27,40,308,0.0118891376515093,0.12987012987013
2014,19101,78,248,150,260,135,151,285,411,0.034278565471226,0.693430656934307
2014,19103,960,2899,1657,2675,556,755,2213,3430,0.0427366401275869,0.645189504373178
2014,19105,60,565,108,173,0,30,108,203,0.0138642261986067,0.532019704433498
2014,19107,32,198,0,13,0,4,0,17,0.00234192037470726,0
2014,19109,71,343,17,94,1,10,18,104,0.00953341277843982,0.173076923076923
2014,19111,21,297,119,390,65,82,184,472,0.0188966290335495,0.389830508474576
2014,19113,821,3015,1002,2492,217,387,1219,2879,0.0202865054926471,0.423410906564779
2014,19115,36,161,13,48,0,10,13,58,0.00759062949875671,0.224137931034483
2014,19117,0,113,27,170,9,20,36,190,0.0311730926989336,0.189473684210526
2014,19119,60,141,20,115,0,6,20,121,0.0159001314060447,0.165289256198347
2014,19121,82,505,3,92,0,51,3,143,0.0135712252064155,0.020979020979021
2014,19123,66,364,20,253,0,10,20,263,0.0175169841481284,0.0760456273764259
2014,19125,243,645,182,330,4,17,186,347,0.0160343791876531,0.536023054755043
2014,19127,207,728,90,328,11,89,101,417,0.0153551570497478,0.24220623501199
2014,19129,74,282,96,205,0,9,96,214,0.0209188660801564,0.448598130841121
2014,19131,27,131,9,79,4,4,13,83,0.0112298741712894,0.156626506024096
2014,19133,17,193,28,97,0,0,28,97,0.0147103427358204,0.288659793814433
2014,19135,64,198,11,67,0,9,11,76,0.0138081395348837,0.144736842105263
2014,19137,26,207,64,140,0,0,64,140,0.0188172043010753,0.457142857142857
2014,19139,96,576,66,358,22,75,88,433,0.01530846738554,0.203233256351039
2014,19141,93,386,11,183,28,36,39,219,0.022165991902834,0.178082191780822
2014,19143,13,76,24,82,0,2,24,84,0.0189274447949527,0.285714285714286
2014,19145,70,467,102,347,0,4,102,351,0.0309879050057385,0.290598290598291
2014,19147,45,195,14,60,0,1,14,61,0.00957613814756672,0.229508196721311
2014,19149,59,250,26,204,13,40,39,244,0.0144335995267672,0.159836065573771
2014,19151,36,135,8,80,0,10,8,90,0.0175541252194266,0.0888888888888889
2014,19153,2614,7420,2676,6781,498,1307,3174,8088,0.0277085938436767,0.392433234421365
2014,19155,234,969,521,1820,32,155,553,1975,0.0317207927789021,0.28
2014,19157,52,266,127,234,27,49,154,283,0.0232119422572178,0.54416961130742
2014,19159,47,91,12,18,0,24,12,42,0.0118176702307259,0.285714285714286
2014,19161,40,214,29,53,0,3,29,56,0.00770818995182381,0.517857142857143
2014,19163,379,1183,1563,3911,217,454,1780,4365,0.0385992837246319,0.407789232531501
2014,19165,89,194,38,100,1,8,39,108,0.0127088726759237,0.361111111111111
2014,19167,37,215,74,355,0,78,74,433,0.0212713696207506,0.170900692840647
2014,19169,445,1683,939,1198,639,706,1578,1904,0.0396559265199009,0.828781512605042
2014,19171,51,221,10,109,4,4,14,113,0.00944105606149219,0.123893805309735
2014,19173,7,118,3,85,2,32,5,117,0.0263632266786841,0.0427350427350427
2014,19175,35,279,22,71,2,14,24,85,0.00993454885460496,0.282352941176471
2014,19177,16,130,21,86,0,2,21,88,0.0167491435097069,0.238636363636364
2014,19179,86,442,97,393,30,61,127,454,0.0188381742738589,0.279735682819383
2014,19181,448,1575,98,300,56,71,154,371,0.0121583535426362,0.415094339622642
2014,19183,96,456,66,230,0,0,66,230,0.0153333333333333,0.28695652173913
2014,19185,2,119,17,53,0,5,17,58,0.013148945817275,0.293103448275862
2014,19187,144,1049,94,557,73,92,167,649,0.0257121350184224,0.257318952234206
2014,19189,19,128,50,209,0,0,50,209,0.0279748360326596,0.239234449760766
2014,19191,39,286,90,187,2,23,92,210,0.015495867768595,0.438095238095238
2014,19193,148,795,490,1593,14,163,504,1756,0.0270983472477277,0.287015945330296
2014,19195,22,143,8,59,0,1,8,60,0.0111815132314573,0.133333333333333
2014,19197,13,172,17,144,0,18,17,162,0.0178512396694215,0.104938271604938
2014,20001,89,370,12,53,0,0,12,53,0.0059270856631626,0.226415094339623
2014,20003,51,423,8,97,0,0,8,97,0.0179496669133975,0.0824742268041237
2014,20005,45,161,5,32,0,20,5,52,0.00507762913777951,0.0961538461538462
2014,20007,11,79,3,62,0,2,3,64,0.0184066724187518,0.046875
2014,20009,100,553,77,404,5,13,82,417,0.0227545563680017,0.196642685851319
2014,20011,16,235,24,98,0,0,24,98,0.0100740131578947,0.244897959183673
2014,20013,90,274,7,124,1,13,8,137,0.0203173661574967,0.0583941605839416
2014,20015,566,2258,200,703,28,38,228,741,0.017436114640689,0.307692307692308
2014,20017,40,172,8,18,0,6,8,24,0.0122137404580153,0.333333333333333
2014,20019,17,68,10,99,0,4,10,103,0.0393430099312452,0.0970873786407767
2014,20021,40,162,33,265,0,9,33,274,0.0190172126596335,0.12043795620438
2014,20023,2,43,0,44,12,12,12,56,0.0282258064516129,0.214285714285714
2014,20025,16,47,25,62,0,3,25,65,0.0419896640826873,0.384615384615385
2014,20027,18,130,17,162,57,72,74,234,0.0395136778115502,0.316239316239316
2014,20029,19,136,27,69,0,30,27,99,0.0154349859681946,0.272727272727273
2014,20031,35,213,19,150,3,14,22,164,0.027563025210084,0.134146341463415
2014,20033,4,33,0,6,0,0,0,6,0.00449775112443778,0
2014,20035,98,893,120,619,10,21,130,640,0.0273084144051886,0.203125
2014,20037,87,331,240,519,16,19,256,538,0.0225085766881433,0.475836431226766
2014,20039,6,97,7,59,0,0,7,59,0.0266125394677492,0.11864406779661
2014,20041,62,490,107,388,0,17,107,405,0.0303734813259337,0.264197530864198
2014,20043,20,36,9,152,0,0,9,152,0.0292532717474981,0.0592105263157895
2014,20045,752,1791,1013,1521,353,503,1366,2024,0.0315633528265107,0.674901185770751
2014,20047,8,69,2,46,0,3,2,49,0.0234225621414914,0.0408163265306122
2014,20049,30,125,0,10,0,0,0,10,0.00484261501210654,0
2014,20051,150,616,87,282,3,64,90,346,0.0197578803106441,0.260115606936416
2014,20053,55,363,6,34,0,16,6,50,0.0106382978723404,0.12
2014,20055,100,420,171,378,27,123,198,501,0.0232590529247911,0.395209580838323
2014,20057,102,504,51,333,35,163,86,496,0.0245022970903522,0.173387096774194
2014,20059,74,465,100,317,14,29,114,346,0.0203517440150579,0.329479768786127
2014,20061,198,709,369,1578,108,702,477,2280,0.115372937961745,0.209210526315789
2014,20063,10,39,3,28,1,1,4,29,0.0144278606965174,0.137931034482759
2014,20065,7,31,5,42,0,0,5,42,0.022070415133999,0.119047619047619
2014,20067,13,92,47,87,0,2,47,89,0.0189644150862987,0.528089887640449
2014,20069,23,95,14,86,0,0,14,86,0.0227633668607729,0.162790697674419
2014,20071,0,19,0,17,0,0,0,17,0.0198135198135198,0
2014,20073,29,102,0,15,0,0,0,15,0.00322927879440258,0
2014,20075,0,41,5,28,0,2,5,30,0.0178784266984505,0.166666666666667
2014,20077,25,100,16,73,0,6,16,79,0.0191608052389037,0.20253164556962
2014,20079,227,833,51,370,6,99,57,469,0.0204821381780068,0.121535181236674
2014,20081,0,104,10,53,0,5,10,58,0.0226474033580633,0.172413793103448
2014,20083,0,39,2,8,0,0,2,8,0.00586080586080586,0.25
2014,20085,78,331,81,179,0,0,81,179,0.019757174392936,0.452513966480447
2014,20087,141,542,12,74,0,8,12,82,0.00624001217563351,0.146341463414634
2014,20089,8,51,0,34,0,3,0,37,0.016093953892997,0
2014,20091,2523,6491,7903,13876,1065,1727,8968,15603,0.041769844223083,0.574761263859514
2014,20093,43,158,0,112,0,19,0,131,0.0517173312277931,0
2014,20095,34,91,14,169,0,0,14,169,0.0307328605200946,0.0828402366863905
2014,20097,17,59,9,27,0,0,9,27,0.0161001788908766,0.333333333333333
2014,20099,45,424,83,225,0,0,83,225,0.0158116654954322,0.368888888888889
2014,20101,4,27,2,2,0,3,2,5,0.00434782608695652,0.4
2014,20103,370,1661,1511,3566,409,661,1920,4227,0.0813166095956293,0.454222853087296
2014,20105,9,77,6,53,0,10,6,63,0.02734375,0.0952380952380952
2014,20107,24,158,29,93,0,0,29,93,0.0137249114521842,0.311827956989247
2014,20109,8,45,3,47,1,10,4,57,0.0291858678955453,0.0701754385964912
2014,20111,81,589,81,615,13,81,94,696,0.0351355444494927,0.135057471264368
2014,20113,129,581,75,305,28,41,103,346,0.0173442277808411,0.297687861271676
2014,20115,19,291,43,81,8,26,51,107,0.0125366139425893,0.476635514018692
2014,20117,26,207,20,103,5,5,25,108,0.0151642796967144,0.231481481481481
2014,20119,30,105,9,53,0,4,9,57,0.0198606271777003,0.157894736842105
2014,20121,131,819,88,382,5,5,93,387,0.0177441540577717,0.24031007751938
2014,20123,51,122,19,20,0,1,19,21,0.00480439258750858,0.904761904761905
2014,20125,99,468,107,457,37,79,144,536,0.0233256451542713,0.26865671641791
2014,20127,39,145,6,129,0,37,6,166,0.0393644771164335,0.036144578313253
2014,20129,32,102,5,16,0,0,5,16,0.00776322173702086,0.3125
2014,20131,98,208,33,58,0,10,33,68,0.00997506234413965,0.485294117647059
2014,20133,186,609,15,41,0,13,15,54,0.00494143484626647,0.277777777777778
2014,20135,5,51,0,14,0,0,0,14,0.00594227504244482,0
2014,20137,26,292,6,132,0,0,6,132,0.0320543953375425,0.0454545454545455
2014,20139,31,458,59,142,14,17,73,159,0.0143294881038212,0.459119496855346
2014,20141,52,106,14,73,0,5,14,78,0.0280474649406688,0.179487179487179
2014,20143,33,206,1,49,0,0,1,49,0.0116500237755587,0.0204081632653061
2014,20145,48,467,41,191,0,2,41,193,0.0388564525870747,0.212435233160622
2014,20147,38,120,14,33,0,0,14,33,0.00849420849420849,0.424242424242424
2014,20149,189,525,148,394,0,41,148,435,0.0310448187268056,0.340229885057471
2014,20151,2,152,87,124,0,21,87,145,0.0227736767708497,0.6
2014,20153,9,23,25,35,0,0,25,35,0.0178298522669384,0.714285714285714
2014,20155,320,1736,126,679,103,278,229,957,0.0220883534136546,0.239289446185998
2014,20157,16,67,18,83,0,0,18,83,0.0228147333699835,0.216867469879518
2014,20159,29,213,24,88,0,3,24,91,0.0139656230816452,0.263736263736264
2014,20161,327,1123,771,1991,345,628,1116,2619,0.0719327638770634,0.426116838487972
2014,20163,16,152,3,22,0,6,3,28,0.00758602004876727,0.107142857142857
2014,20165,27,79,11,32,0,0,11,32,0.0134115674769489,0.34375
2014,20167,17,161,7,127,0,1,7,128,0.0255744255744256,0.0546875
2014,20169,154,781,387,736,0,34,387,770,0.0210503294239864,0.502597402597403
2014,20171,0,47,19,46,0,0,19,46,0.0132947976878613,0.41304347826087
2014,20173,1780,4935,1947,5839,384,1090,2331,6929,0.0216228530057919,0.336412180689854
2014,20175,84,324,104,448,0,49,104,497,0.0375547831343509,0.209255533199195
2014,20177,508,2046,783,2179,108,366,891,2545,0.0213376036487721,0.350098231827112
2014,20179,0,67,6,13,0,0,6,13,0.00725851479620324,0.461538461538462
2014,20181,27,141,69,220,0,0,69,220,0.0527451450491489,0.313636363636364
2014,20183,5,45,9,38,0,0,9,38,0.0137781000725163,0.236842105263158
2014,20185,20,101,3,21,5,5,8,26,0.00855826201448321,0.307692307692308
2014,20187,1,46,11,33,0,6,11,39,0.0284256559766764,0.282051282051282
2014,20189,12,117,5,84,0,5,5,89,0.0243502051983584,0.0561797752808989
2014,20191,98,593,45,131,0,29,45,160,0.010094000378525,0.28125
2014,20193,43,158,47,118,0,0,47,118,0.0236520344758469,0.398305084745763
2014,20195,17,131,26,49,0,0,26,49,0.0236144578313253,0.530612244897959
2014,20197,32,163,6,61,0,1,6,62,0.0128284709290296,0.0967741935483871
2014,20199,8,30,0,18,0,0,0,18,0.0166358595194085,0
2014,20201,4,80,6,83,0,1,6,84,0.0206642066420664,0.0714285714285714
2014,20203,3,15,26,60,0,0,26,60,0.0415512465373961,0.433333333333333
2014,20205,8,161,18,81,0,0,18,81,0.0127318453316567,0.222222222222222
2014,20207,19,92,2,23,0,0,2,23,0.00970873786407767,0.0869565217391304
2014,20209,587,2620,595,3061,215,716,810,3777,0.0379350173253653,0.214455917394758
2014,21001,51,454,45,310,0,13,45,323,0.0258627592281207,0.139318885448916
2014,21003,73,405,12,352,9,32,21,384,0.0284191829484902,0.0546875
2014,21005,116,817,37,80,0,5,37,85,0.00582670688236907,0.435294117647059
2014,21007,14,167,15,55,0,3,15,58,0.00992980653997603,0.258620689655172
2014,21009,62,533,91,419,2,32,93,451,0.0155367231638418,0.206208425720621
2014,21011,57,500,0,52,0,36,0,88,0.0110483364720653,0
2014,21013,18,354,104,445,0,0,104,445,0.022663610898905,0.233707865168539
2014,21015,656,2926,1054,2930,354,388,1408,3318,0.0416986087896344,0.424352019288728
2014,21017,57,415,25,148,0,36,25,184,0.0133711212847903,0.135869565217391
2014,21019,158,898,146,922,15,36,161,958,0.0272942249066925,0.168058455114823
2014,21021,139,927,60,559,19,44,79,603,0.0308408346972177,0.131011608623549
2014,21023,6,106,13,51,0,14,13,65,0.011455763130067,0.2
2014,21025,9,156,20,49,5,16,25,65,0.00687103594080338,0.384615384615385
2014,21027,12,417,15,179,0,24,15,203,0.0146739916148619,0.0738916256157636
2014,21029,247,2054,93,702,8,36,101,738,0.0143831611771584,0.136856368563686
2014,21031,8,136,6,179,0,0,6,179,0.0201667417755746,0.0335195530726257
2014,21033,123,339,45,138,0,0,45,138,0.0153044249750471,0.326086956521739
2014,21035,87,320,173,386,79,90,252,476,0.0207615475203908,0.529411764705882
2014,21037,624,1729,642,1709,32,81,674,1790,0.0294577470583395,0.376536312849162
2014,21039,25,75,1,18,0,0,1,18,0.00506614128905151,0.0555555555555556
2014,21041,10,333,54,253,0,5,54,258,0.036358511837655,0.209302325581395
2014,21043,22,470,20,289,0,38,20,327,0.0176794982698962,0.0611620795107034
2014,21045,38,385,42,245,0,31,42,276,0.0249638205499276,0.152173913043478
2014,21047,182,1196,213,3028,234,973,447,4001,0.094240961017548,0.111722069482629
2014,21049,155,1250,47,406,0,38,47,444,0.0179039477398282,0.105855855855856
2014,21051,31,279,10,341,0,17,10,358,0.023776316663346,0.0279329608938547
2014,21053,0,145,0,60,0,0,0,60,0.00858491915867792,0
2014,21055,0,138,0,114,3,3,3,117,0.0180890538033395,0.0256410256410256
2014,21057,32,81,8,79,0,6,8,85,0.0177749895441238,0.0941176470588235
2014,21059,187,1605,71,457,26,146,97,603,0.00919011186636998,0.160862354892206
2014,21061,37,202,6,129,0,0,6,129,0.0151568558336271,0.0465116279069767
2014,21063,5,460,0,5,0,0,0,5,0.00088261253309797,0
2014,21065,33,204,3,29,0,11,3,40,0.00389218643573027,0.075
2014,21067,1838,6959,3094,5954,892,1862,3986,7816,0.0397766887026265,0.509979529170931
2014,21069,31,107,7,179,0,0,7,179,0.018196604655891,0.0391061452513966
2014,21071,134,1003,16,191,0,0,16,191,0.00704225352112676,0.0837696335078534
2014,21073,495,1725,136,552,28,110,164,662,0.0193567251461988,0.24773413897281
2014,21075,32,221,22,166,0,4,22,170,0.0365434221840069,0.129411764705882
2014,21077,16,232,59,172,10,12,69,184,0.0327402135231317,0.375
2014,21079,120,508,0,97,9,26,9,123,0.0103596395182346,0.0731707317073171
2014,21081,43,644,31,109,0,5,31,114,0.00724960254372019,0.271929824561404
2014,21083,15,284,24,272,41,123,65,395,0.0155757097791798,0.164556962025316
2014,21085,79,605,0,346,5,29,5,375,0.0214236745886654,0.0133333333333333
2014,21087,6,238,0,57,0,16,0,73,0.00925456389452333,0
2014,21089,84,531,163,557,0,20,163,577,0.0223141774305824,0.282495667244367
2014,21091,70,323,5,119,0,8,5,127,0.0220103986135182,0.0393700787401575
2014,21093,428,2158,1307,4105,153,797,1460,4902,0.070911931489411,0.297837617299062
2014,21095,38,326,14,135,0,5,14,140,0.00710119198579762,0.1
2014,21097,59,594,49,193,0,0,49,193,0.0150863753615258,0.253886010362694
2014,21099,32,252,0,66,13,23,13,89,0.00721465629053178,0.146067415730337
2014,21101,125,774,100,554,18,63,118,617,0.019370232003265,0.191247974068071
2014,21103,65,499,0,67,0,6,0,73,0.00693520805624169,0
2014,21105,41,253,12,73,0,0,12,73,0.0211226851851852,0.164383561643836
2014,21107,49,747,54,267,11,28,65,295,0.00913030021665119,0.220338983050847
2014,21109,0,177,0,85,0,0,0,85,0.00917530224525043,0
2014,21111,1951,7211,4637,10461,853,2612,5490,13073,0.0255642597061274,0.419949514266045
2014,21113,481,1900,310,547,43,50,353,597,0.0186866157505947,0.591289782244556
2014,21115,47,361,36,104,0,0,36,104,0.0064237183446572,0.346153846153846
2014,21117,728,3093,1317,3558,160,412,1477,3970,0.0367650463498884,0.372040302267003
2014,21119,6,195,38,210,0,10,38,220,0.0199365654734934,0.172727272727273
2014,21121,48,719,34,330,17,34,51,364,0.017180346438854,0.14010989010989
2014,21123,23,382,48,83,0,34,48,117,0.0119387755102041,0.41025641025641
2014,21125,152,1442,136,709,0,35,136,744,0.018377176732123,0.182795698924731
2014,21127,34,346,5,178,17,23,22,201,0.0185031759182546,0.109452736318408
2014,21129,3,308,0,155,0,0,0,155,0.0276144664172457,0
2014,21131,2,142,0,161,0,0,0,161,0.0207313932526397,0
2014,21133,33,179,15,58,0,0,15,58,0.0034311405584477,0.258620689655172
2014,21135,29,202,5,215,0,0,5,215,0.0226291969266393,0.0232558139534884
2014,21137,170,895,37,138,0,0,37,138,0.00822652757078987,0.268115942028986
2014,21139,32,110,0,76,0,12,0,88,0.0129089042100631,0
2014,21141,54,364,50,348,0,0,50,348,0.0191040843214756,0.14367816091954
2014,21143,40,608,8,75,0,27,8,102,0.0152877697841727,0.0784313725490196
2014,21145,180,1056,276,1098,0,65,276,1163,0.025226671294087,0.23731728288908
2014,21147,9,392,2,412,0,55,2,467,0.0368674508565564,0.00428265524625268
2014,21149,24,163,19,49,0,0,19,49,0.00745133819951338,0.387755102040816
2014,21151,354,1547,283,1207,23,87,306,1294,0.0247508655151967,0.236476043276662
2014,21153,17,118,0,28,0,8,0,36,0.00404040404040404,0
2014,21155,39,577,39,53,0,30,39,83,0.00610159523634492,0.469879518072289
2014,21157,203,485,106,336,0,0,106,336,0.0148791072535648,0.31547619047619
2014,21159,0,202,54,304,0,7,54,311,0.0345670779148605,0.173633440514469
2014,21161,110,488,13,278,6,13,19,291,0.0246777476255088,0.0652920962199313
2014,21163,121,921,156,775,18,96,174,871,0.04574099359311,0.199770378874856
2014,21165,1,116,0,58,0,20,0,78,0.0178448867536033,0
2014,21167,123,721,35,141,0,8,35,149,0.0100047001947224,0.23489932885906
2014,21169,31,225,58,149,0,0,58,149,0.0214728347024067,0.389261744966443
2014,21171,45,324,19,65,7,9,26,74,0.00988511888859204,0.351351351351351
2014,21173,65,840,5,308,0,0,5,308,0.0169388989715668,0.0162337662337662
2014,21175,42,750,0,91,0,0,0,91,0.00928381962864721,0
2014,21177,0,831,32,221,0,27,32,248,0.0113579116098008,0.129032258064516
2014,21179,164,1136,36,260,7,27,43,287,0.00977154335909571,0.149825783972125
2014,21181,26,111,11,29,0,4,11,33,0.0067360685854256,0.333333333333333
2014,21183,0,511,0,161,0,1,0,162,0.010028475919277,0
2014,21185,769,2499,378,902,97,121,475,1023,0.0250716859054481,0.464320625610948
2014,21187,0,257,64,87,2,4,66,91,0.0123792681267855,0.725274725274725
2014,21189,3,70,0,0,0,0,0,0,0,NA
2014,21191,55,294,22,94,0,0,22,94,0.00949111470113086,0.234042553191489
2014,21193,83,470,11,143,0,18,11,161,0.00817134446530985,0.0683229813664596
2014,21195,153,909,128,591,0,53,128,644,0.0143557735176103,0.198757763975155
2014,21197,26,179,0,30,0,21,0,51,0.00608446671438797,0
2014,21199,117,894,60,626,0,43,60,669,0.0151200108484383,0.0896860986547085
2014,21201,0,41,10,20,0,0,10,20,0.0129533678756477,0.5
2014,21203,43,377,11,66,0,3,11,69,0.00585887747304067,0.159420289855072
2014,21205,170,727,81,264,0,0,81,264,0.0194060570420465,0.306818181818182
2014,21207,39,220,2,55,0,9,2,64,0.00518176665857016,0.03125
2014,21209,314,1555,222,654,27,133,249,787,0.024863362082583,0.316391359593393
2014,21211,110,1133,140,561,26,26,166,587,0.0200231955246282,0.282793867120954
2014,21213,29,386,118,346,0,0,118,346,0.0292674674335984,0.341040462427746
2014,21215,117,591,46,96,0,0,46,96,0.00816118337158888,0.479166666666667
2014,21217,21,380,13,219,0,51,13,270,0.0165441176470588,0.0481481481481481
2014,21219,18,200,31,163,0,17,31,180,0.0224943764058985,0.172222222222222
2014,21221,29,140,72,180,3,12,75,192,0.0188272210237301,0.390625
2014,21223,3,228,15,71,34,34,49,105,0.017570281124498,0.466666666666667
2014,21225,5,335,18,123,0,0,18,123,0.0127223831195697,0.146341463414634
2014,21227,320,1924,643,2276,148,367,791,2643,0.0370209547288212,0.299281119939463
2014,21229,35,321,20,78,0,13,20,91,0.0114638447971781,0.21978021978022
2014,21231,23,252,0,275,0,0,0,275,0.0188990447391932,0
2014,21233,14,332,4,66,0,0,4,66,0.00717235383612258,0.0606060606060606
2014,21235,83,789,93,406,0,0,93,406,0.0176983435047951,0.229064039408867
2014,21237,19,138,0,17,0,0,0,17,0.00337636544190665,0
2014,21239,153,389,122,216,10,120,132,336,0.0192837465564738,0.392857142857143
2014,22001,131,1271,106,479,15,181,121,660,0.0166809887276955,0.183333333333333
2014,22003,50,642,58,512,0,101,58,613,0.0344440074169804,0.0946166394779772
2014,22005,473,1444,223,1113,45,392,268,1505,0.0211444708262501,0.178073089700997
2014,22007,46,354,34,164,0,0,34,164,0.0106555779351569,0.207317073170732
2014,22009,125,983,41,252,1,1,42,253,0.00903991138742988,0.16600790513834
2014,22011,88,993,87,645,47,120,134,765,0.0321901956658952,0.17516339869281
2014,22013,40,356,27,167,0,0,27,167,0.0173434416865718,0.161676646706587
2014,22015,910,3178,1124,3103,82,316,1206,3419,0.0432790288484664,0.352734717753729
2014,22017,997,4326,928,2478,172,501,1100,2979,0.0177142177558423,0.369251426653239
2014,22019,360,2124,530,2533,177,357,707,2890,0.0228659139640317,0.244636678200692
2014,22021,63,310,3,65,9,25,12,90,0.0130264871906209,0.133333333333333
2014,22023,7,48,14,88,0,0,14,88,0.019421761200618,0.159090909090909
2014,22025,16,432,92,120,0,2,92,122,0.0173123314885767,0.754098360655738
2014,22027,47,508,8,141,0,18,8,159,0.0135158109486569,0.050314465408805
2014,22029,57,554,11,268,0,30,11,298,0.0217375446786782,0.0369127516778524
2014,22031,27,388,12,199,0,37,12,236,0.013061043776634,0.0508474576271186
2014,22033,1894,5981,2431,4830,487,1065,2918,5895,0.0213284803050751,0.494995759117897
2014,22035,13,306,4,133,0,0,4,133,0.0270930943165614,0.0300751879699248
2014,22037,35,922,27,77,0,0,27,77,0.00543363206548585,0.350649350649351
2014,22039,42,773,0,229,0,85,0,314,0.0146530402725279,0
2014,22041,71,757,33,192,0,25,33,217,0.016000589883498,0.152073732718894
2014,22043,17,536,5,588,0,65,5,653,0.0420801649697126,0.00765696784073507
2014,22045,209,1042,93,486,13,164,106,650,0.0137948598230013,0.163076923076923
2014,22047,146,1772,2,274,0,7,2,281,0.012312680746648,0.00711743772241993
2014,22049,56,570,37,328,3,19,40,347,0.0310320157395815,0.115273775216138
2014,22051,1877,7769,1596,4995,522,1350,2118,6345,0.021150211502115,0.333806146572104
2014,22053,103,821,61,289,0,23,61,312,0.0151228733459357,0.195512820512821
2014,22055,1220,4216,920,3552,210,515,1130,4067,0.0277122882568582,0.277846078190312
2014,22057,312,1724,118,445,10,197,128,642,0.0100653779220168,0.199376947040498
2014,22059,31,525,8,251,0,21,8,272,0.0267637508609662,0.0294117647058824
2014,22061,310,826,132,514,45,72,177,586,0.0230354966783286,0.302047781569966
2014,22063,756,2646,52,1213,0,118,52,1331,0.0156129032258065,0.039068369646882
2014,22065,37,642,27,123,0,22,27,145,0.0185090630584631,0.186206896551724
2014,22067,66,303,46,139,0,0,46,139,0.00761518654467759,0.330935251798561
2014,22069,95,763,16,233,3,20,19,253,0.0107490334367167,0.075098814229249
2014,22071,2196,6155,4666,8158,738,1272,5404,9430,0.0376966280905838,0.573064687168611
2014,22073,408,2893,336,1215,24,85,360,1300,0.0132454379655007,0.276923076923077
2014,22075,110,432,78,487,27,50,105,537,0.0353918144071706,0.195530726256983
2014,22077,13,194,18,126,0,20,18,146,0.00940236991241628,0.123287671232877
2014,22079,275,1929,165,746,53,179,218,925,0.0107132102568854,0.235675675675676
2014,22081,9,94,0,7,0,0,0,7,0.00119433543763863,0
2014,22083,116,679,35,110,0,9,35,119,0.00865139949109415,0.294117647058824
2014,22085,30,237,26,121,2,19,28,140,0.00852307317667113,0.2
2014,22087,133,1235,89,418,19,70,108,488,0.0186751368106846,0.221311475409836
2014,22089,247,1295,103,340,29,116,132,456,0.0132700870121933,0.289473684210526
2014,22091,15,258,0,81,0,0,0,81,0.0111478117258464,0
2014,22093,17,293,0,40,0,2,0,42,0.00291767974991316,0
2014,22095,142,1004,18,140,10,10,28,150,0.00522065989141027,0.186666666666667
2014,22097,182,1216,75,460,0,43,75,503,0.00939098614689519,0.149105367793241
2014,22099,82,924,18,228,34,170,52,398,0.0115055504162812,0.130653266331658
2014,22101,92,571,104,487,13,101,117,588,0.016639311789009,0.198979591836735
2014,22103,1418,4492,1876,4420,189,511,2065,4931,0.0305408284610049,0.418779152301764
2014,22105,333,2191,241,1259,40,89,281,1348,0.0172099020771892,0.208456973293769
2014,22107,0,83,0,8,0,0,0,8,0.00233644859813084,0
2014,22109,273,2037,66,1062,15,101,81,1163,0.0160733042180331,0.0696474634565778
2014,22111,29,268,45,93,0,8,45,101,0.00652581249596175,0.445544554455446
2014,22113,216,1253,84,246,16,62,100,308,0.00809695312705381,0.324675324675325
2014,22115,110,498,774,2666,95,467,869,3133,0.0999680918953414,0.277369932971593
2014,22117,69,743,34,592,0,42,34,634,0.0202078153885383,0.0536277602523659
2014,22119,56,699,7,458,22,54,29,512,0.0184232305422619,0.056640625
2014,22121,206,1049,42,294,0,17,42,311,0.0192569659442724,0.135048231511254
2014,22123,1,226,0,80,0,0,0,80,0.0103159252095422,0
2014,22125,219,546,12,102,6,11,18,113,0.00979967045355997,0.15929203539823
2014,22127,10,440,28,272,0,0,28,272,0.0261664261664262,0.102941176470588
2014,23001,356,1881,359,869,31,125,390,994,0.0134668274376448,0.392354124748491
2014,23003,125,446,119,778,14,47,133,825,0.0160777970494806,0.161212121212121
2014,23005,1710,4281,3129,5899,557,1102,3686,7001,0.0347659838609559,0.526496214826453
2014,23007,87,412,137,252,2,12,139,264,0.0123283833006444,0.526515151515151
2014,23009,250,832,224,686,27,180,251,866,0.0212755503144654,0.289838337182448
2014,23011,627,2198,559,1281,147,212,706,1493,0.0172963078812312,0.472873409243135
2014,23013,177,690,273,607,65,74,338,681,0.0229385610347615,0.49632892804699
2014,23015,166,581,241,367,37,63,278,430,0.0165735209096165,0.646511627906977
2014,23017,129,842,211,824,3,9,214,833,0.0200201884253028,0.256902761104442
2014,23019,451,2114,800,1813,144,236,944,2049,0.0194501926983464,0.460712542703758
2014,23021,22,220,39,122,16,32,55,154,0.0117217232455473,0.357142857142857
2014,23023,347,1148,207,488,0,30,207,518,0.020207536865101,0.3996138996139
2014,23025,144,1046,95,558,0,4,95,562,0.0149838696776602,0.169039145907473
2014,23027,233,705,180,454,14,75,194,529,0.0188679245283019,0.366729678638941
2014,23029,53,409,186,378,65,77,251,455,0.0192291437748288,0.551648351648352
2014,23031,542,2660,1707,4167,107,300,1814,4467,0.031356610369372,0.40608909782852
2014,24001,118,845,234,990,57,103,291,1093,0.0212270105455322,0.266239707227813
2014,24003,3596,10212,4433,8905,880,1679,5313,10584,0.028286456495943,0.501984126984127
2014,24005,4355,14434,3531,7902,1782,3176,5313,11078,0.0198180985502268,0.479599205632786
2014,24009,526,1658,545,1206,106,179,651,1385,0.0232032166191992,0.470036101083033
2014,24011,135,910,50,277,0,21,50,298,0.013625348635179,0.167785234899329
2014,24013,1194,2554,433,1172,57,153,490,1325,0.0116903856503825,0.369811320754717
2014,24015,186,1014,603,2013,39,139,642,2152,0.0316582323172885,0.298327137546468
2014,24017,590,2474,784,2367,95,236,879,2603,0.0264073611914255,0.337687283903189
2014,24019,201,679,44,220,9,65,53,285,0.0123088883130345,0.185964912280702
2014,24021,1442,3632,1594,3196,388,849,1982,4045,0.025311307177273,0.489987639060569
2014,24023,38,208,158,544,0,27,158,571,0.0269441298603247,0.276707530647986
2014,24025,1485,4137,1471,2980,206,516,1677,3496,0.0207847800237812,0.479691075514874
2014,24027,3878,6821,3298,4325,788,1378,4086,5703,0.0284131388970541,0.716465018411362
2014,24029,76,203,110,302,8,23,118,325,0.0232375232375232,0.363076923076923
2014,24031,4126,8984,17137,23829,5696,10107,22833,33936,0.049206070720677,0.67282531824611
2014,24033,3558,9430,6854,18025,1654,3908,8508,21933,0.0377758525961533,0.387908630830256
2014,24035,310,1207,224,425,150,264,374,689,0.0204505654329049,0.542815674891147
2014,24037,432,1323,738,2030,241,603,979,2633,0.0374825612846283,0.371819217622484
2014,24039,38,1473,172,331,11,14,183,345,0.0204687036487689,0.530434782608696
2014,24041,145,874,262,648,45,76,307,724,0.025791742367568,0.424033149171271
2014,24043,368,3295,844,2598,53,219,897,2817,0.0274032568727018,0.318423855165069
2014,24045,329,1492,274,1630,190,223,464,1853,0.0295557859478427,0.250404749055586
2014,24047,392,1255,218,830,46,117,264,947,0.0246434891225148,0.278775079197466
2014,24510,4607,12246,5042,7892,1347,2406,6389,10298,0.0246969835049667,0.620411730433094
2014,25001,1275,2856,1199,2599,132,592,1331,3191,0.0194143450776635,0.417110623628956
2014,25003,378,804,596,1715,93,203,689,1918,0.0205527158946004,0.359228362877998
2014,25005,1485,5853,1641,4737,307,926,1948,5663,0.0149673060963426,0.343987285890871
2014,25007,100,159,246,314,5,86,251,400,0.0315606753984535,0.6275
2014,25009,4061,9592,3264,7135,821,2905,4085,10040,0.019393433661515,0.406872509960159
2014,25011,611,1366,519,944,21,235,540,1179,0.022645640858191,0.458015267175573
2014,25013,1204,3931,1027,3768,527,2236,1554,6004,0.0194683493407869,0.258827448367755
2014,25015,1173,2538,1428,1987,535,778,1963,2765,0.0282948393896911,0.70994575045208
2014,25017,15243,25844,16575,22401,8348,12675,24923,35076,0.0327769585718531,0.710542821302315
2014,25019,46,167,116,152,0,0,116,152,0.0201805629314923,0.763157894736842
2014,25021,10034,18344,4641,6806,2500,3893,7141,10699,0.0225449043753846,0.667445555659407
2014,25023,3709,9795,1336,3664,403,1413,1739,5077,0.0148374369839994,0.34252511325586
2014,25025,10227,18209,9684,12574,3921,7041,13605,19615,0.0394247583060318,0.693601835330105
2014,25027,3885,9559,2696,6413,1140,2512,3836,8925,0.0163820383110256,0.429803921568627
2014,26001,42,315,27,142,5,31,32,173,0.0199653779572995,0.184971098265896
2014,26003,70,615,21,155,0,5,21,160,0.0217746325530757,0.13125
2014,26005,513,2918,266,640,13,116,279,756,0.0100786561791761,0.369047619047619
2014,26007,89,459,55,192,9,26,64,218,0.0102941870897672,0.293577981651376
2014,26009,120,579,42,124,0,6,42,130,0.00753885409417768,0.323076923076923
2014,26011,13,340,10,52,3,12,13,64,0.00560273133152412,0.203125
2014,26013,32,318,16,44,0,5,16,49,0.00744907266646397,0.326530612244898
2014,26015,295,1296,156,440,3,41,159,481,0.0118173107633344,0.330561330561331
2014,26017,340,1743,144,625,103,157,247,782,0.010440029904945,0.315856777493606
2014,26019,136,476,82,156,4,4,86,160,0.0123963740605873,0.5375
2014,26021,244,1211,1093,2354,342,423,1435,2777,0.0259821670830176,0.516744688512784
2014,26023,83,928,45,298,0,29,45,327,0.0109130957148578,0.137614678899083
2014,26025,464,2517,372,1271,68,184,440,1455,0.015984092806609,0.302405498281787
2014,26027,79,572,154,656,4,29,158,685,0.0188762434897627,0.230656934306569
2014,26029,179,587,94,261,13,59,107,320,0.017041218447119,0.334375
2014,26031,85,630,87,259,0,12,87,271,0.0141529141424692,0.321033210332103
2014,26033,121,1355,215,451,0,64,215,515,0.0195572095849315,0.41747572815534
2014,26035,97,892,3,130,3,25,6,155,0.00700596637136142,0.0387096774193548
2014,26037,803,2299,169,421,28,66,197,487,0.0096237451584855,0.404517453798768
2014,26039,127,614,3,78,0,5,3,83,0.0080077182826821,0.036144578313253
2014,26041,129,499,72,447,17,48,89,495,0.0185915492957746,0.17979797979798
2014,26043,72,381,115,507,14,61,129,568,0.0300783732260114,0.227112676056338
2014,26045,1046,3866,365,803,100,218,465,1021,0.0137693863789616,0.455435847208619
2014,26047,312,766,142,319,22,50,164,369,0.0158750645327827,0.444444444444444
2014,26049,1335,5872,682,2750,114,393,796,3143,0.011249145487278,0.2532612153993
2014,26051,112,654,20,75,0,30,20,105,0.00556586270871985,0.19047619047619
2014,26053,28,479,64,335,5,5,69,340,0.0279881461969048,0.202941176470588
2014,26055,819,2836,481,1153,99,181,580,1334,0.0212396707373382,0.434782608695652
2014,26057,66,1524,46,168,12,23,58,191,0.0067289061123833,0.303664921465969
2014,26059,58,592,114,370,4,76,118,446,0.0143274759870217,0.26457399103139
2014,26061,100,384,166,392,96,168,262,560,0.0260029717682021,0.467857142857143
2014,26063,129,630,23,79,13,31,36,110,0.0046220429429808,0.327272727272727
2014,26065,2001,6198,1503,2941,1016,1419,2519,4360,0.0259565525411822,0.577752293577982
2014,26067,268,2452,20,279,6,111,26,390,0.00918316889966799,0.0666666666666667
2014,26069,140,915,59,350,14,37,73,387,0.019762038502783,0.188630490956072
2014,26071,20,77,8,147,0,12,8,159,0.0175632387054015,0.050314465408805
2014,26073,401,1620,177,540,115,245,292,785,0.0215884714812167,0.371974522292994
2014,26075,765,4790,351,999,88,258,439,1257,0.011536873020972,0.349244232299125
2014,26077,1858,4791,869,2563,214,486,1083,3049,0.0193832207042549,0.355198425713349
2014,26079,174,666,23,237,8,23,31,260,0.0212609371166898,0.119230769230769
2014,26081,3605,10058,2848,5667,758,1607,3606,7274,0.0184156094695829,0.495738245806984
2014,26083,12,45,29,40,0,0,29,40,0.0234055002925688,0.725
2014,26085,34,449,29,117,0,2,29,119,0.013443289652056,0.243697478991597
2014,26087,370,2365,188,619,10,132,198,751,0.0123788488165095,0.263648468708389
2014,26089,285,699,229,334,2,5,231,339,0.0205741336408327,0.68141592920354
2014,26091,260,1761,331,864,22,194,353,1058,0.0157047856549103,0.333648393194707
2014,26093,1735,4498,419,1119,83,209,502,1328,0.0106273157225054,0.378012048192771
2014,26095,21,407,3,9,0,4,3,13,0.00260939381774388,0.230769230769231
2014,26097,79,241,43,149,5,10,48,159,0.0188724035608309,0.30188679245283
2014,26099,4392,17813,1114,3976,935,2530,2049,6506,0.0110865349551324,0.314940055333538
2014,26101,137,800,121,248,0,17,121,265,0.0145732512098548,0.456603773584906
2014,26103,230,1018,243,788,43,120,286,908,0.0202407489968792,0.314977973568282
2014,26105,194,744,93,314,2,39,95,353,0.0172396952529791,0.269121813031161
2014,26107,206,795,85,193,18,55,103,248,0.00954764196342637,0.415322580645161
2014,26109,17,217,87,397,5,17,92,414,0.0237412547310471,0.222222222222222
2014,26111,275,1702,540,1222,153,203,693,1425,0.0250743432281677,0.486315789473684
2014,26113,69,386,31,118,0,8,31,126,0.0122425184609405,0.246031746031746
2014,26115,435,2323,328,1419,48,161,376,1580,0.0153218064215824,0.237974683544304
2014,26117,266,1903,71,373,6,31,77,404,0.00941132620495259,0.190594059405941
2014,26119,24,381,13,208,0,9,13,217,0.0289797008547009,0.0599078341013825
2014,26121,649,4231,153,1369,73,156,226,1525,0.0133464025975163,0.148196721311475
2014,26123,134,1273,88,405,0,49,88,454,0.0138600561729149,0.193832599118943
2014,26125,10253,27691,6201,10660,4007,6198,10208,16858,0.019920427004716,0.605528532447503
2014,26127,164,681,36,323,8,54,44,377,0.0210614525139665,0.116710875331565
2014,26129,70,628,22,97,3,12,25,109,0.0069329601831828,0.229357798165138
2014,26131,12,55,21,52,0,2,21,54,0.0103033772180882,0.388888888888889
2014,26133,84,624,24,123,7,13,31,136,0.0085427135678392,0.227941176470588
2014,26135,23,240,12,69,0,24,12,93,0.0147665925690695,0.129032258064516
2014,26137,177,670,51,366,9,12,60,378,0.0223325062034739,0.158730158730159
2014,26139,1410,5372,913,1746,251,503,1164,2249,0.0136150376850198,0.517563361493997
2014,26141,49,427,19,86,0,6,19,92,0.00902226144944591,0.206521739130435
2014,26143,59,821,29,241,0,59,29,300,0.0157455518815935,0.0966666666666667
2014,26145,628,3068,303,1314,156,348,459,1662,0.0125769029943926,0.276173285198556
2014,26147,600,3322,232,1094,42,153,274,1247,0.0112021416123179,0.219727345629511
2014,26149,97,690,98,478,8,14,106,492,0.0121256931608133,0.215447154471545
2014,26151,92,853,23,200,6,44,29,244,0.00830383882384971,0.118852459016393
2014,26153,36,166,4,50,0,5,4,55,0.00884955752212389,0.0727272727272727
2014,26155,192,1362,132,578,3,38,135,616,0.0129892037786775,0.219155844155844
2014,26157,77,1169,82,334,31,59,113,393,0.0102941561673259,0.287531806615776
2014,26159,239,1205,114,778,96,136,210,914,0.0179694872601447,0.229759299781182
2014,26161,2886,7276,3701,5339,2220,2823,5921,8162,0.0374601280492003,0.725434942416075
2014,26163,5547,19554,3252,10376,1888,4383,5140,14759,0.0125889753705086,0.348262077376516
2014,26165,134,865,31,166,0,7,31,173,0.00768547312305642,0.179190751445087
2014,27001,78,406,6,72,2,21,8,93,0.00753463501579843,0.0860215053763441
2014,27003,2181,9720,744,2572,235,716,979,3288,0.0146375340563064,0.297749391727494
2014,27005,108,535,130,434,9,67,139,501,0.0221514789759915,0.277445109780439
2014,27007,297,796,76,294,14,33,90,327,0.011992078626962,0.275229357798165
2014,27009,367,1702,14,297,0,19,14,316,0.0122594661700807,0.0443037974683544
2014,27011,45,83,2,20,2,4,4,24,0.00631080725742835,0.166666666666667
2014,27013,336,1058,161,409,50,71,211,480,0.01265622528081,0.439583333333333
2014,27015,134,361,47,102,0,17,47,119,0.00680349894231319,0.394957983193277
2014,27017,206,779,78,251,3,14,81,265,0.0108353436643906,0.305660377358491
2014,27019,1496,3474,481,887,82,201,563,1088,0.0180443147140772,0.517463235294118
2014,27021,131,630,67,177,6,23,73,200,0.009706853038245,0.365
2014,27023,34,378,8,88,2,5,10,93,0.0109052532833021,0.10752688172043
2014,27025,425,2169,90,296,11,71,101,367,0.0100771575276641,0.275204359673025
2014,27027,94,561,448,1136,13,92,461,1228,0.0340109677061984,0.375407166123779
2014,27029,34,164,8,38,2,3,10,41,0.00685045948203843,0.24390243902439
2014,27031,24,89,30,59,13,54,43,113,0.0275341130604288,0.380530973451327
2014,27033,40,321,15,54,0,1,15,55,0.00685187492213779,0.272727272727273
2014,27035,282,1334,122,571,16,87,138,658,0.0149172523237361,0.209726443768997
2014,27037,3700,10015,1884,3697,540,1505,2424,5202,0.0192635987601974,0.465974625144175
2014,27039,121,554,34,88,0,15,34,103,0.0078890931372549,0.330097087378641
2014,27041,207,780,63,190,0,41,63,231,0.00895834949197239,0.272727272727273
2014,27043,38,281,41,94,0,4,41,98,0.00950810129038518,0.418367346938776
2014,27045,64,345,49,171,3,23,52,194,0.013465676407302,0.268041237113402
2014,27047,73,417,47,176,3,26,50,202,0.00920524972657674,0.247524752475248
2014,27049,263,950,166,523,38,72,204,595,0.0184622067767159,0.342857142857143
2014,27051,17,103,12,30,0,0,12,30,0.00695410292072323,0.4
2014,27053,10741,22919,9483,17190,3415,5816,12898,23006,0.0284654093186292,0.560636355733287
2014,27055,26,133,93,347,4,7,97,354,0.0264554218668261,0.274011299435028
2014,27057,137,542,49,211,1,5,50,216,0.0144665461121157,0.231481481481481
2014,27059,222,1177,35,202,0,36,35,238,0.00928780487804878,0.147058823529412
2014,27061,269,852,108,541,15,67,123,608,0.018759642085776,0.202302631578947
2014,27063,44,203,13,83,0,10,13,93,0.0128666297731046,0.139784946236559
2014,27065,100,546,48,155,4,17,52,172,0.0152171989737238,0.302325581395349
2014,27067,115,599,109,322,24,37,133,359,0.0126626926739798,0.370473537604457
2014,27069,8,50,12,24,2,2,14,26,0.0080395794681509,0.538461538461538
2014,27071,30,193,67,122,0,14,67,136,0.0141093474426808,0.492647058823529
2014,27073,30,90,10,26,1,5,11,31,0.00594667178208325,0.354838709677419
2014,27075,35,253,39,138,26,28,65,166,0.0203631010794897,0.391566265060241
2014,27077,12,110,0,24,0,0,0,24,0.00825309491059147,0
2014,27079,125,630,62,230,2,8,64,238,0.0126086035176944,0.26890756302521
2014,27081,21,115,29,47,0,0,29,47,0.011244019138756,0.617021276595745
2014,27083,132,441,116,205,19,24,135,229,0.0141122819991372,0.589519650655022
2014,27085,209,759,11,32,8,22,19,54,0.00219378427787934,0.351851851851852
2014,27087,16,107,11,34,0,0,11,34,0.0100058858151854,0.323529411764706
2014,27089,15,133,15,91,0,10,15,101,0.0151902541735599,0.148514851485149
2014,27091,66,198,45,147,3,41,48,188,0.012818764489295,0.25531914893617
2014,27093,111,613,23,92,4,19,27,111,0.00702487184355421,0.243243243243243
2014,27095,138,991,48,175,3,21,51,196,0.0111325684425764,0.260204081632653
2014,27097,140,851,19,96,29,61,48,157,0.0069239250275634,0.305732484076433
2014,27099,128,631,93,444,35,102,128,546,0.0209315698677401,0.234432234432234
2014,27101,36,154,16,46,2,12,18,58,0.00934428870629934,0.310344827586207
2014,27103,273,1076,90,282,34,49,124,331,0.0157065578437886,0.374622356495468
2014,27105,54,218,81,223,13,117,94,340,0.024388494369127,0.276470588235294
2014,27107,26,99,1,60,0,7,1,67,0.0141529362061681,0.0149253731343284
2014,27109,662,2089,1348,2301,294,488,1642,2789,0.028031559374843,0.588741484403012
2014,27111,244,980,147,542,14,106,161,648,0.0157357940747936,0.248456790123457
2014,27113,44,304,38,222,0,6,38,228,0.0240126382306477,0.166666666666667
2014,27115,146,909,26,244,0,36,26,280,0.0132858837485172,0.0928571428571429
2014,27117,92,201,10,155,0,18,10,173,0.0268675260133561,0.0578034682080925
2014,27119,130,567,61,668,33,45,94,713,0.0338524356661286,0.131837307152875
2014,27121,36,338,19,100,1,15,20,115,0.0145110410094637,0.173913043478261
2014,27123,5987,15246,3445,6245,1249,2702,4694,8947,0.0262735182786984,0.52464513244663
2014,27125,29,77,0,23,0,4,0,27,0.00954063604240283,0
2014,27127,63,309,11,110,21,36,32,146,0.0134587020648968,0.219178082191781
2014,27129,50,383,33,105,0,8,33,113,0.0104804303468744,0.292035398230089
2014,27131,301,2408,242,559,0,69,242,628,0.0155916381151001,0.385350318471338
2014,27133,32,98,42,210,9,9,51,219,0.0333739713501981,0.232876712328767
2014,27135,77,281,8,83,0,14,8,97,0.00922754946727549,0.0824742268041237
2014,27137,766,2523,690,1721,125,240,815,1961,0.0144190116249145,0.415604283528812
2014,27139,1333,4293,337,910,42,251,379,1161,0.0135076962455352,0.326442721791559
2014,27141,824,3731,192,721,81,192,273,913,0.0160304807388419,0.299014238773275
2014,27143,27,223,10,136,2,40,12,176,0.0171456405260594,0.0681818181818182
2014,27145,670,3112,386,1083,124,376,510,1459,0.0156728362569958,0.349554489376285
2014,27147,75,617,145,415,36,43,181,458,0.0188098073842868,0.395196506550218
2014,27149,20,164,2,88,13,39,15,127,0.0222027972027972,0.118110236220472
2014,27151,31,172,52,82,0,11,52,93,0.0136044470450556,0.559139784946237
2014,27153,112,521,37,112,4,19,41,131,0.00784290247260971,0.312977099236641
2014,27155,5,39,2,37,2,10,4,47,0.0186286167261197,0.0851063829787234
2014,27157,102,506,52,86,16,43,68,129,0.00853343917443937,0.527131782945736
2014,27159,37,402,19,88,0,33,19,121,0.0128096548803726,0.15702479338843
2014,27161,123,357,25,217,10,26,35,243,0.0183175033921303,0.1440329218107
2014,27163,3005,7216,1472,2656,183,392,1655,3048,0.0187410076365917,0.542979002624672
2014,27165,72,203,12,45,0,4,12,49,0.00649350649350649,0.244897959183673
2014,27167,50,115,35,157,9,12,44,169,0.0368834570056744,0.260355029585799
2014,27169,102,300,193,506,23,51,216,557,0.0179897939409599,0.387791741472172
2014,27171,958,3425,228,663,31,134,259,797,0.00980645478818304,0.324968632371393
2014,27173,39,226,32,81,10,24,42,105,0.014792899408284,0.4
2014,28001,66,111,52,603,21,63,73,666,0.0295265117928711,0.10960960960961
2014,28003,127,767,128,671,0,0,128,671,0.0266767383612293,0.190760059612519
2014,28005,17,116,3,80,0,0,3,80,0.00872885979268958,0.0375
2014,28007,78,398,24,469,0,9,24,478,0.0374666875685844,0.0502092050209205
2014,28009,3,112,78,243,0,3,78,246,0.0424870466321244,0.317073170731707
2014,28011,64,558,89,324,0,11,89,335,0.0157513635508746,0.265671641791045
2014,28013,18,414,15,70,9,30,24,100,0.0100441944556047,0.24
2014,28015,11,267,0,76,16,16,16,92,0.012216173150976,0.173913043478261
2014,28017,0,397,19,141,0,13,19,154,0.0136549033516581,0.123376623376623
2014,28019,7,227,8,163,0,0,8,163,0.0282789729354615,0.049079754601227
2014,28021,2,71,0,4,0,8,0,12,0.00222057735011103,0
2014,28023,28,146,49,97,5,16,54,113,0.0100310696848646,0.47787610619469
2014,28025,22,200,30,75,0,15,30,90,0.00672294016583252,0.333333333333333
2014,28027,32,299,35,296,0,3,35,299,0.0193841166936791,0.117056856187291
2014,28029,60,280,28,99,0,0,28,99,0.00527268853855986,0.282828282828283
2014,28031,139,595,17,43,0,69,17,112,0.00875341930441579,0.151785714285714
2014,28033,254,2334,1257,4471,29,289,1286,4760,0.0445546871343661,0.270168067226891
2014,28035,505,2287,279,1019,46,222,325,1241,0.0271702244116037,0.261885576148268
2014,28037,15,42,0,10,0,28,0,38,0.00697119794533113,0
2014,28039,69,664,6,206,0,126,6,332,0.0224856078564172,0.0180722891566265
2014,28041,27,1577,10,141,0,15,10,156,0.0156626506024096,0.0641025641025641
2014,28043,94,329,0,107,0,50,0,157,0.0110268296109004,0
2014,28045,410,1312,124,1138,0,5,124,1143,0.0366017676444217,0.108486439195101
2014,28047,643,3120,1514,5740,131,595,1645,6335,0.0503409036728596,0.259668508287293
2014,28049,1225,4263,522,1514,69,268,591,1782,0.0116111628755547,0.331649831649832
2014,28051,24,122,41,133,0,30,41,163,0.0143258920724205,0.251533742331288
2014,28053,13,63,8,22,0,0,8,22,0.00385829533497019,0.363636363636364
2014,28055,4,118,0,32,0,0,0,32,0.0335781741867786,0
2014,28057,91,472,38,284,0,20,38,304,0.0195109428149669,0.125
2014,28059,546,2145,600,2343,56,238,656,2581,0.0277464228507541,0.254165052305308
2014,28061,51,185,6,77,0,3,6,80,0.00707151065146292,0.075
2014,28063,0,164,0,43,0,0,0,43,0.00864147909967846,0
2014,28065,17,262,26,62,0,0,26,62,0.00743761996161228,0.419354838709677
2014,28067,128,775,185,562,0,30,185,592,0.0133399432151066,0.3125
2014,28069,0,324,0,99,0,0,0,99,0.0143623966342666,0
2014,28071,140,583,462,1105,116,123,578,1228,0.0449619214997071,0.470684039087948
2014,28073,842,2694,316,1047,0,62,316,1109,0.0300338524035207,0.284941388638413
2014,28075,279,1656,422,1320,0,8,422,1328,0.0252846426259472,0.317771084337349
2014,28077,41,103,23,154,0,7,23,161,0.0190758293838863,0.142857142857143
2014,28079,40,364,51,148,8,34,59,182,0.0126829268292683,0.324175824175824
2014,28081,429,1942,234,763,88,148,322,911,0.0165197838465165,0.353457738748628
2014,28083,28,364,11,199,24,78,35,277,0.0142857142857143,0.126353790613718
2014,28085,64,259,72,168,0,9,72,177,0.00776486071506909,0.406779661016949
2014,28087,97,925,278,885,59,142,337,1027,0.0265662993429562,0.328140214216164
2014,28089,1500,2698,744,1087,114,206,858,1293,0.0200951137635211,0.663573085846868
2014,28091,93,465,21,309,15,70,36,379,0.0215573630623969,0.0949868073878628
2014,28093,17,522,20,232,0,12,20,244,0.00990621574438715,0.0819672131147541
2014,28095,69,579,46,165,0,23,46,188,0.00762213663085344,0.24468085106383
2014,28097,13,120,0,9,0,54,0,63,0.00908828620888632,0
2014,28099,178,660,0,114,0,5,0,119,0.00642305823932639,0
2014,28101,103,504,0,136,0,0,0,136,0.00968798974212851,0
2014,28103,25,99,8,42,0,0,8,42,0.00578114246386786,0.19047619047619
2014,28105,308,755,264,694,56,130,320,824,0.0333724839010166,0.388349514563107
2014,28107,52,246,22,211,0,17,22,228,0.0103401360544218,0.0964912280701754
2014,28109,75,478,172,1134,15,34,187,1168,0.0316814495348143,0.160102739726027
2014,28111,17,220,19,191,0,20,19,211,0.0257254328212631,0.0900473933649289
2014,28113,160,575,63,462,24,58,87,520,0.0202484326934309,0.167307692307692
2014,28115,13,695,25,282,0,0,25,282,0.0143526058631922,0.0886524822695035
2014,28117,82,603,77,137,24,24,101,161,0.00971635485817743,0.627329192546584
2014,28119,19,168,0,92,0,5,0,97,0.0189194460698264,0
2014,28121,1232,4983,667,1829,34,186,701,2015,0.0205740307742574,0.347890818858561
2014,28123,52,778,78,168,12,39,90,207,0.0113642602250892,0.434782608695652
2014,28125,34,86,0,22,0,0,0,22,0.00683442062752408,0
2014,28127,67,450,24,192,0,3,24,195,0.0108981165819035,0.123076923076923
2014,28129,8,176,5,21,0,11,5,32,0.00297425411283577,0.15625
2014,28131,23,626,48,153,0,0,48,153,0.0130646400819742,0.313725490196078
2014,28133,35,1424,52,254,8,10,60,264,0.0145214521452145,0.227272727272727
2014,28135,14,143,4,687,0,11,4,698,0.0670380330388014,0.00573065902578797
2014,28137,114,477,15,238,0,0,15,238,0.0130704596628041,0.0630252100840336
2014,28139,4,317,14,170,0,0,14,170,0.0117071827009159,0.0823529411764706
2014,28141,18,392,27,141,0,66,27,207,0.0151848591549296,0.130434782608696
2014,28143,119,405,20,139,0,37,20,176,0.0275516593613024,0.113636363636364
2014,28145,61,496,22,148,0,0,22,148,0.0081439498156606,0.148648648648649
2014,28147,7,119,23,62,0,0,23,62,0.00619071392910634,0.370967741935484
2014,28149,56,375,106,387,28,100,134,487,0.0152745977480162,0.275154004106776
2014,28151,126,576,116,524,0,68,116,592,0.0187733874548107,0.195945945945946
2014,28153,34,136,29,147,0,0,29,147,0.0109147609147609,0.197278911564626
2014,28155,87,261,22,102,0,0,22,102,0.0150531286894923,0.215686274509804
2014,28157,0,361,0,54,0,5,0,59,0.00917859365276913,0
2014,28159,114,475,27,153,0,7,27,160,0.0125944584382872,0.16875
2014,28161,5,249,18,46,0,31,18,77,0.00922376617153809,0.233766233766234
2014,28163,42,300,44,649,20,101,64,750,0.0404138376980278,0.0853333333333333
2014,29001,72,340,169,429,7,19,176,448,0.0321146953405018,0.392857142857143
2014,29003,87,339,25,163,8,23,33,186,0.0155064610254273,0.17741935483871
2014,29005,12,61,8,110,0,0,8,110,0.0275068767191798,0.0727272727272727
2014,29007,82,1283,42,284,0,9,42,293,0.0168584579976985,0.143344709897611
2014,29009,86,699,99,580,3,96,102,676,0.0275020341741253,0.150887573964497
2014,29011,43,182,20,170,1,6,21,176,0.0212688821752266,0.119318181818182
2014,29013,28,263,22,153,0,13,22,166,0.0144586708474872,0.132530120481928
2014,29015,64,483,46,405,0,0,46,405,0.0278868002478827,0.11358024691358
2014,29017,36,311,0,20,0,11,0,31,0.00363721694239118,0
2014,29019,916,2797,1393,2478,491,640,1884,3118,0.031883672655507,0.604233483001924
2014,29021,305,2659,444,1893,34,144,478,2037,0.0344151784960043,0.2346588119784
2014,29023,168,522,119,658,0,34,119,692,0.023563061836012,0.171965317919075
2014,29025,32,314,0,64,0,0,0,64,0.0101845957988542,0
2014,29027,173,1961,102,594,54,97,156,691,0.0233422288281593,0.22575976845152
2014,29029,315,1184,144,844,12,52,156,896,0.0273880482958887,0.174107142857143
2014,29031,363,1698,338,737,29,132,367,869,0.0176536312849162,0.422324510932106
2014,29033,19,152,0,36,0,2,0,38,0.00605288308378464,0
2014,29035,14,132,85,109,0,0,85,109,0.0257927117841931,0.779816513761468
2014,29037,342,1907,328,1309,26,120,354,1429,0.0214249302827671,0.247725682295311
2014,29039,16,269,14,137,0,2,14,139,0.0142798438463119,0.100719424460432
2014,29041,34,206,4,9,0,4,4,13,0.00236535662299854,0.307692307692308
2014,29043,788,3070,249,1293,16,99,265,1392,0.0265102460577436,0.190373563218391
2014,29045,13,112,8,62,0,17,8,79,0.0163527220037259,0.10126582278481
2014,29047,1274,6062,1392,3884,114,336,1506,4220,0.0278443094017432,0.356872037914692
2014,29049,140,650,81,271,0,6,81,277,0.0196886772336342,0.292418772563177
2014,29051,606,3095,317,651,6,55,323,706,0.0136472589499729,0.457507082152975
2014,29053,40,877,36,213,0,8,36,221,0.0185948674800168,0.16289592760181
2014,29055,161,953,7,78,0,0,7,78,0.00462304409672831,0.0897435897435897
2014,29057,35,257,9,44,3,3,12,47,0.00849141824751581,0.25531914893617
2014,29059,70,372,38,277,7,21,45,298,0.0260626202553787,0.151006711409396
2014,29061,15,204,3,100,0,13,3,113,0.0204266088214027,0.0265486725663717
2014,29063,44,1195,35,148,0,1,35,149,0.0156611309648938,0.23489932885906
2014,29065,82,497,10,130,0,0,10,130,0.0119562218339005,0.0769230769230769
2014,29067,63,349,0,190,23,60,23,250,0.0258451359454151,0.092
2014,29069,26,651,42,577,0,18,42,595,0.0284757118927973,0.0705882352941176
2014,29071,218,1684,183,604,9,87,192,691,0.010056467574805,0.277858176555716
2014,29073,27,348,55,119,0,0,55,119,0.0111256544502618,0.46218487394958
2014,29075,50,168,16,85,3,7,19,92,0.0200261210274271,0.206521739130435
2014,29077,1423,5468,1186,4522,291,524,1477,5046,0.0276784342980012,0.292707094728498
2014,29079,79,397,1,71,0,44,1,115,0.0166329187156494,0.00869565217391304
2014,29081,17,142,9,155,0,6,9,161,0.0265326301911668,0.0559006211180124
2014,29083,50,546,28,192,12,12,40,204,0.0130651978993211,0.196078431372549
2014,29085,7,326,5,89,0,3,5,92,0.0126373626373626,0.0543478260869565
2014,29087,8,79,27,63,0,12,27,75,0.0217013888888889,0.36
2014,29089,91,277,54,78,0,3,54,81,0.0123343992690726,0.666666666666667
2014,29091,50,703,115,453,16,32,131,485,0.0178545133264615,0.270103092783505
2014,29093,28,338,2,52,0,3,2,55,0.00750136388434261,0.0363636363636364
2014,29095,2106,8159,4610,11780,568,1346,5178,13126,0.028999211281546,0.39448422977297
2014,29097,195,1641,535,2050,33,62,568,2112,0.0280206439971873,0.268939393939394
2014,29099,1243,4509,337,1338,15,127,352,1465,0.0098737640945455,0.240273037542662
2014,29101,162,1246,216,798,98,398,314,1196,0.0388652390082215,0.262541806020067
2014,29103,30,92,13,71,0,0,13,71,0.0253480899678686,0.183098591549296
2014,29105,255,948,145,578,55,55,200,633,0.0263837945981994,0.315955766192733
2014,29107,151,1160,122,275,19,30,141,305,0.0135248991175558,0.462295081967213
2014,29109,176,1154,53,413,0,23,53,436,0.017104746959592,0.121559633027523
2014,29111,34,138,0,155,0,0,0,155,0.0233117762069484,0
2014,29113,216,1164,57,181,0,12,57,193,0.00558384446244648,0.295336787564767
2014,29115,46,249,0,36,0,0,0,36,0.00420168067226891,0
2014,29117,50,538,25,136,0,6,25,142,0.0132909022837888,0.176056338028169
2014,29119,50,391,27,656,24,31,51,687,0.046403242147923,0.074235807860262
2014,29121,23,271,2,64,13,35,15,99,0.00927053094859069,0.151515151515152
2014,29123,51,247,0,87,0,1,0,88,0.0103565964458044,0
2014,29125,26,595,10,73,2,2,12,75,0.0118203309692671,0.16
2014,29127,105,484,44,290,17,39,61,329,0.0169955573922926,0.185410334346505
2014,29129,22,96,2,15,0,0,2,15,0.00579822187862389,0.133333333333333
2014,29131,100,499,59,159,0,0,59,159,0.00930858849013524,0.371069182389937
2014,29133,30,630,43,389,0,20,43,409,0.0413507228793853,0.105134474327628
2014,29135,80,883,23,203,0,2,23,205,0.0195386961494472,0.11219512195122
2014,29137,111,361,43,123,0,12,43,135,0.0221057802521696,0.318518518518519
2014,29139,64,475,6,124,0,5,6,129,0.0153133903133903,0.0465116279069767
2014,29141,51,629,36,178,20,29,56,207,0.0142493288359606,0.270531400966184
2014,29143,30,408,0,150,0,0,0,150,0.0118138142868394,0
2014,29145,393,1711,161,705,14,40,175,745,0.0191871845060266,0.23489932885906
2014,29147,60,758,79,254,31,45,110,299,0.0236363636363636,0.367892976588629
2014,29149,18,250,15,264,0,3,15,267,0.0347746809064861,0.0561797752808989
2014,29151,45,222,0,67,0,0,0,67,0.00730643402399128,0
2014,29153,35,178,9,202,0,0,9,202,0.028071150639244,0.0445544554455446
2014,29155,61,282,107,321,0,36,107,357,0.031151832460733,0.299719887955182
2014,29157,83,495,33,319,0,0,33,319,0.0247690038046432,0.103448275862069
2014,29159,206,966,113,475,8,67,121,542,0.0195456184637577,0.223247232472325
2014,29161,313,1050,385,601,176,291,561,892,0.0323963100167066,0.628923766816143
2014,29163,60,984,11,148,0,0,11,148,0.0115471639229149,0.0743243243243243
2014,29165,1025,3394,908,2584,189,280,1097,2864,0.0458702371990967,0.383030726256983
2014,29167,59,788,77,329,3,21,80,350,0.0176251384832309,0.228571428571429
2014,29169,396,1311,1326,3964,468,1532,1794,5496,0.192997857920427,0.326419213973799
2014,29171,20,85,6,29,0,0,6,29,0.00833572865766025,0.206896551724138
2014,29173,38,298,50,92,8,8,58,100,0.0137892995035852,0.58
2014,29175,74,1437,20,323,25,35,45,358,0.0208977876364485,0.125698324022346
2014,29177,66,572,4,59,0,0,4,59,0.00372592358699084,0.0677966101694915
2014,29179,0,113,7,55,0,0,7,55,0.0115014638226683,0.127272727272727
2014,29181,15,178,40,165,0,3,40,168,0.0173985086992543,0.238095238095238
2014,29183,2358,7171,1492,3080,447,661,1939,3741,0.0152439397088126,0.518310612135793
2014,29185,27,359,13,224,3,12,16,236,0.0331926863572433,0.0677966101694915
2014,29186,56,424,0,42,7,7,7,49,0.0039385901454867,0.142857142857143
2014,29187,280,3150,149,806,0,141,149,947,0.0206999060088745,0.157338965153115
2014,29189,5278,16835,7404,12481,1570,2767,8974,15248,0.0222909637391747,0.588536201469045
2014,29195,113,465,23,185,10,20,33,205,0.0134373361300472,0.160975609756098
2014,29197,8,96,1,26,0,0,1,26,0.00891938250428817,0.0384615384615385
2014,29199,23,96,0,140,0,0,0,140,0.045016077170418,0
2014,29201,118,683,37,336,45,45,82,381,0.0144894466628637,0.215223097112861
2014,29203,5,109,3,48,0,0,3,48,0.00833188682520396,0.0625
2014,29205,7,100,1,38,2,4,3,42,0.00974477958236659,0.0714285714285714
2014,29207,48,584,32,306,0,23,32,329,0.0158310076027331,0.0972644376899696
2014,29209,182,962,89,695,0,34,89,729,0.0304523998496178,0.122085048010974
2014,29211,6,164,24,136,0,0,24,136,0.0300951537950874,0.176470588235294
2014,29213,171,1278,305,1984,31,83,336,2067,0.0570096808892076,0.16255442670537
2014,29215,35,649,52,480,0,42,52,522,0.0293968575772935,0.0996168582375479
2014,29217,50,321,47,285,3,22,50,307,0.0220276960608452,0.162866449511401
2014,29219,48,830,43,315,5,46,48,361,0.0160601476999733,0.132963988919668
2014,29221,51,756,42,107,0,4,42,111,0.00646401118099231,0.378378378378378
2014,29223,0,255,33,123,7,7,40,130,0.0134798838656159,0.307692307692308
2014,29225,188,1499,53,384,0,1,53,385,0.0162983659300652,0.137662337662338
2014,29227,0,6,10,18,0,0,10,18,0.0121130551816958,0.555555555555556
2014,29229,106,421,3,249,0,0,3,249,0.0200644641418211,0.0120481927710843
2014,29510,3440,10225,3459,6207,699,1157,4158,7364,0.0339656929896175,0.564638783269962
2014,30001,27,192,34,224,0,9,34,233,0.0367507886435331,0.145922746781116
2014,30003,13,50,34,104,5,14,39,118,0.0160522377907768,0.330508474576271
2014,30005,23,143,0,53,0,23,0,76,0.0189337319382162,0
2014,30007,81,174,41,199,0,5,41,204,0.0495265841223598,0.200980392156863
2014,30009,18,97,137,288,4,4,141,292,0.0379565839074483,0.482876712328767
2014,30011,0,12,0,1,2,2,2,3,0.00337837837837838,0.666666666666667
2014,30013,261,1204,646,2023,51,235,697,2258,0.0409651669085631,0.308680248007086
2014,30015,10,66,26,52,0,2,26,54,0.0139679255043973,0.481481481481481
2014,30017,31,256,91,321,0,3,91,324,0.0394160583941606,0.280864197530864
2014,30019,0,2,35,39,0,0,35,39,0.0284463894967177,0.897435897435897
2014,30021,44,195,21,196,0,17,21,213,0.033115671641791,0.0985915492957746
2014,30023,80,260,40,116,7,7,47,123,0.0181308962264151,0.382113821138211
2014,30025,3,57,23,64,0,0,23,64,0.0307988450433109,0.359375
2014,30027,93,379,38,121,0,2,38,123,0.0143223102002795,0.308943089430894
2014,30029,179,527,684,2204,59,104,743,2308,0.0360242242617219,0.321923743500867
2014,30031,447,1410,1367,2509,124,145,1491,2654,0.0451798512163151,0.561793519216277
2014,30033,6,6,6,6,0,0,6,6,0.00764331210191083,1
2014,30035,38,217,73,179,0,0,73,179,0.0227619532044761,0.407821229050279
2014,30037,4,27,1,1,0,2,1,3,0.00532859680284192,0.333333333333333
2014,30039,27,132,49,84,0,0,49,84,0.0348114380439287,0.583333333333333
2014,30041,67,206,14,134,19,19,33,153,0.0148818208345492,0.215686274509804
2014,30043,112,489,61,210,0,0,61,210,0.025426807119506,0.29047619047619
2014,30045,12,64,10,33,0,1,10,34,0.0224570673712021,0.294117647058824
2014,30047,128,613,157,445,11,59,168,504,0.025795884942164,0.333333333333333
2014,30049,333,1027,556,1000,52,121,608,1121,0.0250156208158529,0.542372881355932
2014,30051,0,26,13,21,18,21,31,42,0.0260869565217391,0.738095238095238
2014,30053,87,271,63,440,0,0,63,440,0.0300423323774409,0.143181818181818
2014,30055,11,22,5,20,0,0,5,20,0.014903129657228,0.25
2014,30057,75,143,64,164,0,0,64,164,0.0277871907827855,0.390243902439024
2014,30059,12,63,7,30,0,0,7,30,0.0203252032520325,0.233333333333333
2014,30061,0,112,15,53,0,0,15,53,0.0167403663929248,0.283018867924528
2014,30063,837,2173,897,2133,182,388,1079,2521,0.0349832785201837,0.428004760015867
2014,30065,0,117,4,40,0,0,4,40,0.0116652085156022,0.1
2014,30067,29,87,17,226,5,5,22,231,0.0197402153478038,0.0952380952380952
2014,30069,6,23,0,9,0,0,0,9,0.0238726790450928,0
2014,30071,5,48,4,12,0,18,4,30,0.0100435219283562,0.133333333333333
2014,30073,14,141,15,66,5,14,20,80,0.0192539109506619,0.25
2014,30075,2,55,11,22,0,0,11,22,0.0171740827478532,0.5
2014,30077,101,642,16,109,0,0,16,109,0.0202979515828678,0.146788990825688
2014,30079,14,33,0,0,0,0,0,0,0,NA
2014,30081,246,1098,186,947,11,96,197,1043,0.035290137032651,0.188878235858102
2014,30083,73,231,93,477,0,0,93,477,0.0648450244698206,0.19496855345912
2014,30085,10,45,33,112,0,0,33,112,0.0177749563561339,0.294642857142857
2014,30087,71,223,38,75,0,7,38,82,0.0139979515192899,0.463414634146341
2014,30089,3,75,47,165,0,0,47,165,0.0194003527336861,0.284848484848485
2014,30091,4,19,12,64,0,17,12,81,0.0315052508751459,0.148148148148148
2014,30093,191,919,172,559,47,82,219,641,0.0275284517929998,0.341653666146646
2014,30095,36,213,41,126,0,4,41,130,0.0193654103977357,0.315384615384615
2014,30097,8,43,3,30,0,0,3,30,0.0118717847249703,0.1
2014,30099,22,162,13,44,0,1,13,45,0.0106282475200756,0.288888888888889
2014,30101,2,388,96,151,0,0,96,151,0.040943600867679,0.635761589403974
2014,30103,0,0,13,15,0,0,13,15,0.0256849315068493,0.866666666666667
2014,30105,33,76,1,55,0,0,1,55,0.0103189493433396,0.0181818181818182
2014,30107,0,30,1,21,0,0,1,21,0.013401403956605,0.0476190476190476
2014,30109,0,2,3,10,0,0,3,10,0.0138504155124654,0.3
2014,30111,366,2625,888,2734,99,220,987,2954,0.0286776626831186,0.334123222748815
2014,31001,103,603,77,324,0,31,77,355,0.0175829618623081,0.216901408450704
2014,31003,65,141,4,45,0,2,4,47,0.0102262837249782,0.0851063829787234
2014,31005,7,17,0,0,0,0,0,0,0,NA
2014,31007,0,24,6,32,0,0,6,32,0.0551724137931034,0.1875
2014,31009,5,17,3,5,0,0,3,5,0.0126582278481013,0.6
2014,31011,13,65,11,19,0,7,11,26,0.00690938081318097,0.423076923076923
2014,31013,7,118,19,159,0,0,19,159,0.0214952007570637,0.119496855345912
2014,31015,10,21,2,10,0,2,2,12,0.00811359026369168,0.166666666666667
2014,31017,8,38,0,9,0,0,0,9,0.0039647577092511,0
2014,31019,321,1094,257,552,0,43,257,595,0.0208311451878304,0.431932773109244
2014,31021,30,123,22,69,0,0,22,69,0.0142297380903279,0.318840579710145
2014,31023,11,212,22,53,5,9,27,62,0.0107433720325767,0.435483870967742
2014,31025,211,654,56,182,0,31,56,213,0.0123385274865319,0.262910798122066
2014,31027,30,176,5,92,3,3,8,95,0.0159503022162525,0.0842105263157895
2014,31029,10,63,23,61,0,29,23,90,0.0320398718405126,0.255555555555556
2014,31031,24,42,33,129,0,13,33,142,0.0340854536725876,0.232394366197183
2014,31033,5,97,85,259,19,60,104,319,0.0459124928036845,0.326018808777429
2014,31035,19,133,15,56,0,2,15,58,0.0131251414347137,0.258620689655172
2014,31037,25,181,31,199,5,23,36,222,0.0338053905893102,0.162162162162162
2014,31039,22,139,0,72,0,7,0,79,0.0128937489799249,0
2014,31041,25,142,17,101,0,3,17,104,0.0137348124669836,0.163461538461538
2014,31043,5,58,69,471,0,52,69,523,0.041412621743606,0.131931166347992
2014,31045,20,99,145,313,0,0,145,313,0.0557832828372839,0.463258785942492
2014,31047,72,484,36,303,6,26,42,329,0.0214025500910747,0.127659574468085
2014,31049,5,13,14,37,0,7,14,44,0.0322817314746882,0.318181818181818
2014,31051,8,92,25,66,0,3,25,69,0.0171812749003984,0.36231884057971
2014,31053,136,808,59,295,10,41,69,336,0.0134464542980631,0.205357142857143
2014,31055,2260,6556,3500,7795,992,1875,4492,9670,0.0283017487378357,0.464529472595657
2014,31057,9,25,0,33,2,2,2,35,0.0244242847173761,0.0571428571428571
2014,31059,30,134,11,29,4,11,15,40,0.00972762645914397,0.375
2014,31061,22,64,4,47,0,0,4,47,0.0202586206896552,0.0851063829787234
2014,31063,14,51,15,23,0,4,15,27,0.0157802454704851,0.555555555555556
2014,31065,32,134,14,41,0,5,14,46,0.0132221902845645,0.304347826086957
2014,31067,165,462,91,285,0,13,91,298,0.0193280581138929,0.305369127516779
2014,31069,11,40,7,54,0,5,7,59,0.0388157894736842,0.11864406779661
2014,31071,2,36,0,0,0,0,0,0,0,NA
2014,31073,3,68,0,10,0,0,0,10,0.00743494423791822,0
2014,31075,2,8,0,1,0,0,0,1,0.00221729490022173,0
2014,31077,16,72,4,17,0,0,4,17,0.00968109339407745,0.235294117647059
2014,31079,194,795,77,960,22,66,99,1026,0.0265150536244993,0.0964912280701754
2014,31081,11,133,53,64,4,5,57,69,0.0111218568665377,0.826086956521739
2014,31083,7,93,15,50,0,0,15,50,0.0195160031225605,0.3
2014,31085,2,24,0,16,0,0,0,16,0.0194410692588092,0
2014,31087,11,48,1,15,0,0,1,15,0.00711912672045562,0.0666666666666667
2014,31089,43,165,46,158,0,12,46,170,0.0233004385964912,0.270588235294118
2014,31091,0,12,7,7,0,2,7,9,0.0163636363636364,0.777777777777778
2014,31093,10,143,4,32,0,4,4,36,0.00817253121452895,0.111111111111111
2014,31095,33,196,2,53,0,7,2,60,0.0110680686220255,0.0333333333333333
2014,31097,23,310,3,32,0,15,3,47,0.0122555410691004,0.0638297872340425
2014,31099,35,309,52,81,0,0,52,81,0.0178139432592918,0.641975308641975
2014,31101,86,194,86,324,0,2,86,326,0.054524167921057,0.263803680981595
2014,31103,7,10,0,10,0,0,0,10,0.0166666666666667,0
2014,31105,6,52,8,110,0,0,8,110,0.0415251038127595,0.0727272727272727
2014,31107,45,97,7,87,0,5,7,92,0.0153001829369699,0.0760869565217391
2014,31109,708,3744,1699,3901,400,1102,2099,5003,0.0275281857148359,0.419548271037378
2014,31111,161,468,62,471,10,18,72,489,0.0200393410376199,0.147239263803681
2014,31113,3,26,4,21,0,0,4,21,0.0425101214574899,0.19047619047619
2014,31115,3,18,0,13,0,0,0,13,0.032258064516129,0
2014,31117,1,2,2,3,3,3,5,6,0.0185185185185185,0.833333333333333
2014,31119,111,638,113,469,5,24,118,493,0.021671282254165,0.239350912778905
2014,31121,41,308,6,76,0,20,6,96,0.0177350822094957,0.0625
2014,31123,6,81,16,69,0,0,16,69,0.0204202426753477,0.231884057971014
2014,31125,6,50,4,31,0,2,4,33,0.0127610208816705,0.121212121212121
2014,31127,64,174,10,104,0,0,10,104,0.0221041445270988,0.0961538461538462
2014,31129,49,115,16,51,16,16,32,67,0.0203957382039574,0.477611940298507
2014,31131,137,434,17,154,0,23,17,177,0.0163570834488495,0.096045197740113
2014,31133,15,65,0,17,0,2,0,19,0.00951903807615231,0
2014,31135,5,62,26,50,0,0,26,50,0.0242483026188167,0.52
2014,31137,35,195,100,205,9,21,109,226,0.0356410660779057,0.482300884955752
2014,31139,24,169,18,63,0,0,18,63,0.0129098360655738,0.285714285714286
2014,31141,107,406,63,243,0,22,63,265,0.012542003880922,0.237735849056604
2014,31143,13,114,13,19,0,6,13,25,0.00670600858369099,0.52
2014,31145,22,153,2,138,12,12,14,150,0.0201612903225806,0.0933333333333333
2014,31147,47,59,7,120,0,0,7,120,0.0199700449326011,0.0583333333333333
2014,31149,0,30,4,25,3,4,7,29,0.026508226691042,0.241379310344828
2014,31151,40,323,0,63,0,32,0,95,0.0109082558273051,0
2014,31153,1371,4517,1421,3170,254,667,1675,3837,0.0367902276257503,0.4365389627313
2014,31155,133,699,57,150,10,23,67,173,0.0122425872195881,0.38728323699422
2014,31157,117,340,144,805,16,22,160,827,0.0337083231433928,0.193470374848851
2014,31159,101,403,44,146,0,4,44,150,0.0140344311377246,0.293333333333333
2014,31161,32,113,26,94,0,0,26,94,0.0246654421411703,0.276595744680851
2014,31163,11,31,0,32,0,5,0,37,0.0163067430586161,0
2014,31165,2,7,0,15,0,0,0,15,0.016008537886873,0
2014,31167,46,201,3,39,0,0,3,39,0.00967261904761905,0.0769230769230769
2014,31169,28,91,10,58,0,0,10,58,0.0153358011634056,0.172413793103448
2014,31171,16,32,0,0,0,2,0,2,0.00378071833648393,0
2014,31173,26,80,15,70,0,1,15,71,0.0188328912466844,0.211267605633803
2014,31175,23,83,0,40,0,0,0,40,0.0131276665572694,0
2014,31177,79,387,32,173,0,0,32,173,0.012739322533137,0.184971098265896
2014,31179,66,294,36,83,0,0,36,83,0.0160572644612111,0.433734939759036
2014,31181,21,91,12,56,0,3,12,59,0.0222054949190817,0.203389830508475
2014,31183,4,18,0,2,0,0,0,2,0.00324149108589951,0
2014,31185,44,387,8,100,2,9,10,109,0.0116019159127195,0.0917431192660551
2014,32001,11,440,205,793,37,99,242,892,0.0551366052664112,0.271300448430493
2014,32003,536,2826,15040,55506,2856,8360,17896,63866,0.0479160070644337,0.280211693232706
2014,32005,177,585,292,1392,0,17,292,1409,0.0402433451388096,0.207239176721079
2014,32007,133,497,185,1316,29,29,214,1345,0.0426496702181634,0.15910780669145
2014,32009,11,29,0,57,0,0,0,57,0.0755968169761273,0
2014,32011,37,37,35,56,0,0,35,56,0.0451612903225806,0.625
2014,32013,66,479,72,524,13,73,85,597,0.0553597922848665,0.142378559463987
2014,32015,0,85,4,111,0,0,4,111,0.029396186440678,0.036036036036036
2014,32017,31,231,47,68,0,3,47,71,0.0214956100514684,0.661971830985915
2014,32019,71,1541,251,1422,35,69,286,1491,0.0416004017745041,0.191817572099262
2014,32021,6,91,16,158,0,0,16,158,0.0470658325886208,0.10126582278481
2014,32023,81,1068,358,1434,0,78,358,1512,0.0471321695760598,0.236772486772487
2014,32027,31,628,9,124,0,3,9,127,0.0252134206869168,0.0708661417322835
2014,32029,67,133,8,118,0,0,8,118,0.0358662613981763,0.0677966101694915
2014,32031,669,3593,3702,11686,695,1477,4397,13163,0.0457561779356709,0.334042391552078
2014,32033,22,275,60,203,0,5,60,208,0.0303472424861395,0.288461538461538
2014,32510,376,2506,235,1675,9,51,244,1726,0.0450335272784199,0.141367323290846
2014,33001,358,1168,484,912,21,60,505,972,0.0222064837449453,0.519547325102881
2014,33003,228,569,521,1263,6,27,527,1290,0.0355401272832465,0.408527131782946
2014,33005,162,604,648,1598,116,186,764,1784,0.0342523615697719,0.428251121076233
2014,33007,76,522,125,441,4,14,129,455,0.0186605421810278,0.283516483516484
2014,33009,282,1133,1606,2622,265,356,1871,2978,0.0487461533424998,0.628274009402283
2014,33011,946,3826,3393,7017,618,1503,4011,8520,0.0307812364519206,0.470774647887324
2014,33013,905,3410,822,1941,70,195,892,2136,0.020841261013377,0.417602996254682
2014,33015,1036,2856,3064,6065,296,530,3360,6595,0.031282313990001,0.509476876421531
2014,33017,524,2176,852,2350,250,336,1102,2686,0.0336427059457158,0.410275502606106
2014,33019,418,997,299,563,10,38,309,601,0.0191011950165268,0.51414309484193
2014,34001,942,3021,790,2653,249,831,1039,3484,0.0186498653719535,0.298220436280138
2014,34003,5045,9751,6490,10646,2676,4204,9166,14850,0.0230006118007853,0.617239057239057
2014,34005,2061,6085,1967,5131,768,1785,2735,6916,0.0222761912737627,0.39545980335454
2014,34007,2081,7946,2719,5770,466,1537,3185,7307,0.0211792804203973,0.435883399479951
2014,34009,402,1114,757,1485,46,183,803,1668,0.0235703081944974,0.481414868105516
2014,34011,429,4287,159,943,45,616,204,1559,0.0147942189620323,0.13085311096857
2014,34013,3679,9255,3376,7322,1079,3290,4455,10612,0.0203515299126449,0.419807764794572
2014,34015,837,4041,857,1776,105,525,962,2301,0.0118292394534182,0.418079096045198
2014,34017,4628,8703,8401,11736,3624,6232,12025,17968,0.0391866929248914,0.669245325022262
2014,34019,1067,2542,675,1123,165,194,840,1317,0.0148645598194131,0.637813211845103
2014,34021,2651,6389,2416,4320,1348,2211,3764,6531,0.0265093397627919,0.576328280508345
2014,34023,6159,12018,4466,7273,3590,5432,8056,12705,0.0228298604871808,0.634081070444707
2014,34025,3920,7907,2635,5800,656,1433,3291,7233,0.0166747354588837,0.454997926171713
2014,34027,4264,7828,2845,4711,984,1905,3829,6616,0.0192040869640939,0.578748488512696
2014,34029,2456,7717,1333,4329,385,1272,1718,5601,0.0139643772501072,0.30673094090341
2014,34031,2017,4952,1163,2668,334,1585,1497,4253,0.0129143336045961,0.351986832823889
2014,34033,182,937,138,688,25,153,163,841,0.0186457963816956,0.193816884661118
2014,34035,3273,5378,2008,2764,1078,1638,3086,4402,0.0194719311360691,0.701044979554748
2014,34037,591,2143,434,1223,130,297,564,1520,0.0149098542365566,0.371052631578947
2014,34039,3888,9143,1803,4401,512,1908,2315,6309,0.0172282435056158,0.366936122998891
2014,34041,434,1865,337,1189,58,329,395,1518,0.0203512535192385,0.260210803689065
2014,35001,2306,8197,5631,11895,1021,2239,6652,14134,0.0316341946530288,0.47063817744446
2014,35003,3,92,10,75,1,1,11,76,0.02500822639026,0.144736842105263
2014,35005,288,822,290,1386,38,229,328,1615,0.0393288525228911,0.203095975232198
2014,35006,115,617,59,284,0,109,59,393,0.0217199071515419,0.150127226463104
2014,35007,61,406,67,234,10,10,77,244,0.0252509572596502,0.315573770491803
2014,35009,81,483,473,1512,46,137,519,1649,0.0544080770753596,0.314736203759854
2014,35011,0,37,54,65,0,0,54,65,0.0457102672292546,0.830769230769231
2014,35013,315,2091,1352,3615,251,653,1603,4268,0.033536058334512,0.375585754451734
2014,35015,277,723,269,951,18,77,287,1028,0.0288060077899515,0.279182879377432
2014,35017,92,242,114,434,48,48,162,482,0.0233086706320422,0.336099585062241
2014,35019,12,364,9,26,0,14,9,40,0.0118906064209275,0.225
2014,35021,0,4,18,27,0,1,18,28,0.0571428571428571,0.642857142857143
2014,35023,12,62,37,76,0,15,37,91,0.0282784338098198,0.406593406593407
2014,35025,112,653,200,1101,26,153,226,1254,0.0312282099810738,0.180223285486443
2014,35027,169,456,216,754,11,25,227,779,0.0512702382519416,0.291399229781772
2014,35028,209,415,494,609,60,70,554,679,0.0536038525301966,0.815905743740795
2014,35029,130,344,143,602,6,109,149,711,0.0439948023018378,0.209563994374121
2014,35031,20,247,199,747,45,117,244,864,0.0204497041420118,0.282407407407407
2014,35033,0,155,0,0,0,0,0,0,0,NA
2014,35035,340,1086,379,1795,122,828,501,2623,0.0624434604580298,0.191002668699962
2014,35037,31,134,5,155,0,5,5,160,0.0259529602595296,0.03125
2014,35039,72,434,21,201,24,72,45,273,0.0101581395348837,0.164835164835165
2014,35041,47,349,72,380,26,81,98,461,0.0411533654704517,0.212581344902386
2014,35043,644,2368,991,2444,77,155,1068,2599,0.0290160877962733,0.41092727972297
2014,35045,224,818,455,1870,10,128,465,1998,0.0251330238876939,0.232732732732733
2014,35047,63,294,99,184,0,89,99,273,0.0139228886168911,0.362637362637363
2014,35049,760,2311,2133,3868,265,721,2398,4589,0.0434572624481524,0.522553933318806
2014,35051,4,135,65,172,0,4,65,176,0.0190847972240295,0.369318181818182
2014,35053,14,111,27,158,0,0,27,158,0.0143090019923927,0.170886075949367
2014,35055,96,311,434,857,25,72,459,929,0.0383219206336111,0.494079655543595
2014,35057,11,421,52,426,0,206,52,632,0.0569523294584122,0.0822784810126582
2014,35059,11,321,39,190,0,0,39,190,0.0609756097560976,0.205263157894737
2014,35061,75,2194,139,771,35,93,174,864,0.0172513627378552,0.201388888888889
2014,36001,2388,6069,1281,2595,602,1042,1883,3637,0.0178544253152875,0.517734396480616
2014,36003,97,614,127,348,41,64,168,412,0.0134794699820056,0.407766990291262
2014,36005,4917,23366,1629,6836,1940,8750,3569,15586,0.0176930874812268,0.228987552932119
2014,36007,492,2217,861,1806,204,475,1065,2281,0.0172765074339728,0.46690048224463
2014,36009,198,1042,187,585,27,73,214,658,0.0122940099398378,0.325227963525836
2014,36011,371,1904,265,556,68,178,333,734,0.0131831815650987,0.453678474114441
2014,36013,191,1540,199,1146,58,319,257,1465,0.0162308885442056,0.17542662116041
2014,36015,324,1728,312,940,15,72,327,1012,0.0166209535697275,0.323122529644269
2014,36017,170,732,82,326,11,27,93,353,0.0100813936884192,0.263456090651558
2014,36019,134,2385,81,629,21,201,102,830,0.0149525302203246,0.12289156626506
2014,36021,350,1198,154,454,28,85,182,539,0.0118077462320365,0.337662337662338
2014,36023,134,607,70,229,15,22,85,251,0.00827127133724379,0.338645418326693
2014,36025,267,1178,69,351,28,41,97,392,0.0117467261993947,0.247448979591837
2014,36027,1450,5908,928,1874,419,930,1347,2804,0.0139283514474756,0.480385164051355
2014,36029,2538,7254,2872,5948,1240,2650,4112,8598,0.0136307644991352,0.478250755989765
2014,36031,253,1333,211,666,63,87,274,753,0.0259565667011375,0.363877822045153
2014,36033,204,2692,104,363,19,73,123,436,0.0120980049390938,0.282110091743119
2014,36035,206,1296,112,290,53,69,165,359,0.00926260384952784,0.459610027855153
2014,36037,270,1155,83,292,4,60,87,352,0.00846784863720561,0.247159090909091
2014,36039,99,926,113,394,12,21,125,415,0.0117961399619113,0.301204819277108
2014,36041,3,69,6,45,0,0,6,45,0.0122482308111051,0.133333333333333
2014,36043,167,951,88,246,0,26,88,272,0.00610371833135112,0.323529411764706
2014,36045,328,1806,1576,3968,368,2128,1944,6096,0.082658747915226,0.318897637795276
2014,36047,15146,28302,11934,18571,5809,14366,17743,32937,0.0192693027960585,0.538695084555363
2014,36049,118,324,37,159,10,90,47,249,0.0134966664859884,0.188755020080321
2014,36051,341,1676,111,366,0,47,111,413,0.00974056603773585,0.268765133171913
2014,36053,274,1271,199,589,96,151,295,740,0.0155550417253484,0.398648648648649
2014,36055,2481,6698,2469,5409,1141,2568,3610,7977,0.0159393039617473,0.452551084367557
2014,36057,166,1115,24,188,24,150,48,338,0.00985451470888364,0.142011834319527
2014,36059,8121,16918,2415,4908,1630,3774,4045,8682,0.00936486740115761,0.465906473162866
2014,36061,15757,27860,30272,35891,15683,20249,45955,56140,0.046236357227334,0.81857855361596
2014,36063,987,3154,330,1097,62,176,392,1273,0.00848451725562857,0.307934014139827
2014,36065,723,4718,446,1366,116,458,562,1824,0.0113910295642182,0.308114035087719
2014,36067,1791,5353,1726,3835,731,1597,2457,5432,0.0174165084902273,0.452319587628866
2014,36069,1166,2953,278,614,39,134,317,748,0.00994813140045219,0.42379679144385
2014,36071,1598,4571,1357,3346,174,552,1531,3898,0.0164867699803749,0.392765520779887
2014,36073,133,1905,26,204,0,38,26,242,0.00817733324322498,0.107438016528926
2014,36075,157,1601,217,700,23,63,240,763,0.00955445916501791,0.314547837483617
2014,36077,276,1010,156,417,25,34,181,451,0.0112306389760446,0.401330376940133
2014,36079,968,2185,297,728,75,146,372,874,0.012588762297089,0.425629290617849
2014,36081,12290,29447,6467,12269,5825,15699,12292,27968,0.0174928572500788,0.439502288329519
2014,36083,1541,4608,556,1202,186,288,742,1490,0.0137068212133756,0.497986577181208
2014,36085,1311,4043,931,1700,324,879,1255,2579,0.00805819145313032,0.486622721985266
2014,36087,1086,2534,918,1744,349,951,1267,2695,0.0134454200758332,0.47012987012987
2014,36089,299,2057,463,991,63,215,526,1206,0.0167739961333574,0.436152570480929
2014,36091,1792,4474,1442,2363,444,726,1886,3089,0.0198728753586639,0.610553577209453
2014,36093,875,2808,307,819,265,377,572,1196,0.0113283321967114,0.478260869565217
2014,36095,145,563,19,187,11,31,30,218,0.00978368189570056,0.137614678899083
2014,36097,57,428,22,104,0,41,22,145,0.0109607680096757,0.151724137931034
2014,36099,189,1815,73,344,4,12,77,356,0.0142983372158406,0.216292134831461
2014,36101,403,1615,269,723,53,102,322,825,0.0120744665281152,0.39030303030303
2014,36103,4795,11757,2696,5588,1482,3060,4178,8648,0.00849235216943853,0.483117483811286
2014,36105,482,2426,110,661,31,171,141,832,0.0155895744720718,0.169471153846154
2014,36107,317,833,106,492,12,40,118,532,0.0150725294650952,0.221804511278195
2014,36109,974,2029,1520,1990,957,1050,2477,3040,0.05193385267186,0.814802631578947
2014,36111,777,3777,511,1336,32,342,543,1678,0.0130855552002995,0.323599523241955
2014,36113,354,1707,212,541,9,73,221,614,0.0129735668857101,0.359934853420195
2014,36115,242,2242,181,644,12,62,193,706,0.015809391584746,0.273371104815864
2014,36117,515,1752,121,691,11,171,132,862,0.0134025747869892,0.153132250580046
2014,36119,7167,13750,4166,6670,2081,4342,6247,11012,0.016813856621105,0.567290228841264
2014,36121,167,2120,56,293,0,43,56,336,0.0112041081729968,0.166666666666667
2014,36123,170,587,38,306,8,39,46,345,0.0208635703918723,0.133333333333333
2014,37001,527,2236,521,1409,167,500,688,1909,0.01867193536713,0.360398114195914
2014,37003,40,592,28,262,0,35,28,297,0.0114230769230769,0.0942760942760943
2014,37005,4,63,16,161,0,0,16,161,0.0201275159394924,0.0993788819875776
2014,37007,134,969,1,247,0,0,1,247,0.0135453797641897,0.00404858299595142
2014,37009,79,537,37,138,3,45,40,183,0.00909542743538767,0.218579234972678
2014,37011,104,856,40,289,0,14,40,303,0.0232166117538886,0.132013201320132
2014,37013,109,501,154,456,10,85,164,541,0.016007337929402,0.303142329020333
2014,37015,71,711,0,120,0,2,0,122,0.00823211875843455,0
2014,37017,59,388,10,245,3,28,13,273,0.0113320327093105,0.0476190476190476
2014,37019,848,2472,1387,3250,63,195,1450,3445,0.0402007118268277,0.420899854862119
2014,37021,1907,5111,2906,6388,93,263,2999,6651,0.0380013712718546,0.450909637648474
2014,37023,295,1894,243,757,7,68,250,825,0.0131503442999235,0.303030303030303
2014,37025,1093,3668,724,2411,68,264,792,2675,0.02217414370503,0.29607476635514
2014,37027,126,1562,94,521,0,34,94,555,0.00965435663715275,0.169369369369369
2014,37029,96,244,15,223,0,0,15,223,0.033032143386165,0.0672645739910314
2014,37031,446,1615,520,1390,140,328,660,1718,0.0341985826897046,0.384167636786962
2014,37033,50,941,40,296,0,25,40,321,0.0188879082082966,0.124610591900312
2014,37035,602,3031,328,1168,7,91,335,1259,0.0119371568897022,0.266084193804607
2014,37037,656,1306,762,1193,87,88,849,1281,0.0266342315369261,0.662763466042155
2014,37039,164,262,113,633,0,10,113,643,0.0317233213281366,0.175738724727838
2014,37041,181,281,15,238,0,0,15,238,0.0227403019300592,0.0630252100840336
2014,37043,45,199,60,240,0,0,60,240,0.0305498981670061,0.25
2014,37045,189,1415,172,705,35,69,207,774,0.0117286943871984,0.267441860465116
2014,37047,198,1627,81,500,10,64,91,564,0.0143690606608749,0.161347517730496
2014,37049,399,2101,757,2770,139,625,896,3395,0.0504885266867927,0.263917525773196
2014,37051,1015,3915,2652,9183,802,3466,3454,12649,0.0639678365530495,0.273065064431971
2014,37053,110,269,125,501,24,64,149,565,0.0333372669341515,0.263716814159292
2014,37055,213,374,411,894,0,9,411,903,0.0353867857982601,0.45514950166113
2014,37057,748,3057,161,858,9,110,170,968,0.00856841900277057,0.175619834710744
2014,37059,197,711,107,309,27,48,134,357,0.0123358673116793,0.375350140056022
2014,37061,61,1580,94,378,0,91,94,469,0.0119071798517315,0.200426439232409
2014,37063,4167,8566,4072,6475,1282,2042,5354,8517,0.045206526469995,0.628625102735705
2014,37065,150,1573,35,488,0,32,35,520,0.013912299007411,0.0673076923076923
2014,37067,1808,6386,2183,4211,371,640,2554,4851,0.0205195233683997,0.526489383632241
2014,37069,367,1521,130,406,0,16,130,422,0.0100882120915111,0.308056872037915
2014,37071,697,3545,346,1622,68,327,414,1949,0.0137977416728611,0.212416623909697
2014,37073,0,81,18,106,0,13,18,119,0.0144155057540884,0.151260504201681
2014,37075,37,110,15,103,0,1,15,104,0.0172528201725282,0.144230769230769
2014,37077,305,1593,182,624,71,133,253,757,0.0191094057656384,0.334214002642008
2014,37079,10,1202,0,209,2,80,2,289,0.0197081287506819,0.0069204152249135
2014,37081,2010,6894,2384,6302,764,1565,3148,7867,0.0239362996860015,0.400152535909495
2014,37083,129,1009,103,375,13,39,116,414,0.0111861659011078,0.280193236714976
2014,37085,752,3686,972,2764,150,415,1122,3179,0.0418520761473446,0.352941176470588
2014,37087,406,1247,398,1348,20,35,418,1383,0.0317281883043887,0.302241503976862
2014,37089,471,2439,1315,2523,28,168,1343,2691,0.0338218289678749,0.499070977331847
2014,37091,58,481,233,1094,3,10,236,1104,0.0649411764705882,0.213768115942029
2014,37093,344,2282,422,1179,132,662,554,1841,0.059852400923307,0.300923411189571
2014,37095,18,479,0,16,0,3,0,19,0.00438292964244521,0
2014,37097,772,2476,925,2871,248,498,1173,3369,0.0307980619800713,0.348174532502226
2014,37099,187,683,235,556,0,46,235,602,0.0235478192841776,0.390365448504983
2014,37101,601,3858,365,1904,33,97,398,2001,0.0175375554348017,0.198900549725137
2014,37103,58,427,2,37,0,0,2,37,0.0050601750547046,0.0540540540540541
2014,37105,261,1256,375,869,54,54,429,923,0.0237672202909746,0.464788732394366
2014,37107,107,934,18,291,27,68,45,359,0.00890664152628576,0.125348189415042
2014,37109,350,1598,347,1185,0,128,347,1313,0.0238649169362754,0.264280274181264
2014,37111,87,887,59,241,18,136,77,377,0.0118155890556931,0.204244031830239
2014,37113,79,198,294,909,30,51,324,960,0.0379957254808834,0.3375
2014,37115,86,437,80,156,3,25,83,181,0.0122911856580198,0.458563535911602
2014,37117,33,328,20,131,0,25,20,156,0.0092002830856334,0.128205128205128
2014,37119,4911,12198,12335,24236,2185,4232,14520,28468,0.0448413823520146,0.510046367851623
2014,37121,89,301,15,85,0,35,15,120,0.0106449037523286,0.125
2014,37123,33,719,11,92,5,32,16,124,0.00651534258091635,0.129032258064516
2014,37125,369,1301,1092,1972,281,456,1373,2428,0.0371520817713035,0.565485996705107
2014,37127,346,2435,99,757,0,57,99,814,0.0125969142202758,0.121621621621622
2014,37129,1838,5178,1247,3510,265,726,1512,4236,0.0299974506415885,0.356940509915014
2014,37131,106,815,61,320,0,3,61,323,0.0211055933089388,0.188854489164087
2014,37133,385,1950,1633,6684,157,1628,1790,8312,0.086552679259429,0.215351299326275
2014,37135,1773,3613,2323,3238,887,1140,3210,4378,0.0524883405867472,0.733211512105984
2014,37137,97,568,28,104,19,39,47,143,0.0145251396648045,0.328671328671329
2014,37139,87,1044,181,772,0,57,181,829,0.031258248180687,0.218335343787696
2014,37141,297,2262,238,1028,50,108,288,1136,0.0300982963728373,0.253521126760563
2014,37143,3,203,88,280,0,3,88,283,0.028807003257329,0.31095406360424
2014,37145,27,410,79,355,23,66,102,421,0.0153761869978086,0.242280285035629
2014,37147,763,2236,829,2020,125,304,954,2324,0.0227829735505755,0.410499139414802
2014,37149,64,232,210,435,11,24,221,459,0.0299549696534621,0.481481481481481
2014,37151,421,2178,59,492,0,38,59,530,0.00547860243952863,0.111320754716981
2014,37153,102,875,154,508,0,23,154,531,0.0172385806577281,0.290018832391714
2014,37155,214,1849,198,910,20,157,218,1067,0.0126495240127562,0.204311152764761
2014,37157,159,1187,277,942,47,188,324,1130,0.0172611319025433,0.286725663716814
2014,37159,452,3073,368,1254,14,59,382,1313,0.0140252304602797,0.290936785986291
2014,37161,234,990,277,830,0,29,277,859,0.0181545354636909,0.322467986030268
2014,37163,340,1719,96,631,0,21,96,652,0.0153505674059425,0.147239263803681
2014,37165,125,866,100,448,35,60,135,508,0.0214744673655732,0.265748031496063
2014,37167,244,1205,115,429,0,6,115,435,0.0104799074877132,0.264367816091954
2014,37169,84,679,16,165,19,112,35,277,0.00827409044745803,0.126353790613718
2014,37171,118,1060,81,385,14,52,95,437,0.00856980369854686,0.217391304347826
2014,37173,3,104,33,244,11,22,44,266,0.0275590551181102,0.165413533834586
2014,37175,73,677,138,441,58,113,196,554,0.0226631212926979,0.353790613718412
2014,37177,0,413,0,29,0,0,0,29,0.0094370322160755,0
2014,37179,1393,4315,1373,3474,78,462,1451,3936,0.0300487834670616,0.36864837398374
2014,37181,96,552,98,302,0,27,98,329,0.0110957471923375,0.297872340425532
2014,37183,7606,15381,10372,18401,2357,4484,12729,22885,0.0369892660818855,0.556215861918287
2014,37185,122,686,35,227,70,136,105,363,0.0245220563399311,0.289256198347107
2014,37187,0,66,0,98,0,3,0,101,0.0114916372738651,0
2014,37189,411,1163,321,604,95,182,416,786,0.0274230688716768,0.529262086513995
2014,37191,604,3123,399,1791,77,303,476,2094,0.0258336726007624,0.227316141356256
2014,37193,128,761,151,239,0,23,151,262,0.00536533420707733,0.576335877862595
2014,37195,345,1544,247,955,1,121,248,1076,0.0196903707499177,0.230483271375465
2014,37197,76,364,55,246,0,23,55,269,0.0101597613022623,0.204460966542751
2014,37199,17,348,20,150,12,25,32,175,0.0134719014626636,0.182857142857143
2014,38001,5,39,14,38,3,3,17,41,0.0230596175478065,0.414634146341463
2014,38003,93,240,13,107,0,6,13,113,0.0146791374382957,0.115044247787611
2014,38005,47,114,5,57,0,2,5,59,0.0152691511387164,0.0847457627118644
2014,38007,23,54,15,48,0,0,15,48,0.0747663551401869,0.3125
2014,38009,14,85,33,97,8,11,41,108,0.0230080954409885,0.37962962962963
2014,38011,3,21,11,65,0,0,11,65,0.0289919714540589,0.169230769230769
2014,38013,9,59,12,81,0,1,12,82,0.0572625698324022,0.146341463414634
2014,38015,576,1838,480,1650,39,88,519,1738,0.0300728461924455,0.298619102416571
2014,38017,805,1862,1787,4484,176,500,1963,4984,0.0508192876734677,0.393860353130016
2014,38019,2,46,6,10,0,0,6,10,0.00341880341880342,0.6
2014,38021,33,77,44,102,0,0,44,102,0.0286436394271272,0.431372549019608
2014,38023,11,36,0,33,0,2,0,35,0.0194336479733481,0
2014,38025,29,77,4,119,0,0,4,119,0.0430691277596815,0.0336134453781513
2014,38027,6,71,10,61,0,5,10,66,0.0380184331797235,0.151515151515152
2014,38029,18,49,4,5,0,11,4,16,0.0064,0.25
2014,38031,22,114,8,26,0,5,8,31,0.0128364389233954,0.258064516129032
2014,38033,3,3,26,66,0,1,26,67,0.055008210180624,0.388059701492537
2014,38035,126,524,674,1717,150,311,824,2028,0.052005333880398,0.406311637080868
2014,38037,2,61,5,18,6,6,11,24,0.0132450331125828,0.458333333333333
2014,38039,9,74,2,23,1,7,3,30,0.0165380374862183,0.1
2014,38041,23,94,1,102,1,1,2,103,0.0548455804046858,0.0194174757281553
2014,38043,7,63,7,25,2,11,9,36,0.0198785201546107,0.25
2014,38045,20,68,23,44,0,3,23,47,0.0155115511551155,0.48936170212766
2014,38047,6,29,0,25,0,6,0,31,0.0213058419243986,0
2014,38049,28,132,20,96,0,9,20,105,0.0259451445515196,0.19047619047619
2014,38051,8,26,3,14,0,0,3,14,0.00641319285387082,0.214285714285714
2014,38053,34,211,40,311,0,2,40,313,0.0593477436480849,0.12779552715655
2014,38055,77,273,36,180,4,9,40,189,0.0276113951789627,0.211640211640212
2014,38057,78,300,34,130,2,10,36,140,0.0225879315908358,0.257142857142857
2014,38059,242,961,188,598,0,26,188,624,0.0319051027712445,0.301282051282051
2014,38061,48,310,9,146,0,0,9,146,0.0255378695119818,0.0616438356164384
2014,38063,13,68,1,50,0,0,1,50,0.021079258010118,0.02
2014,38065,0,36,0,5,0,0,0,5,0.00382555470543229,0
2014,38067,52,214,8,111,3,17,11,128,0.0241100018835939,0.0859375
2014,38069,0,128,0,63,0,0,0,63,0.019644527595884,0
2014,38071,110,357,50,125,0,6,50,131,0.0165550360166814,0.381679389312977
2014,38073,8,200,5,55,0,8,5,63,0.0163934426229508,0.0793650793650794
2014,38075,24,61,5,23,0,5,5,28,0.0158102766798419,0.178571428571429
2014,38077,109,227,37,236,0,36,37,272,0.0260112843071627,0.136029411764706
2014,38079,27,92,43,65,0,2,43,67,0.0083064716092239,0.641791044776119
2014,38081,22,79,13,27,0,24,13,51,0.018451519536903,0.254901960784314
2014,38083,1,17,4,15,0,0,4,15,0.0141376060320452,0.266666666666667
2014,38085,13,39,8,56,0,8,8,64,0.0285204991087344,0.125
2014,38087,12,12,0,12,0,0,0,12,0.0211640211640212,0
2014,38089,146,539,192,825,0,48,192,873,0.0490284173873975,0.219931271477663
2014,38091,18,78,1,24,0,0,1,24,0.0165631469979296,0.0416666666666667
2014,38093,112,529,82,282,0,4,82,286,0.0196685234853174,0.286713286713287
2014,38095,14,79,3,17,0,0,3,17,0.0102843315184513,0.176470588235294
2014,38097,71,199,35,117,2,7,37,124,0.0224678383765175,0.298387096774194
2014,38099,55,108,7,125,25,40,32,165,0.0210674157303371,0.193939393939394
2014,38101,173,922,808,2240,116,410,924,2650,0.0660452596949457,0.348679245283019
2014,38103,20,75,12,33,1,1,13,34,0.0106750392464678,0.382352941176471
2014,38105,49,317,230,1217,8,10,238,1227,0.0689946018893387,0.193969030154849
2014,39001,2,316,35,97,0,0,35,97,0.00508385744234801,0.360824742268041
2014,39003,277,1706,162,867,0,66,162,933,0.0134678676597956,0.173633440514469
2014,39005,165,1079,195,414,107,112,302,526,0.0150032801848313,0.574144486692015
2014,39007,188,1537,151,947,7,162,158,1109,0.0160149029574861,0.142470694319207
2014,39009,276,840,262,470,90,169,352,639,0.0186629282397266,0.550860719874804
2014,39011,218,985,68,227,15,28,83,255,0.00822872632224338,0.325490196078431
2014,39013,143,1606,162,643,24,62,186,705,0.0138949111119871,0.263829787234043
2014,39015,35,705,50,475,2,6,52,481,0.0158871713568503,0.108108108108108
2014,39017,2010,7119,1295,3298,202,483,1497,3781,0.0160385842269581,0.395927003438244
2014,39019,51,434,16,202,0,8,16,210,0.0103893533864345,0.0761904761904762
2014,39021,100,1007,92,299,0,71,92,370,0.0138493786494984,0.248648648648649
2014,39023,239,1861,405,1301,46,134,451,1435,0.0154123750093978,0.314285714285714
2014,39025,1129,4283,890,2220,90,187,980,2407,0.0179984147636353,0.407145824678022
2014,39027,97,870,39,312,15,124,54,436,0.0157982462497282,0.123853211009174
2014,39029,171,1547,296,1479,0,143,296,1622,0.0214018050350979,0.18249075215783
2014,39031,41,549,78,171,0,6,78,177,0.00701851778421032,0.440677966101695
2014,39033,73,760,11,231,11,33,22,264,0.00882795519143956,0.0833333333333333
2014,39035,4665,11937,5515,10468,1986,3894,7501,14362,0.0164413545514803,0.522281019356636
2014,39037,69,814,74,481,0,46,74,527,0.0147933977094094,0.140417457305503
2014,39039,128,757,85,293,0,28,85,321,0.0123723260743881,0.264797507788162
2014,39041,2638,5231,1184,1921,208,372,1392,2293,0.0194678394348978,0.607064980375055
2014,39043,403,1908,82,557,5,81,87,638,0.0117979917525011,0.136363636363636
2014,39045,887,4315,525,1066,70,176,595,1242,0.0126205403867454,0.479066022544283
2014,39047,171,705,12,147,49,120,61,267,0.0135822565876488,0.228464419475655
2014,39049,6255,17399,8152,16436,2510,5200,10662,21636,0.0277399196624438,0.492789794786467
2014,39051,80,641,17,150,0,16,17,166,0.00581619424687292,0.102409638554217
2014,39053,49,257,85,316,0,37,85,353,0.0170490219753683,0.240793201133144
2014,39055,485,1536,207,368,112,171,319,539,0.00850573624327352,0.591836734693878
2014,39057,1285,2991,1473,2797,317,658,1790,3455,0.0323426164287386,0.518089725036179
2014,39059,93,838,16,264,0,23,16,287,0.0104694852807062,0.0557491289198606
2014,39061,3413,8736,4878,10042,1649,2328,6527,12370,0.0231582021596849,0.527647534357316
2014,39063,275,1357,322,854,34,51,356,905,0.017930733872246,0.393370165745856
2014,39065,70,534,70,123,0,11,70,134,0.00692792885947679,0.522388059701492
2014,39067,27,186,9,196,0,5,9,201,0.0178571428571429,0.0447761194029851
2014,39069,66,369,56,233,0,0,56,233,0.0122451124658398,0.240343347639485
2014,39071,88,939,62,221,20,41,82,262,0.00898552712806091,0.312977099236641
2014,39073,100,787,0,87,0,0,0,87,0.00434066756473582,0
2014,39075,20,279,13,271,0,50,13,321,0.0131773399014778,0.0404984423676012
2014,39077,55,1447,18,531,3,14,21,545,0.0138268723361072,0.0385321100917431
2014,39079,115,672,29,157,0,13,29,170,0.00762468604233943,0.170588235294118
2014,39081,69,640,197,893,0,50,197,943,0.019476227849147,0.208907741251326
2014,39083,293,1462,112,436,9,67,121,503,0.0127622865551975,0.240556660039761
2014,39085,1011,3315,488,1174,101,338,589,1512,0.00929689181295539,0.389550264550265
2014,39087,74,542,136,1215,0,25,136,1240,0.0290024558531166,0.109677419354839
2014,39089,1006,3715,304,1036,99,182,403,1218,0.0108366845795224,0.330870279146141
2014,39091,100,929,29,200,12,50,41,250,0.00809742825678565,0.164
2014,39093,1365,6080,572,1718,141,519,713,2237,0.0108740034999028,0.318730442556996
2014,39095,1180,4556,1349,4241,346,693,1695,4934,0.0170787512504457,0.343534657478719
2014,39097,232,2610,62,254,16,51,78,305,0.0101067002452117,0.255737704918033
2014,39099,458,3732,709,2839,109,325,818,3164,0.0190626525042325,0.258533501896334
2014,39101,146,2282,88,577,0,48,88,625,0.0135187748745458,0.1408
2014,39103,1048,3856,563,1158,115,242,678,1400,0.011754038351748,0.484285714285714
2014,39105,65,422,23,117,0,0,23,117,0.00708146713472945,0.196581196581197
2014,39107,150,604,71,245,58,107,129,352,0.0129999630682867,0.366477272727273
2014,39109,514,2173,235,855,42,186,277,1041,0.0146551602776174,0.266090297790586
2014,39111,6,126,24,103,0,22,24,125,0.0119548584544759,0.192
2014,39113,2236,8722,2029,5860,520,1204,2549,7064,0.0194982458755303,0.360843714609287
2014,39115,7,276,9,97,6,6,15,103,0.00985551621854368,0.145631067961165
2014,39117,58,518,7,100,0,18,7,118,0.00502619585125868,0.0593220338983051
2014,39119,250,1201,89,401,31,44,120,445,0.00770029416854127,0.269662921348315
2014,39121,25,1024,0,93,0,0,0,93,0.00823664865822336,0
2014,39123,235,952,90,326,2,10,92,336,0.0110573600552868,0.273809523809524
2014,39125,37,299,11,54,0,61,11,115,0.00876190476190476,0.0956521739130435
2014,39127,112,878,12,96,0,12,12,108,0.00451240912509401,0.111111111111111
2014,39129,273,2995,65,276,2,57,67,333,0.00867729831144465,0.201201201201201
2014,39131,82,836,42,226,0,27,42,253,0.0131750247357184,0.16600790513834
2014,39133,616,2914,611,1468,254,314,865,1782,0.0173041629038366,0.485409652076319
2014,39135,55,551,20,400,0,44,20,444,0.0154402559465851,0.045045045045045
2014,39137,88,472,36,87,24,45,60,132,0.00582910134687569,0.454545454545455
2014,39139,495,3721,51,705,86,145,137,850,0.00995794233765625,0.161176470588235
2014,39141,200,2375,99,563,0,7,99,570,0.0105133076341369,0.173684210526316
2014,39143,252,1104,59,431,0,7,59,438,0.0105868703470947,0.134703196347032
2014,39145,15,1064,146,721,0,72,146,793,0.0148296368328533,0.184110970996217
2014,39147,190,1034,35,285,29,87,64,372,0.0100291167906826,0.172043010752688
2014,39149,102,601,85,251,0,59,85,310,0.0096162794304681,0.274193548387097
2014,39151,1137,5119,593,2296,207,455,800,2751,0.0106667183652895,0.290803344238459
2014,39153,2471,7146,2030,3798,439,1013,2469,4811,0.0129308491194874,0.513198919143629
2014,39155,376,2418,417,1916,24,171,441,2087,0.014267061340844,0.211308097747964
2014,39157,242,1378,90,634,6,44,96,678,0.0106153123532175,0.141592920353982
2014,39159,899,2808,76,374,68,103,144,477,0.0135998175286537,0.30188679245283
2014,39161,130,664,46,413,0,6,46,419,0.0213917394190024,0.109785202863962
2014,39163,34,318,0,71,0,7,0,78,0.00861117244424818,0
2014,39165,2159,6547,1765,3108,447,761,2212,3869,0.0268027239160103,0.571723959679504
2014,39167,92,463,111,1074,31,109,142,1183,0.0272618334331935,0.120033812341505
2014,39169,482,2231,153,487,62,122,215,609,0.00814737518060684,0.35303776683087
2014,39171,159,785,97,473,0,17,97,490,0.0189218412109978,0.197959183673469
2014,39173,730,2838,655,1247,271,508,926,1755,0.0222396816747557,0.527635327635328
2014,39175,125,649,40,226,0,16,40,242,0.0155757224689451,0.165289256198347
2014,40001,31,136,2,105,0,6,2,111,0.00772442588726514,0.018018018018018
2014,40003,42,385,16,167,0,0,16,167,0.0386037910309755,0.0958083832335329
2014,40005,18,691,22,104,3,8,25,112,0.0116569525395504,0.223214285714286
2014,40007,9,87,6,131,3,3,9,134,0.0358672376873662,0.0671641791044776
2014,40009,65,443,50,752,0,15,50,767,0.0512221183384533,0.0651890482398957
2014,40011,42,481,23,262,0,30,23,292,0.0415185553817716,0.0787671232876712
2014,40013,169,562,158,821,11,88,169,909,0.0318087972845295,0.185918591859186
2014,40015,66,803,29,346,0,67,29,413,0.0211058871627146,0.0702179176755448
2014,40017,965,3746,388,1853,71,217,459,2070,0.0257494713272795,0.221739130434783
2014,40019,96,822,107,490,8,76,115,566,0.0176770042787095,0.203180212014134
2014,40021,123,575,190,453,20,45,210,498,0.0167868940875076,0.421686746987952
2014,40023,6,150,13,104,0,0,13,104,0.0101423834601131,0.125
2014,40025,6,26,2,16,0,0,2,16,0.00970873786407767,0.125
2014,40027,1561,7501,1529,3564,375,635,1904,4199,0.0253910856064775,0.453441295546559
2014,40029,22,110,0,32,0,6,0,38,0.00966429298067141,0
2014,40031,273,2066,1418,5878,365,1207,1783,7085,0.0912768451836488,0.251658433309809
2014,40033,8,83,12,160,0,0,12,160,0.0382043935052531,0.075
2014,40035,56,863,15,206,0,15,15,221,0.0214625619112363,0.0678733031674208
2014,40037,187,1825,44,363,10,45,54,408,0.00856117674213652,0.132352941176471
2014,40039,165,896,56,196,0,22,56,218,0.0129893344455699,0.256880733944954
2014,40041,123,880,111,902,39,58,150,960,0.0326175591193259,0.15625
2014,40043,60,124,7,36,0,0,7,36,0.0110429447852761,0.194444444444444
2014,40045,13,62,6,45,0,0,6,45,0.0157013258897418,0.133333333333333
2014,40047,124,1130,490,1371,127,228,617,1599,0.0395029398685706,0.385866166353971
2014,40049,40,365,18,111,0,15,18,126,0.00683816346466949,0.142857142857143
2014,40051,355,1626,96,444,12,19,108,463,0.0130768796249223,0.233261339092873
2014,40053,13,127,19,31,0,0,19,31,0.00971482293951739,0.612903225806452
2014,40055,3,535,13,80,0,0,13,80,0.017797552836485,0.1625
2014,40057,5,60,18,52,0,0,18,52,0.0264361972547026,0.346153846153846
2014,40059,9,52,18,29,0,39,18,68,0.0266771282856022,0.264705882352941
2014,40061,19,94,8,82,0,26,8,108,0.0125173852573018,0.0740740740740741
2014,40063,48,521,20,142,8,12,28,154,0.0159123785906179,0.181818181818182
2014,40065,115,531,87,459,36,214,123,673,0.0405837303262377,0.182763744427935
2014,40067,22,211,4,83,0,0,4,83,0.0191200184289334,0.0481927710843374
2014,40069,45,316,6,197,7,15,13,212,0.0285984082018076,0.0613207547169811
2014,40071,147,799,133,802,54,165,187,967,0.0319965587982265,0.193381592554292
2014,40073,65,332,25,79,0,0,25,79,0.00791821188734088,0.316455696202532
2014,40075,64,271,19,211,0,0,19,211,0.0324815270935961,0.0900473933649289
2014,40077,28,239,37,129,7,22,44,151,0.0210394315173471,0.291390728476821
2014,40079,51,992,64,606,11,39,75,645,0.0192456883690398,0.116279069767442
2014,40081,61,768,53,399,13,50,66,449,0.0193709823547176,0.146993318485523
2014,40083,662,2041,142,480,27,34,169,514,0.0178373126041088,0.328793774319066
2014,40085,22,113,26,234,0,29,26,263,0.0409274821039527,0.0988593155893536
2014,40087,367,1566,110,250,9,9,119,259,0.0110067570438995,0.459459459459459
2014,40089,31,560,60,364,3,20,63,384,0.0176559841831808,0.1640625
2014,40091,24,481,39,177,0,16,39,193,0.0131265728082704,0.202072538860104
2014,40093,21,191,0,146,0,8,0,154,0.0292664386164956,0
2014,40095,31,388,43,355,0,2,43,357,0.0326474622770919,0.120448179271709
2014,40097,66,721,63,709,1,18,64,727,0.0265260699821214,0.0880330123796424
2014,40099,103,426,35,200,5,5,40,205,0.021986271986272,0.195121951219512
2014,40101,256,2126,143,779,19,96,162,875,0.01874946430102,0.185142857142857
2014,40103,65,248,65,140,0,9,65,149,0.0189422832443427,0.436241610738255
2014,40105,40,308,20,108,0,0,20,108,0.0149377593360996,0.185185185185185
2014,40107,47,565,14,166,0,0,14,166,0.0199231877100336,0.0843373493975904
2014,40109,3183,12542,4836,13418,755,2818,5591,16236,0.033820561051362,0.344358216309436
2014,40111,148,999,98,371,0,23,98,394,0.0151387074463998,0.248730964467005
2014,40113,227,1775,17,245,1,18,18,263,0.00796969696969697,0.0684410646387833
2014,40115,67,424,66,611,0,8,66,619,0.0295423089772348,0.106623586429725
2014,40117,44,508,22,129,4,14,26,143,0.012666076173605,0.181818181818182
2014,40119,540,2114,514,1395,202,299,716,1694,0.0402490020908573,0.422668240850059
2014,40121,168,1142,82,662,0,6,82,668,0.0211499493414387,0.122754491017964
2014,40123,104,715,40,323,10,67,50,390,0.016120365394949,0.128205128205128
2014,40125,249,2080,36,546,0,59,36,605,0.0131364672673977,0.059504132231405
2014,40127,25,244,20,169,7,13,27,182,0.0227870289219982,0.148351648351648
2014,40129,3,59,3,37,0,0,3,37,0.0144700821274932,0.0810810810810811
2014,40131,615,2372,422,1062,30,91,452,1153,0.0198035107004225,0.392020815264527
2014,40133,102,721,15,174,11,11,26,185,0.0110718774313244,0.140540540540541
2014,40135,33,549,21,712,0,8,21,720,0.025668449197861,0.0291666666666667
2014,40137,187,1342,80,633,16,154,96,787,0.0257880595058654,0.121982210927573
2014,40139,40,224,90,683,16,16,106,699,0.0537733671820909,0.151645207439199
2014,40141,14,198,33,93,0,4,33,97,0.0185645933014354,0.34020618556701
2014,40143,2425,9943,3120,9558,403,1229,3523,10787,0.0269463471175128,0.326596829517011
2014,40145,585,2774,262,796,5,66,267,862,0.0173941118308211,0.309744779582367
2014,40147,244,1119,316,990,136,223,452,1213,0.0345869806963018,0.372629843363561
2014,40149,31,285,21,105,7,15,28,120,0.0155078831739468,0.233333333333333
2014,40151,43,472,67,96,0,0,67,96,0.0169312169312169,0.697916666666667
2014,40153,104,622,23,317,0,39,23,356,0.0261630043360035,0.0646067415730337
2014,41001,149,538,80,307,0,10,80,317,0.0268144138047708,0.252365930599369
2014,41003,509,1428,1057,1487,446,558,1503,2045,0.0397411481207975,0.734963325183374
2014,41005,3629,10923,2605,6176,387,784,2992,6960,0.0261557771948681,0.429885057471264
2014,41007,263,909,469,1374,0,36,469,1410,0.0528545188739364,0.332624113475177
2014,41009,206,1034,248,913,35,60,283,973,0.0283062780008146,0.290853031860226
2014,41011,194,1028,316,1222,29,49,345,1271,0.0275018933246781,0.271439811172305
2014,41013,81,738,23,273,0,0,23,273,0.0177873338545739,0.0842490842490843
2014,41015,17,248,209,1171,0,21,209,1192,0.0678081802150293,0.175335570469799
2014,41017,828,2886,1797,4028,111,157,1908,4185,0.036347371438001,0.455913978494624
2014,41019,252,1849,438,2017,16,176,454,2193,0.0281150241663568,0.207022343821249
2014,41021,3,71,9,20,0,0,9,20,0.0139958012596221,0.45
2014,41023,15,193,38,154,0,3,38,157,0.0284060068753392,0.24203821656051
2014,41025,26,198,31,122,10,26,41,148,0.0284014584532719,0.277027027027027
2014,41027,87,244,153,446,16,16,169,462,0.0306345733041575,0.365800865800866
2014,41029,497,3423,1448,5257,143,380,1591,5637,0.0388137600528809,0.282242327479156
2014,41031,24,1002,80,377,2,12,82,389,0.0267703530383318,0.210796915167095
2014,41033,199,1024,415,2052,20,114,435,2166,0.0358217841431548,0.200831024930748
2014,41035,254,1021,295,1300,7,176,302,1476,0.032371260636898,0.204607046070461
2014,41037,20,290,92,206,7,7,99,213,0.0360589131538852,0.464788732394366
2014,41039,1130,4174,2349,6595,566,1174,2915,7769,0.0324523699127391,0.375209164628652
2014,41041,288,829,271,1035,22,31,293,1066,0.0303556681948914,0.274859287054409
2014,41043,602,2902,343,1382,54,196,397,1578,0.0196236926865059,0.251584283903676
2014,41045,28,786,82,599,0,42,82,641,0.0320131848374369,0.12792511700468
2014,41047,1471,7021,1089,3858,156,702,1245,4560,0.0220919529092583,0.273026315789474
2014,41049,24,256,12,212,0,0,12,212,0.0298507462686567,0.0566037735849057
2014,41051,5818,15220,10801,19840,2355,4211,13156,24051,0.0447953839391479,0.547004282566213
2014,41053,583,2421,243,1068,71,177,314,1245,0.0257300514601029,0.252208835341365
2014,41055,3,50,21,71,0,5,21,76,0.0580152671755725,0.276315789473684
2014,41057,55,517,60,328,18,25,78,353,0.0187576385567777,0.220963172804533
2014,41059,187,1601,227,1230,45,81,272,1311,0.0265180630284397,0.207475209763539
2014,41061,99,416,89,362,0,9,89,371,0.0217378566824867,0.23989218328841
2014,41063,47,176,38,117,0,4,38,121,0.0230081764594029,0.31404958677686
2014,41065,98,454,183,621,25,52,208,673,0.0382125823302294,0.309063893016345
2014,41067,4344,11441,5941,12298,1822,2906,7763,15204,0.041566650445357,0.510589318600368
2014,41069,2,67,0,11,0,0,0,11,0.0102040816326531,0
2014,41071,718,2933,670,1861,38,206,708,2067,0.0315230818502082,0.342525399129173
2014,42001,193,1282,353,1318,33,135,386,1453,0.020780595243203,0.265657260839642
2014,42003,4623,10103,8387,14784,2625,3794,11012,18578,0.0213062431260472,0.592744105931747
2014,42005,172,1056,49,268,5,51,54,319,0.00640678034182884,0.169278996865204
2014,42007,843,2904,420,1318,14,118,434,1436,0.0117147984989395,0.302228412256267
2014,42009,67,300,97,385,0,26,97,411,0.0116200169635284,0.236009732360097
2014,42011,1083,5030,620,3148,187,766,807,3914,0.0142100944677205,0.206182933060807
2014,42013,210,1115,164,687,18,70,182,757,0.00853939175164696,0.240422721268164
2014,42015,69,381,172,712,14,40,186,752,0.0171243794689621,0.247340425531915
2014,42017,2568,7626,3136,6600,628,1234,3764,7834,0.0178389259299741,0.480469747255553
2014,42019,1885,3589,606,1340,147,240,753,1580,0.0123144070768871,0.476582278481013
2014,42021,317,1736,262,1007,35,166,297,1173,0.0117020321431778,0.253196930946292
2014,42023,34,104,4,22,0,0,4,22,0.00589654248190834,0.181818181818182
2014,42025,254,1253,30,582,43,55,73,637,0.013466661029132,0.114599686028257
2014,42027,716,2350,1232,1998,719,966,1951,2964,0.0334862281672956,0.658232118758435
2014,42029,3766,7060,3256,5770,1063,1824,4319,7594,0.0224110963553195,0.568738477745589
2014,42031,85,439,43,248,7,38,50,286,0.0110741113606443,0.174825174825175
2014,42033,172,1815,162,915,16,125,178,1040,0.0175474117567659,0.171153846153846
2014,42035,174,612,57,172,12,51,69,223,0.0088848161281326,0.309417040358744
2014,42037,231,778,167,399,41,62,208,461,0.0105248738613274,0.45119305856833
2014,42039,213,1268,192,679,39,101,231,780,0.0129783693843594,0.296153846153846
2014,42041,1317,6301,1278,2513,466,631,1744,3144,0.0189947981802693,0.55470737913486
2014,42043,1544,5589,1380,3620,371,882,1751,4502,0.024249410193155,0.388938249666815
2014,42045,3107,7955,2400,4857,619,1356,3019,6213,0.0166020452608148,0.485916626428456
2014,42047,0,183,33,66,0,19,33,85,0.00366331939835366,0.388235294117647
2014,42049,655,2312,1292,2777,210,474,1502,3251,0.0174574705730733,0.462011688711166
2014,42051,248,1736,149,861,24,94,173,955,0.0097445996551126,0.181151832460733
2014,42053,25,449,23,68,0,19,23,87,0.0141119221411192,0.264367816091954
2014,42055,256,1453,466,1945,142,292,608,2237,0.0215120975497173,0.27179257934734
2014,42057,33,294,23,78,3,8,26,86,0.00825890713531163,0.302325581395349
2014,42059,160,1046,124,408,0,37,124,445,0.0164528413502422,0.278651685393258
2014,42061,114,1101,76,206,81,101,157,307,0.0094004531814563,0.511400651465798
2014,42063,352,1049,231,688,105,154,336,842,0.0149266960945948,0.399049881235154
2014,42065,82,759,31,242,0,17,31,259,0.00818351290720086,0.11969111969112
2014,42067,22,287,9,42,5,49,14,91,0.00529223611514975,0.153846153846154
2014,42069,730,2243,540,1850,216,495,756,2345,0.015675343253252,0.322388059701493
2014,42071,1714,5204,1603,3632,370,959,1973,4591,0.0132143628121177,0.429753866260074
2014,42073,124,673,173,539,3,106,176,645,0.0101224105461394,0.272868217054264
2014,42075,583,2481,170,865,67,445,237,1310,0.0141461044220075,0.180916030534351
2014,42077,1897,6450,1620,4083,496,1678,2116,5761,0.0239330655178574,0.367297344211074
2014,42079,909,3697,689,2543,133,646,822,3189,0.0140629547639417,0.257761053621825
2014,42081,243,1653,332,1293,11,31,343,1324,0.0165037893897088,0.259063444108761
2014,42083,68,510,111,474,0,25,111,499,0.0164882368490616,0.222444889779559
2014,42085,230,1207,313,1199,11,67,324,1266,0.0157735388295685,0.255924170616114
2014,42087,51,475,40,156,0,37,40,193,0.00591425857261055,0.207253886010363
2014,42089,359,1602,675,2490,52,180,727,2670,0.0237557164973219,0.272284644194757
2014,42091,7889,16707,4541,8023,1921,2839,6462,10862,0.019251424094942,0.594918062971828
2014,42093,241,621,71,178,6,40,77,218,0.0163663663663664,0.353211009174312
2014,42095,1512,4635,1414,3883,183,697,1597,4580,0.0222639198109997,0.348689956331878
2014,42097,385,2034,90,457,30,146,120,603,0.00884903805233113,0.199004975124378
2014,42099,183,855,65,199,4,67,69,266,0.00835847159376571,0.259398496240602
2014,42101,5211,11954,10407,17084,3713,8530,14120,25614,0.0253651174674098,0.551261029124697
2014,42103,139,589,371,1234,38,48,409,1282,0.0317775078700146,0.319032761310452
2014,42105,54,196,27,234,0,4,27,238,0.0192509908598237,0.113445378151261
2014,42107,279,2092,159,926,26,232,185,1158,0.0107903613559701,0.159758203799655
2014,42109,82,509,41,216,12,85,53,301,0.0114348668464841,0.176079734219269
2014,42111,241,1332,62,488,13,59,75,547,0.00963571025930102,0.137111517367459
2014,42113,33,125,22,50,0,0,22,50,0.0101255569056298,0.44
2014,42115,62,536,92,611,3,41,95,652,0.0211235663837232,0.145705521472393
2014,42117,62,455,145,449,5,26,150,475,0.0162765993900559,0.315789473684211
2014,42119,360,1176,230,1320,9,122,239,1442,0.0472183110121484,0.165742024965326
2014,42121,241,986,78,329,0,35,78,364,0.00934603435437903,0.214285714285714
2014,42123,123,669,82,377,13,18,95,395,0.0131675445029669,0.240506329113924
2014,42125,1082,3299,819,2152,71,314,890,2466,0.0167034693905198,0.360908353609084
2014,42127,227,2161,260,963,30,46,290,1009,0.0260750465164358,0.287413280475719
2014,42129,1280,5054,787,1818,57,327,844,2145,0.00811393554244213,0.393473193473193
2014,42131,65,404,52,221,7,7,59,228,0.0115612798539628,0.258771929824561
2014,42133,1301,5269,1491,4636,279,1010,1770,5646,0.0187605291226811,0.313496280552604
2014,44001,437,810,318,635,58,92,376,727,0.0214460603557627,0.517193947730399
2014,44003,1204,3974,921,1872,192,305,1113,2177,0.0181989934961796,0.511254019292605
2014,44005,440,845,2603,3623,240,429,2843,4052,0.0685919355384772,0.701628825271471
2014,44007,1141,3738,4004,7907,1428,3153,5432,11060,0.0263946065270569,0.491139240506329
2014,44009,801,1619,805,1565,76,181,881,1746,0.0206527010562922,0.504581901489118
2014,45001,109,558,13,118,11,23,24,141,0.00826688555347092,0.170212765957447
2014,45003,266,1389,1133,3758,104,318,1237,4076,0.0364530698027993,0.303483807654563
2014,45005,53,407,0,63,0,0,0,63,0.00906735751295337,0
2014,45007,567,2647,492,2258,235,565,727,2823,0.0219090267052642,0.257527453064116
2014,45009,16,84,78,157,0,24,78,181,0.018074695426403,0.430939226519337
2014,45011,0,174,43,174,0,0,43,174,0.0120149150669797,0.247126436781609
2014,45013,411,1590,3898,8314,327,927,4225,9241,0.0787849335856907,0.457201601558273
2014,45015,1587,5408,1274,4719,202,392,1476,5111,0.0418094809603665,0.288788886714929
2014,45017,22,303,0,97,0,0,0,97,0.00905188503172826,0
2014,45019,1934,6770,5360,9617,479,708,5839,10325,0.0412308970166002,0.565520581113801
2014,45021,161,794,76,518,0,5,76,523,0.014281033258697,0.145315487571702
2014,45023,47,345,129,317,0,48,129,365,0.0164436635581385,0.353424657534247
2014,45025,238,602,134,422,0,117,134,539,0.0172402763561924,0.24860853432282
2014,45027,141,1007,26,403,0,38,26,441,0.0187181663837012,0.0589569160997732
2014,45029,246,734,48,216,0,15,48,231,0.00891238087889193,0.207792207792208
2014,45031,190,1142,108,630,0,28,108,658,0.0143498931390936,0.164133738601824
2014,45033,15,445,7,143,18,18,25,161,0.00788867656426086,0.15527950310559
2014,45035,882,4261,905,3306,138,301,1043,3607,0.0388697910492796,0.289159966731356
2014,45037,165,833,86,489,46,213,132,702,0.0370722433460076,0.188034188034188
2014,45039,54,453,26,104,29,45,55,149,0.00895971136500301,0.369127516778524
2014,45041,432,1956,347,1453,10,78,357,1531,0.0168156755925576,0.233180927498367
2014,45043,258,1268,419,996,78,182,497,1178,0.0270195880544979,0.421901528013582
2014,45045,1996,6289,3735,9161,610,1302,4345,10463,0.0335611802706578,0.415272866290739
2014,45047,399,1590,189,790,27,128,216,918,0.0199422153672365,0.235294117647059
2014,45049,49,270,19,324,0,0,19,324,0.0231065468549422,0.058641975308642
2014,45051,575,2756,2461,9843,320,1231,2781,11074,0.0549035939692314,0.251128770092108
2014,45053,55,879,123,493,0,13,123,506,0.029045404971012,0.243083003952569
2014,45055,206,1420,215,647,8,59,223,706,0.016624281812188,0.31586402266289
2014,45057,88,686,265,1376,46,143,311,1519,0.0274579273693534,0.204739960500329
2014,45059,212,1519,125,411,0,72,125,483,0.0108300820664604,0.25879917184265
2014,45061,5,521,0,114,0,10,0,124,0.00981245548785313,0
2014,45063,1754,5848,1040,3486,294,730,1334,4216,0.023109093998542,0.316413662239089
2014,45065,18,305,109,196,24,27,133,223,0.0277916251246261,0.596412556053812
2014,45067,9,210,21,263,0,0,21,263,0.0120267056886775,0.0798479087452472
2014,45069,42,927,28,515,0,24,28,539,0.027063667403093,0.051948051948052
2014,45071,114,846,20,374,22,55,42,429,0.0168970814132104,0.0979020979020979
2014,45073,254,996,323,1102,13,121,336,1223,0.0230528538038151,0.274734260016353
2014,45075,357,1093,192,573,5,37,197,610,0.0102340407683919,0.322950819672131
2014,45077,537,2130,610,1596,175,265,785,1861,0.025281204151497,0.421816227834498
2014,45079,2192,9208,3551,8439,646,1337,4197,9776,0.0401574091570066,0.429316693944354
2014,45081,40,294,65,259,0,81,65,340,0.0247488717426117,0.191176470588235
2014,45083,849,4180,1012,3291,328,821,1340,4112,0.0215467326203489,0.325875486381323
2014,45085,162,1151,551,1533,63,357,614,1890,0.027395671773761,0.324867724867725
2014,45087,98,503,36,203,0,9,36,212,0.0107368954165612,0.169811320754717
2014,45089,36,501,22,253,43,93,65,346,0.015023229560158,0.187861271676301
2014,45091,704,2003,2443,6051,118,293,2561,6344,0.040988796567899,0.403688524590164
2014,46003,6,72,3,3,0,16,3,19,0.0102813852813853,0.157894736842105
2014,46005,64,192,38,263,51,126,89,389,0.0321593915343915,0.22879177377892
2014,46007,2,72,24,34,0,0,24,34,0.0180084745762712,0.705882352941177
2014,46009,30,375,7,52,0,1,7,53,0.0103253458016754,0.132075471698113
2014,46011,239,633,214,573,28,72,242,645,0.0380441193818568,0.375193798449612
2014,46013,298,758,184,633,21,33,205,666,0.0268678392770695,0.307807807807808
2014,46015,14,49,8,17,0,2,8,19,0.00527484730705164,0.421052631578947
2014,46017,0,7,16,16,0,0,16,16,0.0155189136760427,1
2014,46019,163,434,0,102,22,26,22,128,0.0184331797235023,0.171875
2014,46021,1,3,7,28,0,0,7,28,0.0264900662251656,0.25
2014,46023,37,146,41,117,0,0,41,117,0.0203125,0.35042735042735
2014,46025,5,119,17,33,0,0,17,33,0.0130900436334788,0.515151515151515
2014,46027,9,155,180,310,6,75,186,385,0.054617676266137,0.483116883116883
2014,46029,96,520,80,301,0,0,80,301,0.0164409001529386,0.26578073089701
2014,46031,9,39,11,47,1,1,12,48,0.0207882200086618,0.25
2014,46033,26,178,41,203,5,5,46,208,0.0322330698899737,0.221153846153846
2014,46035,62,594,155,282,0,30,155,312,0.0240740740740741,0.496794871794872
2014,46037,10,156,4,76,8,8,12,84,0.0207151664611591,0.142857142857143
2014,46039,13,52,28,78,0,0,28,78,0.0255737704918033,0.358974358974359
2014,46041,28,87,5,14,0,0,5,14,0.0046265697290152,0.357142857142857
2014,46043,5,83,20,23,0,1,20,24,0.0113100848256362,0.833333333333333
2014,46045,1,63,9,21,6,8,15,29,0.0101045296167247,0.517241379310345
2014,46047,12,87,57,355,0,0,57,355,0.0659851301115242,0.16056338028169
2014,46049,17,61,9,45,0,2,9,47,0.0297656744775174,0.191489361702128
2014,46051,4,113,5,50,0,0,5,50,0.00982318271119843,0.1
2014,46053,4,60,17,60,0,0,17,60,0.019672131147541,0.283333333333333
2014,46055,6,20,24,33,0,0,24,33,0.0220146764509673,0.727272727272727
2014,46057,34,127,2,77,0,0,2,77,0.020952380952381,0.025974025974026
2014,46059,44,57,3,25,0,0,3,25,0.0102249488752556,0.12
2014,46061,9,43,0,53,0,0,0,53,0.0256038647342995,0
2014,46063,2,2,19,24,0,0,19,24,0.028673835125448,0.791666666666667
2014,46065,124,672,126,338,0,6,126,344,0.0284838950070382,0.366279069767442
2014,46067,36,130,22,49,0,0,22,49,0.00954979536152797,0.448979591836735
2014,46069,2,17,6,14,0,0,6,14,0.0136319376825706,0.428571428571429
2014,46071,0,30,13,56,0,0,13,56,0.0306849315068493,0.232142857142857
2014,46073,23,74,2,2,0,13,2,15,0.0101351351351351,0.133333333333333
2014,46075,0,9,0,0,0,0,0,0,0,NA
2014,46077,30,104,34,104,0,7,34,111,0.0300243440627536,0.306306306306306
2014,46079,68,199,31,155,5,10,36,165,0.0209683568433092,0.218181818181818
2014,46081,102,358,172,499,52,102,224,601,0.0362113634994276,0.372712146422629
2014,46083,828,2449,310,766,0,31,310,797,0.0257196334064799,0.388958594730238
2014,46085,23,55,9,33,0,0,9,33,0.0137672090112641,0.272727272727273
2014,46087,17,147,5,102,0,11,5,113,0.0295966474594028,0.0442477876106195
2014,46089,0,109,0,84,0,4,0,88,0.0491071428571429,0
2014,46091,43,149,0,68,5,16,5,84,0.0265654648956357,0.0595238095238095
2014,46093,172,843,112,665,16,134,128,799,0.0474071437047585,0.160200250312891
2014,46095,0,12,0,15,0,7,0,22,0.0181368507831822,0
2014,46097,13,54,11,22,0,0,11,22,0.0134886572654813,0.5
2014,46099,768,2700,1016,2664,62,368,1078,3032,0.02642542139483,0.355540897097625
2014,46101,19,122,25,43,5,19,30,62,0.0145779449800141,0.483870967741935
2014,46103,413,1701,685,2765,150,278,835,3043,0.0437438905180841,0.274400262898455
2014,46105,22,33,20,142,3,5,23,147,0.0655664585191793,0.156462585034014
2014,46107,3,18,7,19,0,0,7,19,0.0108385624643468,0.368421052631579
2014,46109,19,70,42,158,0,0,42,158,0.0241147741147741,0.265822784810127
2014,46111,0,45,3,33,0,0,3,33,0.0194231901118305,0.0909090909090909
2014,46113,10,79,32,107,0,0,32,107,0.0153559127439724,0.299065420560748
2014,46115,35,173,3,69,12,27,15,96,0.021357063403782,0.15625
2014,46117,50,177,0,9,0,0,0,9,0.00444005920078934,0
2014,46119,7,7,2,13,0,8,2,21,0.0208747514910537,0.0952380952380952
2014,46121,0,113,48,79,0,10,48,89,0.0185842555857173,0.539325842696629
2014,46123,0,16,4,61,0,0,4,61,0.0155097889651665,0.0655737704918033
2014,46125,26,136,19,72,4,5,23,77,0.0131917080692136,0.298701298701299
2014,46127,86,218,304,680,0,0,304,680,0.0685345696432171,0.447058823529412
2014,46129,12,117,51,100,67,67,118,167,0.0422357106727365,0.706586826347305
2014,46135,42,332,115,608,0,7,115,615,0.0390873268081861,0.186991869918699
2014,46137,12,52,3,25,0,0,3,25,0.016857720836143,0.12
2014,47001,239,1704,338,933,223,348,561,1281,0.0240861913357401,0.437939110070258
2014,47003,102,810,46,460,5,15,51,475,0.0160105163812862,0.107368421052632
2014,47005,22,209,49,112,9,9,58,121,0.0100917431192661,0.479338842975207
2014,47007,39,729,0,148,0,0,0,148,0.0155347958433925,0
2014,47009,496,2390,527,1906,46,107,573,2013,0.0230452203777905,0.284649776453055
2014,47011,311,1152,304,1594,15,136,319,1730,0.0255992897306896,0.184393063583815
2014,47013,21,305,42,586,0,14,42,600,0.0209753539590981,0.07
2014,47015,94,686,30,126,0,10,30,136,0.0140133951571355,0.220588235294118
2014,47017,58,437,22,255,0,11,22,266,0.013611708115853,0.0827067669172932
2014,47019,259,1200,51,461,35,67,86,528,0.0129294512329505,0.162878787878788
2014,47021,257,1193,157,368,0,7,157,375,0.0140623242209472,0.418666666666667
2014,47023,93,419,27,297,0,64,27,361,0.0332473752072205,0.074792243767313
2014,47025,174,390,123,526,11,60,134,586,0.0261829230150574,0.228668941979522
2014,47027,0,210,0,80,2,8,2,88,0.0156695156695157,0.0227272727272727
2014,47029,59,435,60,513,0,30,60,543,0.0214514281199384,0.110497237569061
2014,47031,224,1358,189,669,21,22,210,691,0.0191853846794569,0.303907380607815
2014,47033,64,389,7,49,0,0,7,49,0.00495149555375909,0.142857142857143
2014,47035,123,814,177,1015,18,47,195,1062,0.0248415241748731,0.18361581920904
2014,47037,4233,11384,7456,14701,1421,3198,8877,17899,0.0409753127117558,0.495949494385161
2014,47039,29,260,0,121,0,0,0,121,0.0143517969398648,0
2014,47041,82,551,20,67,0,13,20,80,0.0060560181680545,0.25
2014,47043,126,890,209,551,0,19,209,570,0.016877887006988,0.366666666666667
2014,47045,88,505,112,503,38,68,150,571,0.0222994610638132,0.262697022767075
2014,47047,219,879,105,455,26,88,131,543,0.0197167755991285,0.241252302025783
2014,47049,18,360,47,282,0,9,47,291,0.0230842455973346,0.161512027491409
2014,47051,255,788,81,460,32,135,113,595,0.0214051876101738,0.189915966386555
2014,47053,97,1070,66,391,5,17,71,408,0.0121298608633607,0.174019607843137
2014,47055,89,302,85,362,39,39,124,401,0.0198554169142404,0.309226932668329
2014,47057,34,518,85,309,20,23,105,332,0.0205661896797373,0.316265060240964
2014,47059,130,936,125,687,14,91,139,778,0.0159096950982597,0.17866323907455
2014,47061,7,177,18,56,0,2,18,58,0.00612008019415427,0.310344827586207
2014,47063,305,1385,113,773,43,157,156,930,0.0214765720619818,0.167741935483871
2014,47065,1090,3347,2269,7049,280,649,2549,7698,0.0324827944148835,0.331124967524032
2014,47067,20,147,2,52,0,19,2,71,0.0147762747138398,0.028169014084507
2014,47069,2,554,18,120,9,10,27,130,0.00697088315727385,0.207692307692308
2014,47071,21,324,95,402,0,0,95,402,0.0218016161397039,0.236318407960199
2014,47073,288,1366,217,792,15,18,232,810,0.0201122312161692,0.28641975308642
2014,47075,25,274,8,107,0,84,8,191,0.0154468257177517,0.0418848167539267
2014,47077,126,502,103,282,16,81,119,363,0.0190901919537207,0.327823691460055
2014,47079,20,343,23,368,12,12,35,380,0.0164366970889744,0.0921052631578947
2014,47081,0,1066,40,220,0,9,40,229,0.0135760018970832,0.174672489082969
2014,47083,33,254,12,55,5,12,17,67,0.011559696342305,0.253731343283582
2014,47085,68,473,0,121,0,100,0,221,0.0172575355302202,0
2014,47087,39,257,24,95,12,12,36,107,0.0127730691178226,0.336448598130841
2014,47089,163,1470,173,796,24,70,197,866,0.0240135318747747,0.227482678983834
2014,47091,32,593,7,199,15,27,22,226,0.0166323226376214,0.0973451327433628
2014,47093,1735,6331,3174,7026,447,707,3621,7733,0.0264560582423297,0.468252941937152
2014,47095,5,770,1,73,0,8,1,81,0.0142155142155142,0.0123456790123457
2014,47097,42,1235,23,218,0,22,23,240,0.0129954515919428,0.0958333333333333
2014,47099,49,447,42,369,9,54,51,423,0.0149761019649495,0.120567375886525
2014,47101,43,260,42,222,25,31,67,253,0.0299798554331082,0.264822134387352
2014,47103,39,353,127,665,11,42,138,707,0.0304846498792687,0.195190947666195
2014,47105,274,1356,275,708,7,58,282,766,0.0210520529874127,0.368146214099217
2014,47107,121,805,80,570,8,21,88,591,0.0162362637362637,0.148900169204738
2014,47109,19,173,9,272,3,35,12,307,0.0168329860730343,0.0390879478827362
2014,47111,18,554,13,209,0,96,13,305,0.0201679560933677,0.0426229508196721
2014,47113,533,1700,364,964,51,78,415,1042,0.0162302767869659,0.398272552783109
2014,47115,27,400,174,297,0,0,174,297,0.014858171994597,0.585858585858586
2014,47117,74,621,104,344,4,4,108,348,0.0165438554789636,0.310344827586207
2014,47119,496,2169,242,1039,38,253,280,1292,0.0229811454998221,0.21671826625387
2014,47121,10,180,15,249,0,0,15,249,0.029734893718653,0.0602409638554217
2014,47123,130,1045,74,697,0,16,74,713,0.0226622592333609,0.103786816269285
2014,47125,381,1426,2262,7343,589,1821,2851,9164,0.0834061453327508,0.311108686163247
2014,47127,44,277,0,3,0,0,0,3,0.000660938532716457,0
2014,47129,132,1465,0,197,0,3,0,200,0.0129007288911824,0
2014,47131,65,555,32,463,0,0,32,463,0.0212942096306857,0.0691144708423326
2014,47133,37,404,36,119,0,33,36,152,0.00997440776953868,0.236842105263158
2014,47135,8,132,2,57,2,3,4,60,0.0108715346983149,0.0666666666666667
2014,47137,16,91,0,19,0,0,0,19,0.00493891343904341,0
2014,47139,24,312,17,376,0,3,17,379,0.0318300159570001,0.0448548812664908
2014,47141,207,1129,143,626,174,286,317,912,0.0196133250177423,0.347587719298246
2014,47143,90,754,29,618,35,38,64,656,0.0302053596095405,0.0975609756097561
2014,47145,173,810,68,352,44,131,112,483,0.0124426812303571,0.231884057971014
2014,47147,327,1552,127,817,0,28,127,845,0.0189330286123995,0.150295857988166
2014,47149,1238,5102,1250,4031,445,910,1695,4941,0.029148722789216,0.343047965998786
2014,47151,33,277,49,200,0,11,49,211,0.0142500168839063,0.232227488151659
2014,47153,38,444,51,121,0,0,51,121,0.0120170821332804,0.421487603305785
2014,47155,205,2155,454,2039,28,211,482,2250,0.0347882554849483,0.214222222222222
2014,47157,1334,4689,5582,14782,1033,2014,6615,16796,0.0281194019855686,0.393843772326744
2014,47159,58,431,12,61,0,0,12,61,0.00467647960748237,0.19672131147541
2014,47161,25,193,8,142,4,31,12,173,0.0185086123890018,0.069364161849711
2014,47163,485,2407,511,2838,75,213,586,3051,0.027030139801903,0.192068174369059
2014,47165,966,4309,806,2627,132,301,938,2928,0.0260827736107894,0.320355191256831
2014,47167,138,1531,152,1114,49,134,201,1248,0.0314587482039777,0.161057692307692
2014,47169,15,397,7,97,0,9,7,106,0.0199510634293243,0.0660377358490566
2014,47171,23,442,60,286,0,38,60,324,0.0243188471065075,0.185185185185185
2014,47173,8,258,20,71,0,4,20,75,0.00569822215468774,0.266666666666667
2014,47175,0,119,26,62,0,3,26,65,0.0161170344656583,0.4
2014,47177,45,485,105,361,0,94,105,455,0.0166587339362208,0.230769230769231
2014,47179,446,1890,700,1754,93,164,793,1918,0.0225955421516422,0.413451511991658
2014,47181,13,588,0,96,0,1,0,97,0.00791707476330395,0
2014,47183,123,776,69,335,7,31,76,366,0.0167674546454096,0.207650273224044
2014,47185,45,644,43,370,0,0,43,370,0.0203722057042176,0.116216216216216
2014,47187,2983,4910,2268,3905,334,521,2602,4426,0.035227073749224,0.587889742431089
2014,47189,967,3382,483,1662,53,260,536,1922,0.0237041056694992,0.278876170655567
2014,48001,158,3936,49,379,0,86,49,465,0.0111631256751891,0.105376344086022
2014,48003,0,557,10,138,0,25,10,163,0.0166666666666667,0.0613496932515337
2014,48005,402,2101,103,647,60,126,163,773,0.0137473545679276,0.210866752910737
2014,48007,234,1564,62,347,6,6,68,353,0.0200922078661278,0.192634560906516
2014,48009,19,159,13,42,0,0,13,42,0.006859382655561,0.30952380952381
2014,48011,0,58,12,18,0,0,12,18,0.013215859030837,0.666666666666667
2014,48013,157,1130,88,492,22,52,110,544,0.0186774703014489,0.202205882352941
2014,48015,112,693,66,176,0,57,66,233,0.0121651960528377,0.283261802575107
2014,48017,0,216,0,35,20,20,20,55,0.0129168623767027,0.363636363636364
2014,48019,126,957,32,155,0,37,32,192,0.0121719284899201,0.166666666666667
2014,48021,619,2999,127,501,141,188,268,689,0.0136785054892696,0.388969521044993
2014,48023,61,123,9,60,0,0,9,60,0.0222799851466766,0.15
2014,48025,234,3487,3,445,60,121,63,566,0.0256957370499841,0.1113074204947
2014,48027,1659,5447,2755,9768,742,3269,3497,13037,0.0682026251497507,0.26823655749022
2014,48029,7834,25258,9397,21864,3685,7814,13082,29678,0.0265532411363191,0.440797897432442
2014,48031,64,253,15,86,0,0,15,86,0.0109386924446706,0.174418604651163
2014,48033,9,57,0,0,0,2,0,2,0.0043859649122807,0
2014,48035,84,680,42,122,0,4,42,126,0.00985452839042703,0.333333333333333
2014,48037,176,1451,459,2218,33,101,492,2319,0.0371604839355821,0.212160413971539
2014,48039,2723,9840,1061,2464,270,645,1331,3109,0.0148443468296409,0.428111933097459
2014,48041,1232,5380,1637,2532,1135,1560,2772,4092,0.0406323231520833,0.67741935483871
2014,48043,161,412,39,146,0,3,39,149,0.0230151374729688,0.261744966442953
2014,48045,0,13,16,30,0,0,16,30,0.027124773960217,0.533333333333333
2014,48047,7,230,32,33,0,77,32,110,0.0239599215857112,0.290909090909091
2014,48049,184,955,21,92,0,27,21,119,0.00468098497364487,0.176470588235294
2014,48051,171,630,6,58,0,6,6,64,0.00538176925664312,0.09375
2014,48053,403,1728,34,292,0,85,34,377,0.0122617576270084,0.0901856763925729
2014,48055,183,2023,39,331,48,81,87,412,0.0167943909995108,0.211165048543689
2014,48057,130,443,1,48,56,101,57,149,0.0104021223122033,0.38255033557047
2014,48059,54,484,9,80,0,57,9,137,0.014419534785812,0.0656934306569343
2014,48061,640,2359,595,1925,324,1666,919,3591,0.0150934989933464,0.255917571707045
2014,48063,55,276,0,114,0,55,0,169,0.020771878072763,0
2014,48065,27,212,0,21,0,0,0,21,0.00507736943907157,0
2014,48067,84,495,36,340,0,65,36,405,0.0190185489551538,0.0888888888888889
2014,48069,22,155,0,66,0,41,0,107,0.0223943072415237,0
2014,48071,299,1024,25,347,0,4,25,351,0.0150889863296363,0.0712250712250712
2014,48073,210,1340,37,361,0,79,37,440,0.013331313437358,0.0840909090909091
2014,48075,16,388,47,123,0,1,47,124,0.0267702936096718,0.379032258064516
2014,48077,73,498,0,36,0,19,0,55,0.00731966994942774,0
2014,48079,6,69,0,10,0,7,0,17,0.00915455035002692,0
2014,48081,44,142,0,0,0,3,0,3,0.00123711340206186,0
2014,48083,17,167,0,6,0,8,0,14,0.00229170076935669,0
2014,48085,9767,22834,7596,13757,2674,4314,10270,18071,0.0335053314471018,0.568313873056278
2014,48087,16,88,0,39,0,0,0,39,0.0189965903555772,0
2014,48089,77,261,76,105,0,0,76,105,0.0073865634892719,0.723809523809524
2014,48091,1814,4916,510,1642,111,390,621,2032,0.0253155094870868,0.305610236220472
2014,48093,88,372,64,100,0,30,64,130,0.0138268453520528,0.492307692307692
2014,48095,0,242,0,170,16,245,16,415,0.128046899105214,0.0385542168674699
2014,48097,164,1015,213,558,15,59,228,617,0.0240742908424051,0.369529983792545
2014,48099,281,2799,293,2093,163,1106,456,3199,0.0691705587268639,0.142544545170366
2014,48101,9,22,0,6,0,0,0,6,0.00505050505050505,0
2014,48103,21,157,13,89,0,0,13,89,0.0314487632508834,0.146067415730337
2014,48105,0,103,0,4,0,13,0,17,0.0065359477124183,0
2014,48107,7,214,1,22,0,9,1,31,0.00810457516339869,0.032258064516129
2014,48109,18,48,0,26,0,3,0,29,0.018979057591623,0
2014,48111,51,260,12,60,5,97,17,157,0.0388229475766568,0.10828025477707
2014,48113,16643,44580,12088,25614,5148,11788,17236,37402,0.0242661504005647,0.460830971605797
2014,48115,46,591,13,202,0,32,13,234,0.0265577119509704,0.0555555555555556
2014,48117,52,475,14,107,0,28,14,135,0.012076214330441,0.103703703703704
2014,48119,40,213,0,13,0,0,0,13,0.0035901684617509,0
2014,48121,10190,25433,4980,11937,1707,3031,6687,14968,0.0334070603884843,0.446753073222875
2014,48123,74,1100,25,105,1,1,26,106,0.00739294183289162,0.245283018867925
2014,48125,2,120,0,10,0,21,0,31,0.0182675309369476,0
2014,48127,35,407,0,52,0,0,0,52,0.00810979413599501,0
2014,48129,12,57,19,43,0,0,19,43,0.0175224123879381,0.441860465116279
2014,48131,28,589,0,27,0,0,0,27,0.00363636363636364,0
2014,48133,41,476,0,101,12,30,12,131,0.0105492027701723,0.0916030534351145
2014,48135,629,3343,272,1896,156,553,428,2449,0.0284044120205523,0.174765210289914
2014,48137,7,26,19,39,0,0,19,39,0.0267123287671233,0.487179487179487
2014,48139,1024,4244,408,989,50,231,458,1220,0.0125617792421746,0.375409836065574
2014,48141,828,3381,3272,11894,1805,6564,5077,18458,0.037784669553024,0.275056885903131
2014,48143,214,787,129,353,0,20,129,373,0.016643612511713,0.345844504021448
2014,48145,133,658,0,54,0,17,0,71,0.00593248663101604,0
2014,48147,322,2239,58,493,25,56,83,549,0.0232883685416136,0.151183970856102
2014,48149,82,451,42,119,7,71,49,190,0.0107308257087993,0.257894736842105
2014,48151,20,69,0,2,0,0,0,2,0.000748222970445193,0
2014,48153,4,80,0,4,8,8,8,12,0.00297176820208024,0.666666666666667
2014,48155,0,73,0,5,0,0,0,5,0.00559910414333707,0
2014,48157,6665,16243,3314,6219,1893,3874,5207,10093,0.0252911121524132,0.515902110373526
2014,48159,90,308,9,48,0,0,9,48,0.00658165364047717,0.1875
2014,48161,101,873,66,176,0,22,66,198,0.0145299772510457,0.333333333333333
2014,48163,170,843,0,41,0,538,0,579,0.0527034407427635,0
2014,48165,119,381,0,174,0,158,0,332,0.0319969159599075,0
2014,48167,3462,10227,1242,3377,359,705,1601,4082,0.0204344191308614,0.392209701126899
2014,48169,22,336,73,642,0,146,73,788,0.163214581607291,0.0926395939086294
2014,48171,331,771,46,242,0,75,46,317,0.0171342089616777,0.145110410094637
2014,48173,3,6,0,6,0,0,0,6,0.0072463768115942,0
2014,48175,54,267,4,130,0,10,4,140,0.0263703145601808,0.0285714285714286
2014,48177,89,466,0,91,0,14,0,105,0.00814837808474313,0
2014,48179,159,1273,25,189,0,25,25,214,0.0140715412940558,0.116822429906542
2014,48181,562,2709,182,1567,60,105,242,1672,0.0204979833024801,0.144736842105263
2014,48183,708,3626,270,1073,87,373,357,1446,0.0184126418193626,0.246887966804979
2014,48185,172,1523,35,162,0,20,35,182,0.00983943342163594,0.192307692307692
2014,48187,1141,4152,411,1484,143,255,554,1739,0.0193753969226655,0.318573893041978
2014,48189,207,2037,49,380,0,1,49,381,0.0176888434931984,0.128608923884514
2014,48191,29,156,0,17,0,0,0,17,0.0075354609929078,0
2014,48193,69,271,0,64,0,0,0,64,0.0107023411371237,0
2014,48195,15,143,0,88,0,0,0,88,0.0254335260115607,0
2014,48197,2,131,0,9,0,0,0,9,0.00314245810055866,0
2014,48199,142,1363,44,252,9,53,53,305,0.00829390330124545,0.173770491803279
2014,48201,17916,52016,20538,46528,13506,27113,34044,73641,0.0276022984111277,0.462296818348474
2014,48203,243,1443,232,686,26,86,258,772,0.0178447598354214,0.33419689119171
2014,48205,32,479,51,145,2,2,53,147,0.0319843342036554,0.360544217687075
2014,48207,37,453,0,74,0,84,0,158,0.0367441860465116,0
2014,48209,2287,7539,746,1684,174,472,920,2156,0.0218064124608071,0.426716141001855
2014,48211,13,114,4,45,0,0,4,45,0.0178217821782178,0.0888888888888889
2014,48213,410,2235,131,895,42,233,173,1128,0.0205715536264658,0.153368794326241
2014,48215,1100,6312,569,4512,711,3891,1280,8403,0.0189668131555604,0.152326550041652
2014,48217,146,1016,57,282,2,29,59,311,0.0131013564748505,0.189710610932476
2014,48219,199,979,0,204,29,38,29,242,0.0172192969972961,0.119834710743802
2014,48221,465,1709,96,423,11,294,107,717,0.018977793070591,0.149232914923291
2014,48223,168,908,161,428,0,29,161,457,0.0193824751887353,0.352297592997812
2014,48225,56,1001,43,191,0,5,43,196,0.0116093111413848,0.219387755102041
2014,48227,132,1362,47,597,18,107,65,704,0.0292504570383912,0.0923295454545455
2014,48229,0,56,0,65,0,104,0,169,0.0776654411764706,0
2014,48231,467,2914,194,806,82,397,276,1203,0.0210395606701878,0.229426433915212
2014,48233,90,393,42,262,0,0,42,262,0.0180677194676229,0.16030534351145
2014,48235,4,28,0,44,0,0,0,44,0.0398190045248869,0
2014,48237,17,848,0,133,0,35,0,168,0.0272948822095857,0
2014,48239,25,332,49,161,0,8,49,169,0.0177353342428377,0.289940828402367
2014,48241,49,659,6,110,12,33,18,143,0.00592819832518033,0.125874125874126
2014,48243,36,96,23,23,0,0,23,23,0.0130681818181818,1
2014,48245,1136,6945,678,2709,104,412,782,3121,0.0187971283336144,0.25056071771868
2014,48247,6,82,0,1,0,1,0,2,0.000595238095238095,0
2014,48249,155,926,0,192,6,60,6,252,0.00986417191842486,0.0238095238095238
2014,48251,871,4660,110,804,13,260,123,1064,0.0107139260900211,0.115601503759398
2014,48253,59,2422,1,331,0,27,1,358,0.0245777838802691,0.00279329608938547
2014,48255,61,797,0,107,0,70,0,177,0.0171928120446819,0
2014,48257,739,4068,133,958,90,277,223,1235,0.0180708788153698,0.180566801619433
2014,48259,421,1812,303,576,0,50,303,626,0.0252185473149901,0.484025559105431
2014,48261,0,1,0,0,0,0,0,0,0,NA
2014,48263,17,45,0,11,0,0,0,11,0.0181818181818182,0
2014,48265,512,1972,222,509,53,80,275,589,0.016433234752525,0.466893039049236
2014,48267,64,157,0,14,0,0,0,14,0.00402645959160196,0
2014,48269,0,0,0,0,0,0,0,0,0,NA
2014,48271,12,154,63,87,0,128,63,215,0.084280674245394,0.293023255813953
2014,48273,404,738,121,194,0,0,121,194,0.010830728003573,0.623711340206186
2014,48275,17,223,0,12,0,0,0,12,0.0046260601387818,0
2014,48277,165,1266,54,526,32,86,86,612,0.0185017231997098,0.140522875816993
2014,48279,21,444,7,182,25,105,32,287,0.0331217541834968,0.111498257839721
2014,48281,142,585,8,110,45,97,53,207,0.0152116402116402,0.256038647342995
2014,48283,31,491,11,44,0,104,11,148,0.0335524824302879,0.0743243243243243
2014,48285,101,598,3,23,0,6,3,29,0.00212221002561288,0.103448275862069
2014,48287,76,510,10,83,0,15,10,98,0.0088808337109198,0.102040816326531
2014,48289,77,384,0,66,0,28,0,94,0.00795329554107792,0
2014,48291,367,5570,59,440,71,138,130,578,0.0115208291807853,0.224913494809689
2014,48293,42,730,26,141,0,91,26,232,0.0144945645382981,0.112068965517241
2014,48295,20,132,5,71,0,0,5,71,0.0325389550870761,0.0704225352112676
2014,48297,81,385,10,98,16,102,26,200,0.0235128144838937,0.13
2014,48299,280,672,12,126,0,13,12,139,0.00930762019552699,0.0863309352517986
2014,48301,0,0,0,7,0,0,0,7,0.0921052631578947,0
2014,48303,1663,6233,1190,3084,424,621,1614,3705,0.0220613191537504,0.435627530364372
2014,48305,37,209,12,38,2,5,14,43,0.0112653916688499,0.325581395348837
2014,48307,21,380,0,8,0,0,0,8,0.0013729191693839,0
2014,48309,1231,4373,755,2024,117,405,872,2429,0.0168089906301468,0.358995471387402
2014,48311,0,8,0,0,0,0,0,0,0,NA
2014,48313,71,801,4,7,0,9,4,16,0.00174863387978142,0.25
2014,48315,123,380,10,157,0,6,10,163,0.02079877504147,0.0613496932515337
2014,48317,66,218,0,1,0,2,0,3,0.000996346728661574,0
2014,48319,30,155,11,11,0,0,11,11,0.003584229390681,1
2014,48321,75,840,48,183,14,52,62,235,0.00984829435923225,0.263829787234043
2014,48323,9,749,23,281,25,369,48,650,0.0207138304652645,0.0738461538461539
2014,48325,265,1600,21,205,0,19,21,224,0.00727083874318359,0.09375
2014,48327,4,80,0,25,0,0,0,25,0.0168463611859838,0
2014,48329,1032,3564,692,2427,145,320,837,2747,0.0301268904706024,0.304696032034947
2014,48331,125,994,72,138,0,41,72,179,0.0109594073348436,0.402234636871508
2014,48333,27,78,0,4,12,12,12,16,0.00484848484848485,0.75
2014,48335,91,988,0,35,0,27,0,62,0.00981789390340459,0
2014,48337,129,679,26,29,10,57,36,86,0.00629252945050121,0.418604651162791
2014,48339,4707,13951,3137,7847,1245,2434,4382,10281,0.0326830214230991,0.426223130045715
2014,48341,167,762,18,223,0,27,18,250,0.0193363755897595,0.072
2014,48343,19,476,0,50,7,36,7,86,0.00968141393673309,0.0813953488372093
2014,48345,7,27,0,13,0,0,0,13,0.0174966352624495,0
2014,48347,408,1229,89,481,14,91,103,572,0.0155219668394345,0.18006993006993
2014,48349,101,1032,87,297,9,20,96,317,0.0102532587249733,0.302839116719243
2014,48351,87,763,0,16,0,5,0,21,0.00216182828906733,0
2014,48353,8,321,6,132,0,18,6,150,0.0153956686852099,0.04
2014,48355,1841,7726,1515,4141,297,682,1812,4823,0.021597005167519,0.375699771926187
2014,48357,48,221,31,215,7,7,38,222,0.035725780495655,0.171171171171171
2014,48359,14,63,0,12,0,0,0,12,0.00999167360532889,0
2014,48361,283,1786,192,722,59,158,251,880,0.0159901152015118,0.285227272727273
2014,48363,238,875,41,195,7,26,48,221,0.0117123323970534,0.217194570135747
2014,48365,47,426,0,109,0,18,0,127,0.00791030831516661,0
2014,48367,676,4406,379,1351,8,102,387,1453,0.0182061948676824,0.266345492085341
2014,48369,47,220,30,161,0,69,30,230,0.0378227265252426,0.130434782608696
2014,48371,48,1232,0,112,0,16,0,128,0.012183514182372,0
2014,48373,209,1807,65,270,23,191,88,461,0.0141129649471912,0.190889370932755
2014,48375,787,4790,257,1357,76,794,333,2151,0.0281869168675962,0.154811715481172
2014,48377,82,202,35,114,26,39,61,153,0.0316115702479339,0.398692810457516
2014,48379,7,436,0,13,0,0,0,13,0.00163234555499749,0
2014,48381,885,3845,370,1240,32,123,402,1363,0.0168288225997629,0.294937637564197
2014,48383,34,141,15,48,0,5,15,53,0.0231542158147663,0.283018867924528
2014,48385,51,236,0,8,0,0,0,8,0.00317208564631245,0
2014,48387,75,350,36,132,0,23,36,155,0.017146017699115,0.232258064516129
2014,48389,77,1134,7,244,0,179,7,423,0.046053347849755,0.016548463356974
2014,48391,10,283,0,18,0,0,0,18,0.00363342753330642,0
2014,48393,10,37,4,25,0,0,4,25,0.0387596899224806,0.16
2014,48395,173,523,17,73,0,10,17,83,0.00756195335276968,0.204819277108434
2014,48397,1068,2835,575,1230,43,67,618,1297,0.0242307620453229,0.476484194294526
2014,48399,8,101,0,15,0,4,0,19,0.00274924034148459,0
2014,48401,259,5020,6,260,13,20,19,280,0.00759136753063659,0.0678571428571429
2014,48403,16,165,24,80,0,8,24,88,0.0114464099895942,0.272727272727273
2014,48405,14,199,10,19,0,0,10,19,0.0029618082618862,0.526315789473684
2014,48407,114,1109,0,407,0,0,0,407,0.0220095176292451,0
2014,48409,321,2074,90,648,48,144,138,792,0.0191290486196652,0.174242424242424
2014,48411,14,362,0,85,0,0,0,85,0.0200518990327908,0
2014,48413,0,78,0,0,0,0,0,0,0,NA
2014,48415,97,834,6,68,0,23,6,91,0.00816070307595731,0.0659340659340659
2014,48417,12,66,1,9,16,21,17,30,0.0132216835610401,0.566666666666667
2014,48419,79,360,6,196,0,21,6,217,0.0131946977988569,0.0276497695852535
2014,48421,5,118,0,6,7,7,7,13,0.00661241098677518,0.538461538461538
2014,48423,1653,5684,1175,2503,165,481,1340,2984,0.0216418505812984,0.449061662198391
2014,48425,14,249,10,39,0,28,10,67,0.0117440841367222,0.149253731343284
2014,48427,40,538,27,275,40,448,67,723,0.0209759777184635,0.0926694329183956
2014,48429,83,513,14,93,28,28,42,121,0.0193290734824281,0.347107438016529
2014,48431,22,31,0,31,0,0,0,31,0.0345211581291759,0
2014,48433,0,36,0,3,0,0,0,3,0.0029585798816568,0
2014,48435,30,109,0,0,0,0,0,0,0,NA
2014,48437,11,417,3,21,0,0,3,21,0.00422110552763819,0.142857142857143
2014,48439,11116,35728,8536,22638,3028,7140,11564,29778,0.0251321891708268,0.388340385519511
2014,48441,583,3116,374,1332,42,472,416,1804,0.0222287939277441,0.23059866962306
2014,48443,12,39,0,0,0,5,0,5,0.00747384155455904,0
2014,48445,92,711,13,232,0,22,13,254,0.0315410406059853,0.0511811023622047
2014,48447,12,50,0,6,0,2,0,8,0.00709219858156028,0
2014,48449,123,682,73,441,12,80,85,521,0.0267907646423613,0.163147792706334
2014,48451,560,2817,836,2626,162,305,998,2931,0.0408786610878661,0.340498123507335
2014,48453,11169,25905,13290,21664,3671,6695,16961,28359,0.0397017503825418,0.598081737719948
2014,48455,21,626,24,128,0,21,24,149,0.014088502269289,0.161073825503356
2014,48457,90,843,35,132,0,0,35,132,0.00856419905274768,0.265151515151515
2014,48459,244,1415,47,332,0,8,47,340,0.0126737987848064,0.138235294117647
2014,48461,26,138,0,27,0,0,0,27,0.0131259115216334,0
2014,48463,81,543,0,191,0,44,0,235,0.01433626159102,0
2014,48465,201,784,127,546,53,333,180,879,0.0300718439958946,0.204778156996587
2014,48467,249,1298,8,204,10,44,18,248,0.00684043580195835,0.0725806451612903
2014,48469,302,1786,151,874,28,83,179,957,0.0166771225428691,0.187042842215256
2014,48471,403,4289,99,408,111,114,210,522,0.0117226975678771,0.402298850574713
2014,48473,156,1142,47,211,6,38,53,249,0.00994885727984657,0.21285140562249
2014,48475,58,350,0,54,0,0,0,54,0.00781702374059062,0
2014,48477,218,827,12,94,0,88,12,182,0.00800175862826995,0.0659340659340659
2014,48479,409,1927,186,1016,521,1963,707,2979,0.0211951533607018,0.237327962403491
2014,48481,19,436,22,157,27,102,49,259,0.00971092197517903,0.189189189189189
2014,48483,13,177,3,109,0,0,3,109,0.0290279627163782,0.0275229357798165
2014,48485,543,3300,394,2270,234,430,628,2700,0.0323970194742084,0.232592592592593
2014,48487,58,482,67,168,9,35,76,203,0.0234167724074288,0.374384236453202
2014,48489,23,1158,21,179,0,208,21,387,0.0284454244762955,0.0542635658914729
2014,48491,7849,19931,4319,10083,609,1835,4928,11918,0.040471889050381,0.413492196677295
2014,48493,186,1382,42,273,44,87,86,360,0.0120635346156424,0.238888888888889
2014,48495,81,302,23,123,9,31,32,154,0.0331968096572537,0.207792207792208
2014,48497,618,2139,72,479,0,100,72,579,0.0143868803578084,0.124352331606218
2014,48499,263,1856,98,410,0,39,98,449,0.0146727231136237,0.21826280623608
2014,48501,0,100,0,26,0,61,0,87,0.0181666318646899,0
2014,48503,40,336,44,170,0,18,44,188,0.0150568636873298,0.234042553191489
2014,48505,0,104,0,78,0,0,0,78,0.00988092221940714,0
2014,48507,12,386,0,25,0,30,0,55,0.00802919708029197,0
2014,49001,0,136,0,33,0,0,0,33,0.00870482722236877,0
2014,49003,264,960,104,639,5,36,109,675,0.0228689524325789,0.161481481481481
2014,49005,468,1270,497,1299,231,314,728,1613,0.0275971803996715,0.451332920024799
2014,49007,31,322,0,89,3,20,3,109,0.00825070017409734,0.0275229357798165
2014,49009,11,28,9,9,0,0,9,9,0.0176817288801572,1
2014,49011,2395,6445,1389,3704,396,740,1785,4444,0.0246034602076125,0.401665166516652
2014,49013,33,286,33,174,5,12,38,186,0.0167326376394386,0.204301075268817
2014,49015,27,242,50,240,0,0,50,240,0.0363912054586808,0.208333333333333
2014,49017,37,129,32,134,3,3,35,137,0.0406648857227664,0.255474452554745
2014,49019,1,59,108,235,0,2,108,237,0.0357089046255838,0.455696202531646
2014,49021,120,737,130,554,14,40,144,594,0.0237239396117901,0.242424242424242
2014,49023,5,126,0,94,13,15,13,109,0.0190160502442428,0.119266055045872
2014,49025,68,162,48,183,0,0,48,183,0.0367691380349608,0.262295081967213
2014,49027,134,256,33,180,1,28,34,208,0.0273180982400841,0.163461538461538
2014,49029,39,169,34,97,0,0,34,97,0.0172016314949459,0.350515463917526
2014,49031,5,13,11,30,0,0,11,30,0.0228484386900229,0.366666666666667
2014,49033,0,67,0,37,0,0,0,37,0.0269286754002911,0
2014,49035,4161,11011,7255,15887,1508,3307,8763,19194,0.0294929770943102,0.456548921537981
2014,49037,47,196,147,371,0,0,147,371,0.0440460643476196,0.39622641509434
2014,49039,162,1224,38,246,4,15,42,261,0.0167737789203085,0.160919540229885
2014,49041,40,463,43,228,0,0,43,228,0.0180493983533882,0.18859649122807
2014,49043,351,726,437,819,102,170,539,989,0.0397763835263835,0.544994944388271
2014,49045,283,1345,302,870,49,75,351,945,0.0279098614843912,0.371428571428571
2014,49047,136,512,174,598,14,61,188,659,0.0334178498985801,0.285280728376328
2014,49049,1907,6007,3368,7442,721,1718,4089,9160,0.0348597807182789,0.446397379912664
2014,49051,166,560,225,415,43,96,268,511,0.0340848452508004,0.524461839530333
2014,49053,680,2395,1115,3296,194,316,1309,3612,0.0405892863162863,0.362403100775194
2014,49055,4,21,14,40,0,40,14,80,0.0449438202247191,0.175
2014,49057,983,5248,583,2305,43,413,626,2718,0.0190284166089093,0.230316409124356
2014,50001,172,618,233,530,46,131,279,661,0.02646328769317,0.422087745839637
2014,50003,81,198,281,776,0,5,281,781,0.029921078844533,0.359795134443022
2014,50005,86,376,229,545,29,61,258,606,0.0280594527017641,0.425742574257426
2014,50007,550,1492,1830,2644,221,350,2051,2994,0.0290993206270836,0.685036740146961
2014,50009,12,98,31,138,0,1,31,139,0.0296818278881059,0.223021582733813
2014,50011,281,755,110,312,0,29,110,341,0.0102735598939503,0.32258064516129
2014,50013,59,180,48,98,0,11,48,109,0.0212434223348275,0.440366972477064
2014,50015,119,344,307,531,55,125,362,656,0.0387752689443197,0.551829268292683
2014,50017,205,487,235,343,23,42,258,385,0.0185864632615622,0.67012987012987
2014,50019,85,373,149,412,14,17,163,429,0.0220191962223477,0.37995337995338
2014,50021,132,408,439,956,18,55,457,1011,0.0232761597789801,0.452027695351138
2014,50023,337,669,498,831,24,46,522,877,0.0208889100609756,0.59521094640821
2014,50025,116,355,416,906,56,105,472,1011,0.0316293329996246,0.466864490603363
2014,50027,143,643,913,1569,58,104,971,1673,0.0399045915324985,0.580394500896593
2014,51001,87,174,120,387,98,153,218,540,0.0226928895612708,0.403703703703704
2014,51003,1205,2733,1792,2268,370,514,2162,2782,0.0409400615131046,0.777138749101366
2014,51005,36,371,61,83,0,0,61,83,0.00701250422440013,0.734939759036145
2014,51007,22,225,0,92,0,17,0,109,0.011996478098173,0
2014,51009,40,588,118,264,0,56,118,320,0.0143080706460988,0.36875
2014,51011,2,158,0,84,0,0,0,84,0.00776699029126214,0
2014,51013,4744,6805,9855,11684,2103,2676,11958,14360,0.0867443096699367,0.832729805013928
2014,51015,379,1644,202,363,97,109,299,472,0.00888989339661732,0.633474576271186
2014,51017,0,188,0,29,0,0,0,29,0.00801104972375691,0
2014,51019,543,1907,217,562,55,95,272,657,0.0121347567507665,0.41400304414003
2014,51021,18,353,22,70,0,0,22,70,0.013550135501355,0.314285714285714
2014,51023,126,721,91,219,0,0,91,219,0.00919472667730288,0.415525114155251
2014,51025,46,431,0,83,0,4,0,87,0.00718711276332094,0
2014,51027,33,212,17,115,0,0,17,115,0.00651964397074664,0.147826086956522
2014,51029,46,577,5,66,0,11,5,77,0.00621920684920443,0.0649350649350649
2014,51031,320,1366,190,421,0,28,190,449,0.0117278307431109,0.423162583518931
2014,51033,123,1078,88,287,0,12,88,299,0.0151040614265508,0.294314381270903
2014,51035,28,425,25,135,0,4,25,139,0.00634210886526441,0.179856115107914
2014,51036,21,120,20,49,0,6,20,55,0.0101270484257043,0.363636363636364
2014,51037,31,168,1,10,0,1,1,11,0.00127921851378067,0.0909090909090909
2014,51041,2257,6580,1978,4035,420,887,2398,4922,0.0230442578971764,0.487200325071109
2014,51043,105,417,39,200,0,0,39,200,0.0197316495659037,0.195
2014,51045,0,87,0,0,0,0,0,0,0,NA
2014,51047,127,1416,182,504,8,28,190,532,0.0166949099353543,0.357142857142857
2014,51049,72,217,0,36,12,12,12,48,0.00703915530136384,0.25
2014,51051,59,351,0,30,0,0,0,30,0.0026733202637676,0
2014,51053,53,682,44,132,0,9,44,141,0.00721449038067949,0.312056737588652
2014,51057,51,259,17,64,0,14,17,78,0.0100957804814911,0.217948717948718
2014,51059,12451,19489,17104,23768,6810,10961,23914,34729,0.0457505318833611,0.688588787468686
2014,51061,702,1826,237,582,51,105,288,687,0.0151428319520367,0.419213973799127
2014,51063,108,250,80,222,0,41,80,263,0.023361165393498,0.304182509505703
2014,51065,404,1176,46,209,13,13,59,222,0.0120051914341337,0.265765765765766
2014,51067,248,1371,189,464,0,32,189,496,0.012318696602424,0.381048387096774
2014,51069,631,2357,447,1049,80,176,527,1225,0.0224276821677041,0.430204081632653
2014,51071,17,123,41,267,6,27,47,294,0.0242774566473988,0.159863945578231
2014,51073,189,737,152,425,38,215,190,640,0.0244872972145699,0.296875
2014,51075,133,584,71,164,27,33,98,197,0.0121905940594059,0.49746192893401
2014,51077,3,192,6,99,0,2,6,101,0.00884955752212389,0.0594059405940594
2014,51079,122,613,101,287,0,19,101,306,0.0237614536418699,0.330065359477124
2014,51081,32,734,0,97,0,0,0,97,0.0110014744244074,0
2014,51083,115,429,27,236,5,24,32,260,0.0102305815692138,0.123076923076923
2014,51085,1026,2390,351,864,83,146,434,1010,0.0148649643093679,0.42970297029703
2014,51087,3416,10453,2254,4155,887,1675,3141,5830,0.0272261969252611,0.538765008576329
2014,51089,120,1000,16,478,0,5,16,483,0.0125951809742359,0.0331262939958592
2014,51091,8,47,7,30,0,0,7,30,0.0166112956810631,0.233333333333333
2014,51093,189,981,146,364,25,156,171,520,0.0206529509889586,0.328846153846154
2014,51095,909,2274,773,1399,130,216,903,1615,0.0322290959888246,0.559133126934985
2014,51097,19,90,14,74,0,0,14,74,0.0139307228915663,0.189189189189189
2014,51099,158,745,158,527,0,51,158,578,0.036400277095535,0.273356401384083
2014,51101,72,344,23,77,0,36,23,113,0.0101957953622665,0.20353982300885
2014,51103,67,219,19,93,32,48,51,141,0.0159178144050576,0.361702127659574
2014,51105,18,224,47,466,0,47,47,513,0.0276252019386107,0.0916179337231969
2014,51107,5466,8045,3390,5665,1124,2725,4514,8390,0.0389601946616639,0.538021454112038
2014,51109,141,843,138,312,0,35,138,347,0.0143596110076557,0.397694524495677
2014,51111,37,333,0,85,0,8,0,93,0.0100856740049886,0
2014,51113,80,543,67,99,0,0,67,99,0.0105916336792554,0.676767676767677
2014,51115,68,245,8,52,0,0,8,52,0.00756583733449731,0.153846153846154
2014,51117,57,483,82,312,28,50,110,362,0.0154853060700689,0.303867403314917
2014,51119,52,247,76,123,0,0,76,123,0.014787208463573,0.617886178861789
2014,51121,869,1871,1002,1489,502,630,1504,2119,0.0411033305530231,0.709768758848513
2014,51125,104,272,62,116,19,28,81,144,0.0131554905901699,0.5625
2014,51127,243,1280,8,84,18,18,26,102,0.00747800586510264,0.254901960784314
2014,51131,103,237,19,84,0,2,19,86,0.00946094609460946,0.22093023255814
2014,51133,62,192,38,74,0,0,38,74,0.00760768993523183,0.513513513513513
2014,51135,170,763,8,88,0,12,8,100,0.00894614421184469,0.08
2014,51137,419,1569,176,380,13,55,189,435,0.0180925841201181,0.43448275862069
2014,51139,59,383,73,175,12,12,85,187,0.0109203457136183,0.454545454545455
2014,51141,69,523,16,157,0,0,16,157,0.0114959361499597,0.101910828025478
2014,51143,158,1444,30,501,0,23,30,524,0.0115225613510423,0.0572519083969466
2014,51145,407,1315,71,394,0,16,71,410,0.0203980099502488,0.173170731707317
2014,51147,62,594,166,345,16,48,182,393,0.0303451470928886,0.463104325699746
2014,51149,265,1715,244,1192,81,223,325,1415,0.0561820058762805,0.229681978798587
2014,51153,4059,12079,3660,8331,836,1822,4496,10153,0.0376980885476229,0.44282478085295
2014,51155,198,1020,41,146,39,39,80,185,0.00722882150672085,0.432432432432432
2014,51157,17,136,24,95,0,0,24,95,0.0170311939763356,0.252631578947368
2014,51159,63,256,5,76,0,12,5,88,0.0128730251609128,0.0568181818181818
2014,51161,837,3252,611,1352,35,95,646,1447,0.0217806878904192,0.446440912232205
2014,51163,272,538,100,401,27,28,127,429,0.0258045112781955,0.296037296037296
2014,51165,401,1338,292,596,31,106,323,702,0.0134294951504601,0.46011396011396
2014,51167,42,312,26,238,0,25,26,263,0.0128136419001218,0.0988593155893536
2014,51169,21,377,35,240,0,11,35,251,0.0149806028051328,0.139442231075697
2014,51171,463,1099,148,761,25,46,173,807,0.026675040491852,0.214374225526642
2014,51173,28,311,80,441,6,48,86,489,0.0213985646770523,0.175869120654397
2014,51175,41,557,23,126,3,33,26,159,0.0119360408377749,0.163522012578616
2014,51177,756,3108,660,1833,97,340,757,2173,0.0266162024448201,0.348366313851818
2014,51179,1264,3976,1723,3799,271,508,1994,4307,0.0513600209876102,0.462967262595774
2014,51181,39,133,26,72,0,0,26,72,0.0146133549827481,0.361111111111111
2014,51183,95,1161,6,33,0,1,6,34,0.00378661320859784,0.176470588235294
2014,51185,67,555,44,533,0,39,44,572,0.0179136262566158,0.0769230769230769
2014,51187,238,820,166,442,31,31,197,473,0.0181406765360129,0.416490486257928
2014,51191,314,987,345,1080,58,77,403,1157,0.0291678221191419,0.348314606741573
2014,51193,155,586,67,215,16,37,83,252,0.0196078431372549,0.329365079365079
2014,51195,16,747,51,593,7,40,58,633,0.0223706530958439,0.0916271721958926
2014,51197,75,338,0,141,0,30,0,171,0.00809582425906638,0
2014,51199,741,2030,771,1938,169,489,940,2427,0.0559848677077807,0.387309435517099
2014,51510,4052,6589,5873,7653,1699,2730,7572,10383,0.0931394535244622,0.729268997399595
2014,51520,111,684,151,623,0,5,151,628,0.0505026135906715,0.240445859872611
2014,51530,34,111,27,50,0,0,27,50,0.0119846596356663,0.54
2014,51540,999,2092,819,1040,191,493,1010,1533,0.05777710775261,0.65883887801696
2014,51550,1852,8000,1650,4375,175,512,1825,4887,0.0326592531209067,0.373439738080622
2014,51570,55,404,41,239,0,13,41,252,0.0209424083769634,0.162698412698413
2014,51580,19,331,8,128,0,10,8,138,0.0345691382765531,0.0579710144927536
2014,51590,281,1268,168,790,0,41,168,831,0.0283966648441771,0.202166064981949
2014,51595,51,172,0,73,0,49,0,122,0.0317460317460317,0
2014,51600,827,1337,344,390,193,261,537,651,0.0398726036626447,0.824884792626728
2014,51610,288,435,448,584,233,335,681,919,0.105100640439158,0.741022850924918
2014,51620,76,463,0,112,0,8,0,120,0.0214094558429973,0
2014,51630,660,1951,231,785,15,54,246,839,0.0541919648624209,0.293206197854589
2014,51640,18,317,1,52,11,11,12,63,0.0126100880704564,0.19047619047619
2014,51650,600,3692,630,2046,90,355,720,2401,0.026818725077351,0.299875052061641
2014,51660,894,2540,356,712,115,217,471,929,0.039666951323655,0.506996770721206
2014,51670,119,675,80,181,0,0,80,181,0.0121984094891495,0.441988950276243
2014,51678,63,107,17,47,20,23,37,70,0.0293009627459188,0.528571428571429
2014,51680,844,2939,570,1001,129,211,699,1212,0.0277205983257856,0.576732673267327
2014,51683,473,1728,86,358,23,156,109,514,0.020365307658782,0.212062256809339
2014,51685,175,753,91,264,25,174,116,438,0.0447623914154318,0.264840182648402
2014,51690,47,666,5,112,0,7,5,119,0.0124490009415211,0.0420168067226891
2014,51700,1132,5515,1348,4413,365,989,1713,5402,0.0472665546689066,0.317104776008886
2014,51710,1724,6721,1794,5105,432,819,2226,5924,0.0401665242802707,0.37575962187711
2014,51720,17,182,4,91,0,0,4,91,0.0341719864814119,0.043956043956044
2014,51730,187,1007,119,501,85,126,204,627,0.0284805814217579,0.325358851674641
2014,51735,127,435,130,185,0,23,130,208,0.0248714576109052,0.625
2014,51740,601,3530,292,1248,40,95,332,1343,0.0212405896121971,0.247207743857036
2014,51750,89,491,51,150,0,0,51,150,0.0214992116955712,0.34
2014,51760,3062,7883,2091,3844,285,605,2376,4449,0.0319435369802624,0.534052596089009
2014,51770,751,3455,657,1545,46,274,703,1819,0.0267366316841579,0.386476085761407
2014,51775,304,1200,74,241,98,153,172,394,0.0234747378455672,0.436548223350254
2014,51790,386,1312,70,209,10,10,80,219,0.012918829636621,0.365296803652968
2014,51800,603,2232,571,1285,87,162,658,1447,0.025637391258128,0.45473393227367
2014,51810,2354,9319,3936,10269,853,2176,4789,12445,0.0422362651534692,0.384813177983126
2014,51820,107,813,106,299,0,0,106,299,0.0208405938523733,0.354515050167224
2014,51830,278,846,138,245,71,102,209,347,0.0486812570145903,0.602305475504323
2014,51840,422,1620,119,473,9,38,128,511,0.0287806251760068,0.250489236790607
2014,53001,47,247,27,134,0,28,27,162,0.0155261644623347,0.166666666666667
2014,53003,37,199,139,902,0,7,139,909,0.0586451612903226,0.152915291529153
2014,53005,985,3494,1004,2705,452,818,1456,3523,0.0302263328585892,0.413284132841328
2014,53007,407,1598,157,444,24,121,181,565,0.0115226169596606,0.320353982300885
2014,53009,271,1196,432,1657,14,110,446,1767,0.0327549771994216,0.252405206564799
2014,53011,667,3455,3234,11352,398,1295,3632,12647,0.0438234173048269,0.28718273108247
2014,53013,33,160,3,35,2,10,5,45,0.0150905432595573,0.111111111111111
2014,53015,284,1301,388,1524,37,70,425,1594,0.0228520637105214,0.266624843161857
2014,53017,226,1217,134,415,23,101,157,516,0.0203021718602455,0.304263565891473
2014,53019,29,234,6,131,0,3,6,134,0.0240488155061019,0.0447761194029851
2014,53021,459,2588,226,832,8,138,234,970,0.0203888596952181,0.241237113402062
2014,53023,7,7,0,43,0,0,0,43,0.0261716372489349,0
2014,53025,323,1377,137,742,51,346,188,1088,0.0199384254508137,0.172794117647059
2014,53027,218,2030,132,654,2,107,134,761,0.0149927105086883,0.176084099868594
2014,53029,522,1813,687,2505,201,513,888,3018,0.0536924691775338,0.294234592445328
2014,53031,357,1153,347,844,21,72,368,916,0.0380193417175113,0.40174672489083
2014,53033,7753,23501,24824,41408,10941,16374,35765,57782,0.0411439004035922,0.618964383371984
2014,53035,1167,3590,2683,6387,663,1619,3346,8006,0.0465040631516581,0.417936547589308
2014,53037,305,1299,296,577,36,58,332,635,0.0256379198966408,0.522834645669291
2014,53039,103,300,44,243,4,26,48,269,0.0180864654071136,0.178438661710037
2014,53041,369,2236,55,791,0,173,55,964,0.0184826581283433,0.0570539419087137
2014,53043,29,204,15,81,3,8,18,89,0.0119318943558118,0.202247191011236
2014,53045,326,2126,99,668,12,119,111,787,0.01784782855199,0.141041931385006
2014,53047,99,528,125,351,18,72,143,423,0.0148389812671017,0.33806146572104
2014,53049,85,427,92,385,0,21,92,406,0.0259159964253798,0.226600985221675
2014,53051,30,239,71,307,0,18,71,325,0.0336334471696161,0.218461538461538
2014,53053,2836,15540,5018,13643,1183,3934,6201,17577,0.0329348498191834,0.35279057859703
2014,53055,143,325,230,390,12,30,242,420,0.0329955220362951,0.576190476190476
2014,53057,767,2638,560,1897,80,250,640,2147,0.0264441433674098,0.298090358639963
2014,53059,25,185,38,204,4,17,42,221,0.0276977064795087,0.190045248868778
2014,53061,5220,16080,4181,10634,779,2591,4960,13225,0.0266222459311747,0.375047258979206
2014,53063,1256,5352,2579,7503,296,887,2875,8390,0.0265476085002974,0.342669845053635
2014,53065,92,764,126,603,34,167,160,770,0.0251182515087261,0.207792207792208
2014,53067,1577,6522,2102,4817,740,2024,2842,6841,0.0385814914868058,0.415436339716416
2014,53069,6,56,8,25,0,0,8,25,0.00818598559266536,0.32
2014,53071,324,1654,260,833,54,94,314,927,0.0241702083279013,0.338727076591154
2014,53073,669,2165,869,2248,374,785,1243,3033,0.0228945401843339,0.409825255522585
2014,53075,289,656,632,1050,143,227,775,1277,0.0581644272375313,0.606891151135474
2014,53077,418,2114,504,1938,80,419,584,2357,0.016006899877079,0.24777259227832
2014,54001,20,170,20,211,0,0,20,211,0.0184844502847131,0.0947867298578199
2014,54003,222,1133,540,2911,0,38,540,2949,0.0407393592772183,0.183112919633774
2014,54005,51,407,8,191,11,22,19,213,0.0125693378968488,0.0892018779342723
2014,54007,63,358,8,114,7,26,15,140,0.0134344112849055,0.107142857142857
2014,54009,50,215,53,479,0,0,53,479,0.0280757282691519,0.110647181628392
2014,54011,301,1542,576,2025,25,118,601,2143,0.0329393319909621,0.280447970135324
2014,54013,39,246,22,77,0,0,22,77,0.0140280561122244,0.285714285714286
2014,54015,0,153,0,9,0,10,0,19,0.00296273195072509,0
2014,54017,39,363,24,65,0,0,24,65,0.0110732538330494,0.369230769230769
2014,54019,43,373,62,236,6,8,68,244,0.00742838006515055,0.278688524590164
2014,54021,47,330,85,423,7,55,92,478,0.0780280770486451,0.192468619246862
2014,54023,0,91,3,70,0,30,3,100,0.0116631677163518,0.03
2014,54025,37,362,198,659,25,25,223,684,0.0263583815028902,0.326023391812865
2014,54027,39,280,20,293,0,0,20,293,0.0172627113651093,0.068259385665529
2014,54029,102,348,133,688,9,57,142,745,0.0334155640278089,0.190604026845638
2014,54031,1,133,43,276,0,60,43,336,0.0329767396211601,0.12797619047619
2014,54033,114,857,172,750,12,12,184,762,0.0155038759689922,0.241469816272966
2014,54035,77,484,37,229,0,0,37,229,0.0112112014099677,0.161572052401747
2014,54037,101,454,419,1495,43,82,462,1577,0.0431121681839307,0.292961318960051
2014,54039,702,2494,641,1980,81,179,722,2159,0.0157299605111691,0.334414080592867
2014,54041,43,332,27,272,7,7,34,279,0.0236560963201628,0.121863799283154
2014,54043,6,383,0,49,0,11,0,60,0.0039580447259054,0
2014,54045,65,403,10,290,39,39,49,329,0.0126509267092209,0.148936170212766
2014,54047,1,233,18,278,0,47,18,325,0.0209745079057761,0.0553846153846154
2014,54049,173,700,164,637,6,34,170,671,0.0171282705807275,0.253353204172876
2014,54051,26,438,41,232,8,28,49,260,0.0110384648042795,0.188461538461538
2014,54053,38,359,76,396,0,0,76,396,0.0203097753615755,0.191919191919192
2014,54055,74,526,232,884,10,87,242,971,0.0222323983972524,0.249227600411946
2014,54057,31,206,13,176,2,2,15,178,0.0091512004524189,0.0842696629213483
2014,54059,48,188,4,276,0,50,4,326,0.0176216216216216,0.0122699386503067
2014,54061,384,1110,1163,2031,244,344,1407,2375,0.0401745690748854,0.592421052631579
2014,54063,71,231,12,139,0,8,12,147,0.0149390243902439,0.0816326530612245
2014,54065,33,120,49,576,5,5,54,581,0.04525274554093,0.0929432013769363
2014,54067,47,278,13,268,0,0,13,268,0.0143661216831949,0.0485074626865672
2014,54069,64,351,284,737,28,64,312,801,0.0261073628630097,0.389513108614232
2014,54071,0,52,6,44,0,0,6,44,0.00787542509396814,0.136363636363636
2014,54073,6,365,4,104,0,0,4,104,0.0189850310332238,0.0384615384615385
2014,54075,14,274,27,73,0,0,27,73,0.0110288563227074,0.36986301369863
2014,54077,69,612,116,567,14,43,130,610,0.0247093612022522,0.213114754098361
2014,54079,195,831,83,277,13,35,96,312,0.00787819104613287,0.307692307692308
2014,54081,269,1537,150,1001,6,133,156,1134,0.0202146244072872,0.137566137566138
2014,54083,112,827,54,139,0,22,54,161,0.00761625431666588,0.335403726708075
2014,54085,44,124,24,91,0,0,24,91,0.0123339658444023,0.263736263736264
2014,54087,58,327,10,105,9,15,19,120,0.0113884407326564,0.158333333333333
2014,54089,39,377,73,497,0,29,73,526,0.0503638452700115,0.138783269961977
2014,54091,63,402,0,54,8,26,8,80,0.00655791458316255,0.1
2014,54093,15,102,3,87,0,0,3,87,0.0166890466142336,0.0344827586206897
2014,54095,32,85,0,98,0,40,0,138,0.020979020979021,0
2014,54097,29,189,58,355,0,14,58,369,0.0223460304002907,0.157181571815718
2014,54099,69,398,128,550,15,15,143,565,0.0192000543718354,0.253097345132743
2014,54101,25,162,18,40,0,0,18,40,0.00610314311870613,0.45
2014,54103,2,121,2,46,0,7,2,53,0.00452064141931082,0.0377358490566038
2014,54105,0,10,0,32,0,0,0,32,0.00767570160710002,0
2014,54107,164,538,189,1228,0,68,189,1296,0.0211147135013604,0.145833333333333
2014,54109,8,204,15,46,0,0,15,46,0.00280043832947766,0.326086956521739
2014,55001,68,656,48,317,4,35,52,352,0.021790268664108,0.147727272727273
2014,55003,55,297,30,76,0,7,30,83,0.0076958738989337,0.36144578313253
2014,55005,171,1032,62,404,26,36,88,440,0.0135785705468461,0.2
2014,55007,100,369,102,188,1,2,103,190,0.0165750676088284,0.542105263157895
2014,55009,724,3384,998,2122,225,433,1223,2555,0.0153747096556787,0.47866927592955
2014,55011,78,228,14,145,0,6,14,151,0.0158048984718443,0.0927152317880795
2014,55013,20,222,98,301,5,12,103,313,0.026839307151432,0.329073482428115
2014,55015,471,1477,62,134,34,42,96,176,0.00533737680060652,0.545454545454545
2014,55017,235,2057,67,414,98,98,165,512,0.011672974328576,0.322265625
2014,55019,84,465,28,120,5,36,33,156,0.00714776632302406,0.211538461538462
2014,55021,292,1629,101,389,16,49,117,438,0.0110366376052008,0.267123287671233
2014,55023,28,385,72,214,3,9,75,223,0.0189111261872456,0.336322869955157
2014,55025,2448,6662,5751,8896,1265,1976,7016,10872,0.0331144385287345,0.64532744665195
2014,55027,440,3213,180,630,6,21,186,651,0.010389071526603,0.285714285714286
2014,55029,154,323,153,462,25,28,178,490,0.0229261217423853,0.363265306122449
2014,55031,65,337,207,975,18,54,225,1029,0.0337178058850514,0.21865889212828
2014,55033,236,914,91,342,4,63,95,405,0.0152461978617678,0.234567901234568
2014,55035,475,1604,447,813,58,111,505,924,0.0148012879042722,0.546536796536797
2014,55037,14,110,3,49,1,9,4,58,0.0170437848956803,0.0689655172413793
2014,55039,288,1583,209,460,79,137,288,597,0.00850972845841351,0.482412060301508
2014,55041,18,206,17,37,3,9,20,46,0.00704333180217425,0.434782608695652
2014,55043,162,860,118,287,33,86,151,373,0.0117684177315034,0.404825737265416
2014,55045,225,830,129,321,7,16,136,337,0.0131261198099244,0.403560830860534
2014,55047,139,509,19,100,4,17,23,117,0.00870276703362095,0.196581196581197
2014,55049,123,539,85,172,24,64,109,236,0.014258095698405,0.461864406779661
2014,55051,3,86,35,140,0,4,35,144,0.0307692307692308,0.243055555555556
2014,55053,125,934,9,136,0,11,9,147,0.0101603538844346,0.0612244897959184
2014,55055,415,1817,154,441,100,138,254,579,0.0102918696007679,0.438687392055268
2014,55057,118,760,41,321,0,10,41,331,0.0173017615388636,0.123867069486405
2014,55059,565,2187,772,3049,53,136,825,3185,0.0292225963611674,0.259026687598116
2014,55061,104,361,44,103,23,37,67,140,0.00969193492557979,0.478571428571429
2014,55063,454,1587,738,1523,124,197,862,1720,0.0233201366668474,0.501162790697674
2014,55065,51,291,11,152,5,15,16,167,0.0147162495593937,0.0958083832335329
2014,55067,64,440,42,211,0,11,42,222,0.0155027932960894,0.189189189189189
2014,55069,57,485,10,115,13,16,23,131,0.00633983448676378,0.175572519083969
2014,55071,232,696,146,326,4,34,150,360,0.00629667850209015,0.416666666666667
2014,55073,384,1863,617,1106,46,138,663,1244,0.0135339491062589,0.532958199356913
2014,55075,64,448,39,340,4,30,43,370,0.0123033950719915,0.116216216216216
2014,55077,63,512,20,109,0,7,20,116,0.0103019538188277,0.172413793103448
2014,55078,18,107,7,43,0,0,7,43,0.0167772142021069,0.162790697674419
2014,55079,4010,9924,4048,8893,1041,2303,5089,11196,0.0182025694302186,0.454537334762415
2014,55081,148,811,327,746,33,74,360,820,0.02710385403583,0.439024390243902
2014,55083,133,637,63,166,3,28,66,194,0.00717853839037928,0.34020618556701
2014,55085,155,654,112,421,11,14,123,435,0.0160587714116952,0.282758620689655
2014,55087,1121,4166,775,1442,50,180,825,1622,0.0135792443510511,0.508631319358816
2014,55089,689,1668,661,1121,47,154,708,1275,0.0212188789774997,0.555294117647059
2014,55091,42,174,15,59,0,0,15,59,0.0112724493695071,0.254237288135593
2014,55093,63,407,132,450,18,31,150,481,0.0191465647639519,0.311850311850312
2014,55095,98,463,115,444,21,95,136,539,0.0174699380935403,0.252319109461967
2014,55097,249,1302,173,436,6,28,179,464,0.0104678969453594,0.385775862068966
2014,55099,24,202,21,78,0,12,21,90,0.00848976511649844,0.233333333333333
2014,55101,978,3661,427,1491,100,204,527,1695,0.0128884596959996,0.310914454277286
2014,55103,38,394,35,125,6,10,41,135,0.0108616944243302,0.303703703703704
2014,55105,383,1793,804,1907,89,132,893,2039,0.0189700888496069,0.437959784207945
2014,55107,66,266,17,109,0,19,17,128,0.0122958693563881,0.1328125
2014,55109,225,1041,677,1733,45,159,722,1892,0.0333080999242998,0.381606765327696
2014,55111,293,1187,174,451,15,34,189,485,0.0111983375663819,0.389690721649485
2014,55113,67,227,64,195,0,0,64,195,0.0161037245024362,0.328205128205128
2014,55115,148,1076,42,228,0,9,42,237,0.00805027173913044,0.177215189873418
2014,55117,288,1759,312,862,38,114,350,976,0.0123171670515781,0.358606557377049
2014,55119,146,354,59,181,2,27,61,208,0.0145934189293482,0.293269230769231
2014,55121,87,396,52,153,0,86,52,239,0.0119065411248941,0.217573221757322
2014,55123,99,473,33,136,6,12,39,148,0.00731586752347998,0.263513513513513
2014,55125,119,441,107,247,9,32,116,279,0.0168305483501237,0.415770609318996
2014,55127,370,1447,610,1914,61,134,671,2048,0.0304539844458654,0.32763671875
2014,55129,54,393,35,151,16,43,51,194,0.0165022116366111,0.262886597938144
2014,55131,697,2722,214,822,78,145,292,967,0.0105185297988753,0.301964839710445
2014,55133,3287,8495,1968,3666,400,694,2368,4360,0.015973680064774,0.543119266055046
2014,55135,268,1447,59,354,52,97,111,451,0.0121383393890459,0.246119733924612
2014,55137,83,856,53,154,4,29,57,183,0.0101082633672117,0.311475409836066
2014,55139,1050,4590,477,1100,76,187,553,1287,0.011500312751318,0.42968142968143
2014,55141,278,1383,130,389,10,63,140,452,0.00865104884397489,0.309734513274336
2014,56001,136,334,449,1291,123,136,572,1427,0.0700952942332253,0.400840925017519
2014,56003,22,173,16,160,2,26,18,186,0.023601065854587,0.0967741935483871
2014,56005,148,630,174,1212,37,49,211,1261,0.0423253784446011,0.167327517842982
2014,56007,49,279,88,599,0,32,88,631,0.0586758415473312,0.13946117274168
2014,56009,51,261,66,195,0,0,66,195,0.0207689849824262,0.338461538461538
2014,56011,10,113,3,83,0,0,3,83,0.0165174129353234,0.036144578313253
2014,56013,131,663,207,903,0,47,207,950,0.0352021343609886,0.217894736842105
2014,56015,71,424,121,451,0,0,121,451,0.0480042575838212,0.268292682926829
2014,56017,37,110,48,287,32,40,80,327,0.0909343715239155,0.244648318042813
2014,56019,53,201,5,6,0,30,5,36,0.005851755526658,0.138888888888889
2014,56021,213,765,776,2572,66,226,842,2798,0.0446437119060535,0.300929235167977
2014,56023,31,423,123,494,0,0,123,494,0.041328536769012,0.248987854251012
2014,56025,210,1156,732,1705,32,164,764,1869,0.0356366548449834,0.408774745853398
2014,56027,7,94,16,90,5,17,21,107,0.0593784683684795,0.196261682242991
2014,56029,54,149,214,774,2,12,216,786,0.0387612190551336,0.274809160305344
2014,56031,13,273,22,177,0,12,22,189,0.0299334811529933,0.116402116402116
2014,56033,133,489,284,700,5,15,289,715,0.0344761078161917,0.404195804195804
2014,56035,10,78,144,647,0,0,144,647,0.091656041932285,0.222565687789799
2014,56037,36,168,324,1441,10,46,334,1487,0.0526017899465846,0.224613315400134
2014,56039,83,275,370,610,1,12,371,622,0.0379708198522679,0.596463022508039
2014,56041,104,417,197,527,25,27,222,554,0.0424651234094742,0.40072202166065
2014,56043,7,120,58,109,7,7,65,116,0.0200138026224983,0.560344827586207
2014,56045,30,306,13,69,3,3,16,72,0.0143683895430054,0.222222222222222
2014,72001,NA,NA,NA,NA,NA,NA,NA,NA,NA,NA
2014,72003,NA,NA,NA,NA,NA,NA,NA,NA,NA,NA
2014,72005,NA,NA,NA,NA,NA,NA,NA,NA,NA,NA
2014,72007,NA,NA,NA,NA,NA,NA,NA,NA,NA,NA
2014,72009,NA,NA,NA,NA,NA,NA,NA,NA,NA,NA
2014,72011,NA,NA,NA,NA,NA,NA,NA,NA,NA,NA
2014,72013,NA,NA,NA,NA,NA,NA,NA,NA,NA,NA
2014,72015,NA,NA,NA,NA,NA,NA,NA,NA,NA,NA
2014,72017,NA,NA,NA,NA,NA,NA,NA,NA,NA,NA
2014,72019,NA,NA,NA,NA,NA,NA,NA,NA,NA,NA
2014,72021,NA,NA,NA,NA,NA,NA,NA,NA,NA,NA
2014,72023,NA,NA,NA,NA,NA,NA,NA,NA,NA,NA
2014,72025,NA,NA,NA,NA,NA,NA,NA,NA,NA,NA
2014,72027,NA,NA,NA,NA,NA,NA,NA,NA,NA,NA
2014,72029,NA,NA,NA,NA,NA,NA,NA,NA,NA,NA
2014,72031,NA,NA,NA,NA,NA,NA,NA,NA,NA,NA
2014,72033,NA,NA,NA,NA,NA,NA,NA,NA,NA,NA
2014,72035,NA,NA,NA,NA,NA,NA,NA,NA,NA,NA
2014,72037,NA,NA,NA,NA,NA,NA,NA,NA,NA,NA
2014,72039,NA,NA,NA,NA,NA,NA,NA,NA,NA,NA
2014,72041,NA,NA,NA,NA,NA,NA,NA,NA,NA,NA
2014,72043,NA,NA,NA,NA,NA,NA,NA,NA,NA,NA
2014,72045,NA,NA,NA,NA,NA,NA,NA,NA,NA,NA
2014,72047,NA,NA,NA,NA,NA,NA,NA,NA,NA,NA
2014,72049,NA,NA,NA,NA,NA,NA,NA,NA,NA,NA
2014,72051,NA,NA,NA,NA,NA,NA,NA,NA,NA,NA
2014,72053,NA,NA,NA,NA,NA,NA,NA,NA,NA,NA
2014,72054,NA,NA,NA,NA,NA,NA,NA,NA,NA,NA
2014,72055,NA,NA,NA,NA,NA,NA,NA,NA,NA,NA
2014,72057,NA,NA,NA,NA,NA,NA,NA,NA,NA,NA
2014,72059,NA,NA,NA,NA,NA,NA,NA,NA,NA,NA
2014,72061,NA,NA,NA,NA,NA,NA,NA,NA,NA,NA
2014,72063,NA,NA,NA,NA,NA,NA,NA,NA,NA,NA
2014,72065,NA,NA,NA,NA,NA,NA,NA,NA,NA,NA
2014,72067,NA,NA,NA,NA,NA,NA,NA,NA,NA,NA
2014,72069,NA,NA,NA,NA,NA,NA,NA,NA,NA,NA
2014,72071,NA,NA,NA,NA,NA,NA,NA,NA,NA,NA
2014,72073,NA,NA,NA,NA,NA,NA,NA,NA,NA,NA
2014,72075,NA,NA,NA,NA,NA,NA,NA,NA,NA,NA
2014,72077,NA,NA,NA,NA,NA,NA,NA,NA,NA,NA
2014,72079,NA,NA,NA,NA,NA,NA,NA,NA,NA,NA
2014,72081,NA,NA,NA,NA,NA,NA,NA,NA,NA,NA
2014,72083,NA,NA,NA,NA,NA,NA,NA,NA,NA,NA
2014,72085,NA,NA,NA,NA,NA,NA,NA,NA,NA,NA
2014,72087,NA,NA,NA,NA,NA,NA,NA,NA,NA,NA
2014,72089,NA,NA,NA,NA,NA,NA,NA,NA,NA,NA
2014,72091,NA,NA,NA,NA,NA,NA,NA,NA,NA,NA
2014,72093,NA,NA,NA,NA,NA,NA,NA,NA,NA,NA
2014,72095,NA,NA,NA,NA,NA,NA,NA,NA,NA,NA
2014,72097,NA,NA,NA,NA,NA,NA,NA,NA,NA,NA
2014,72099,NA,NA,NA,NA,NA,NA,NA,NA,NA,NA
2014,72101,NA,NA,NA,NA,NA,NA,NA,NA,NA,NA
2014,72103,NA,NA,NA,NA,NA,NA,NA,NA,NA,NA
2014,72105,NA,NA,NA,NA,NA,NA,NA,NA,NA,NA
2014,72107,NA,NA,NA,NA,NA,NA,NA,NA,NA,NA
2014,72109,NA,NA,NA,NA,NA,NA,NA,NA,NA,NA
2014,72111,NA,NA,NA,NA,NA,NA,NA,NA,NA,NA
2014,72113,NA,NA,NA,NA,NA,NA,NA,NA,NA,NA
2014,72115,NA,NA,NA,NA,NA,NA,NA,NA,NA,NA
2014,72117,NA,NA,NA,NA,NA,NA,NA,NA,NA,NA
2014,72119,NA,NA,NA,NA,NA,NA,NA,NA,NA,NA
2014,72121,NA,NA,NA,NA,NA,NA,NA,NA,NA,NA
2014,72123,NA,NA,NA,NA,NA,NA,NA,NA,NA,NA
2014,72125,NA,NA,NA,NA,NA,NA,NA,NA,NA,NA
2014,72127,NA,NA,NA,NA,NA,NA,NA,NA,NA,NA
2014,72129,NA,NA,NA,NA,NA,NA,NA,NA,NA,NA
2014,72131,NA,NA,NA,NA,NA,NA,NA,NA,NA,NA
2014,72133,NA,NA,NA,NA,NA,NA,NA,NA,NA,NA
2014,72135,NA,NA,NA,NA,NA,NA,NA,NA,NA,NA
2014,72137,NA,NA,NA,NA,NA,NA,NA,NA,NA,NA
2014,72139,NA,NA,NA,NA,NA,NA,NA,NA,NA,NA
2014,72141,NA,NA,NA,NA,NA,NA,NA,NA,NA,NA
2014,72143,NA,NA,NA,NA,NA,NA,NA,NA,NA,NA
2014,72145,NA,NA,NA,NA,NA,NA,NA,NA,NA,NA
2014,72147,NA,NA,NA,NA,NA,NA,NA,NA,NA,NA
2014,72149,NA,NA,NA,NA,NA,NA,NA,NA,NA,NA
2014,72151,NA,NA,NA,NA,NA,NA,NA,NA,NA,NA
2014,72153,NA,NA,NA,NA,NA,NA,NA,NA,NA,NA
2015,01001,416,1927,438,923,23,53,461,976,0.0268729865910405,0.472336065573771
2015,01003,1059,3267,1623,4454,191,411,1814,4865,0.0355106897029949,0.372867420349435
2015,01005,32,896,0,169,0,74,0,243,0.0129200340280732,0
2015,01007,49,1288,0,121,27,40,27,161,0.0103013628511101,0.167701863354037
2015,01009,151,1332,124,541,6,55,130,596,0.0151238327243199,0.218120805369128
2015,01011,81,328,0,124,0,23,0,147,0.0197633772519494,0
2015,01013,46,243,17,108,3,39,20,147,0.0105030008573878,0.136054421768707
2015,01015,412,2398,408,1465,39,161,447,1626,0.0206607369758577,0.274907749077491
2015,01017,78,627,133,362,3,11,136,373,0.015663055345595,0.364611260053619
2015,01019,85,369,13,218,2,16,15,234,0.0124906586954201,0.0641025641025641
2015,01021,112,576,71,431,28,53,99,484,0.0164223669923996,0.204545454545455
2015,01023,48,167,32,173,5,12,37,185,0.0194042374659115,0.2
2015,01025,12,169,21,136,0,15,21,151,0.00881597384399813,0.139072847682119
2015,01027,0,196,0,107,11,11,11,118,0.0123754588358679,0.0932203389830508
2015,01029,34,295,0,146,0,13,0,159,0.0152591170825336,0
2015,01031,183,995,650,1649,173,282,823,1931,0.0560294800371402,0.426204039357846
2015,01033,390,1463,52,371,32,105,84,476,0.0125236792254262,0.176470588235294
2015,01035,0,70,0,45,0,4,0,49,0.00550252667040988,0
2015,01037,30,468,16,31,0,57,16,88,0.0109698329593618,0.181818181818182
2015,01039,60,622,31,322,0,8,31,330,0.0124669437098602,0.0939393939393939
2015,01041,28,280,61,174,0,25,61,199,0.0208420611646418,0.306532663316583
2015,01043,98,1161,69,565,0,88,69,653,0.0117081742061571,0.105666156202144
2015,01045,104,1222,439,1883,40,141,479,2024,0.0608813355391788,0.236660079051383
2015,01047,34,569,11,349,15,71,26,420,0.0152988744399519,0.0619047619047619
2015,01049,181,1333,52,666,0,86,52,752,0.0159230948398162,0.0691489361702128
2015,01051,406,3651,246,719,108,158,354,877,0.0161059281569088,0.403648802736602
2015,01053,12,521,89,344,0,25,89,369,0.014188487714846,0.241192411924119
2015,01055,229,2076,152,669,21,133,173,802,0.0112025254571105,0.21571072319202
2015,01057,67,282,0,91,0,6,0,97,0.00816498316498316,0
2015,01059,69,899,12,462,2,155,14,617,0.029276393831554,0.0226904376012966
2015,01061,60,433,79,311,0,6,79,317,0.0168958533205415,0.249211356466877
2015,01063,35,112,50,102,0,0,50,102,0.0172210028701671,0.490196078431373
2015,01065,36,189,0,53,0,2,0,55,0.00535488267938857,0
2015,01067,65,385,44,204,2,29,46,233,0.0190780316056661,0.197424892703863
2015,01069,278,1373,390,1700,29,92,419,1792,0.0255001849901813,0.233816964285714
2015,01071,71,515,37,319,1,18,38,337,0.00906157569239043,0.112759643916914
2015,01073,3118,10041,3748,7856,587,1254,4335,9110,0.0204733363447791,0.475850713501647
2015,01075,24,259,0,121,0,0,0,121,0.0120794649096536,0
2015,01077,254,1273,247,1059,59,116,306,1175,0.0186893589947511,0.260425531914894
2015,01079,227,792,75,201,4,7,79,208,0.00893010475699811,0.379807692307692
2015,01081,1067,3131,1686,3518,313,621,1999,4139,0.0470624353303694,0.482966900217444
2015,01083,483,2095,294,915,86,119,380,1034,0.0169497082158547,0.367504835589942
2015,01085,5,211,38,60,0,3,38,63,0.00874392782789729,0.603174603174603
2015,01087,51,322,50,118,29,43,79,161,0.0130027459214989,0.490683229813665
2015,01089,1349,3709,3010,6577,465,1003,3475,7580,0.0324936984516195,0.45844327176781
2015,01091,28,329,58,115,0,44,58,159,0.0115359500834361,0.364779874213836
2015,01093,139,608,106,313,0,43,106,356,0.0164434180138568,0.297752808988764
2015,01095,264,1706,108,1002,2,76,110,1078,0.0171016102165464,0.102040816326531
2015,01097,473,2259,1432,4597,335,797,1767,5394,0.0197438497212655,0.327586206896552
2015,01099,20,324,9,126,0,0,9,126,0.00844900422450211,0.0714285714285714
2015,01101,1453,5230,1709,3748,543,856,2252,4604,0.0312059429562954,0.489139878366638
2015,01103,365,2221,268,1048,19,50,287,1098,0.0133940007563097,0.261384335154827
2015,01105,10,196,45,70,0,7,45,77,0.0125919869174162,0.584415584415584
2015,01107,11,255,63,292,0,12,63,304,0.0219669051232025,0.207236842105263
2015,01109,119,388,96,261,32,99,128,360,0.018455859735466,0.355555555555556
2015,01111,17,146,38,310,0,9,38,319,0.0205157887967072,0.119122257053292
2015,01113,11,693,477,2302,140,368,617,2670,0.0699465576862622,0.231086142322097
2015,01115,445,2713,10,586,5,80,15,666,0.0112412652330959,0.0225225225225225
2015,01117,2286,6099,1547,2810,172,314,1719,3124,0.0227819669501043,0.550256081946223
2015,01119,13,145,3,51,0,0,3,51,0.0062746062992126,0.0588235294117647
2015,01121,179,2018,70,808,0,92,70,900,0.0160387782015183,0.0777777777777778
2015,01123,39,581,95,298,0,36,95,334,0.011553895115539,0.284431137724551
2015,01125,923,3170,678,1622,162,335,840,1957,0.0161789021164021,0.429228410832908
2015,01127,243,1248,54,644,0,33,54,677,0.0147861791814092,0.0797636632200886
2015,01129,22,205,0,45,1,2,1,47,0.00408411539798401,0.0212765957446809
2015,01131,34,234,1,13,0,18,1,31,0.00418975537234761,0.032258064516129
2015,01133,29,446,0,201,0,0,0,201,0.0116514984638572,0
2015,02013,13,66,30,255,2,31,32,286,0.113492063492063,0.111888111888112
2015,02016,8,59,42,285,11,115,53,400,0.102354145342886,0.1325
2015,02020,885,3275,3141,7435,409,1080,3550,8515,0.0449815108293714,0.416911332941867
2015,02050,30,233,51,101,0,1,51,102,0.0108005082592122,0.5
2015,02060,4,27,7,26,0,4,7,30,0.0462249614791988,0.233333333333333
2015,02068,55,93,16,90,10,10,26,100,0.0723065798987708,0.26
2015,02070,27,96,26,65,4,6,30,71,0.0250972074938141,0.422535211267606
2015,02090,273,1387,1444,3962,370,842,1814,4804,0.0790951150040338,0.377601998334721
2015,02100,28,62,4,25,0,18,4,43,0.0222337125129266,0.0930232558139535
2015,02105,24,46,8,32,12,13,20,45,0.0278637770897833,0.444444444444444
2015,02110,78,269,375,954,45,117,420,1071,0.0480937626296646,0.392156862745098
2015,02122,212,1142,390,1303,27,92,417,1395,0.0357353280221328,0.298924731182796
2015,02130,56,211,90,376,18,48,108,424,0.0454935622317597,0.254716981132075
2015,02150,15,112,167,415,94,158,261,573,0.0671274601686973,0.455497382198953
2015,02158,15,118,11,31,0,0,11,31,0.0083829096809086,0.354838709677419
2015,02164,0,32,2,5,0,0,2,5,0.00582750582750583,0.4
2015,02170,438,2298,471,1847,33,169,504,2016,0.0332158038685867,0.25
2015,02180,46,149,64,145,8,8,72,153,0.0283806343906511,0.470588235294118
2015,02185,81,399,39,235,0,15,39,250,0.0397899092790068,0.156
2015,02188,35,113,56,117,0,0,56,117,0.0290683229813665,0.478632478632479
2015,02195,24,38,8,57,2,10,10,67,0.0308471454880295,0.149253731343284
2015,02198,11,74,35,190,0,6,35,196,0.0455813953488372,0.178571428571429
2015,02220,23,240,164,323,4,36,168,359,0.0581564879313138,0.467966573816156
2015,02230,3,25,22,55,4,6,26,61,0.077020202020202,0.426229508196721
2015,02240,36,181,47,173,16,33,63,206,0.0462921348314607,0.305825242718447
2015,02261,38,202,102,281,0,84,102,365,0.0577166350411132,0.279452054794521
2015,02275,35,63,26,55,3,4,29,59,0.0324532453245325,0.491525423728814
2015,02282,6,16,2,24,0,0,2,24,0.0547945205479452,0.0833333333333333
2015,02290,17,86,33,77,3,9,36,86,0.0242732147897262,0.418604651162791
2015,04001,129,895,148,611,15,76,163,687,0.0159049868037227,0.2372634643377
2015,04003,272,3700,1403,3743,328,947,1731,4690,0.0529650250143988,0.36908315565032
2015,04005,570,2037,1289,2497,152,228,1441,2725,0.0342500188532214,0.528807339449541
2015,04007,242,1628,242,731,3,14,245,745,0.0194025574914707,0.328859060402685
2015,04009,49,1095,102,675,11,73,113,748,0.032827174580883,0.151069518716578
2015,04011,25,252,21,123,0,5,21,128,0.0226628895184136,0.1640625
2015,04012,40,214,141,338,0,24,141,362,0.0233427908176425,0.389502762430939
2015,04013,5833,21921,35200,88954,6708,16758,41908,105712,0.0404663243178064,0.396435598607537
2015,04015,281,3062,1764,10577,194,733,1958,11310,0.0751505003388749,0.173121131741821
2015,04017,411,2866,283,1077,16,128,299,1205,0.0179422275163788,0.248132780082988
2015,04019,1999,8583,8290,19613,1975,4291,10265,23904,0.0362953920157426,0.429426037483266
2015,04021,2396,14046,2574,11788,751,4344,3325,16132,0.0616042617379184,0.20611207537813
2015,04023,140,461,89,414,69,388,158,802,0.027596173697612,0.197007481296758
2015,04025,1371,4939,2274,6352,104,385,2378,6737,0.0414013913128979,0.352976102122606
2015,04027,331,2205,1217,4794,226,1657,1443,6451,0.051439279164341,0.223686250193768
2015,05001,16,374,8,198,44,68,52,266,0.0205453000695142,0.195488721804511
2015,05003,62,160,3,175,0,4,3,179,0.0123815452721865,0.0167597765363128
2015,05005,75,643,160,711,0,64,160,775,0.0246775991084222,0.206451612903226
2015,05007,997,3284,2037,4938,991,1464,3028,6402,0.0415067427385892,0.472977194626679
2015,05009,44,669,109,693,0,44,109,737,0.0284534012817543,0.147896879240163
2015,05011,21,99,4,46,0,13,4,59,0.00771342659171134,0.0677966101694915
2015,05013,0,198,0,36,0,0,0,36,0.00963597430406852,0
2015,05015,56,416,182,640,20,71,202,711,0.036700562638724,0.284106891701828
2015,05017,23,292,11,188,5,5,16,193,0.0246960972488804,0.0829015544041451
2015,05019,77,482,26,196,0,46,26,242,0.0183583674707935,0.107438016528926
2015,05021,4,312,11,187,0,0,11,187,0.0171214063358359,0.0588235294117647
2015,05023,116,585,55,354,0,12,55,366,0.0194112967382657,0.150273224043716
2015,05025,10,113,3,33,0,0,3,33,0.00571131879543095,0.0909090909090909
2015,05027,42,275,35,138,23,23,58,161,0.010707635009311,0.360248447204969
2015,05029,111,388,159,306,0,9,159,315,0.0217496375060416,0.504761904761905
2015,05031,307,2433,332,1039,63,115,395,1154,0.0179661228048325,0.342287694974003
2015,05033,151,982,140,991,18,78,158,1069,0.0260464889625262,0.147801683816651
2015,05035,77,614,162,894,45,80,207,974,0.0312389749510889,0.212525667351129
2015,05037,73,356,0,68,0,0,0,68,0.00575004227972264,0
2015,05039,67,249,0,130,0,0,0,130,0.0241008527994067,0
2015,05041,20,139,3,78,19,19,22,97,0.0118538433337407,0.22680412371134
2015,05043,81,503,56,136,0,15,56,151,0.0129725085910653,0.370860927152318
2015,05045,562,2429,505,1273,0,14,505,1287,0.0178807118940773,0.392385392385392
2015,05047,97,709,32,233,0,22,32,255,0.0210900669919775,0.125490196078431
2015,05049,39,342,0,269,0,3,0,272,0.0303131617073443,0
2015,05051,409,1872,705,2280,49,131,754,2411,0.0348143762725081,0.31273330568229
2015,05053,34,375,5,171,0,0,5,171,0.0137958854376765,0.0292397660818713
2015,05055,93,834,47,520,34,35,81,555,0.0193251854173195,0.145945945945946
2015,05057,6,277,0,289,0,0,0,289,0.019534946599973,0
2015,05059,46,1020,13,146,0,0,13,146,0.00626045195317525,0.089041095890411
2015,05061,19,270,0,81,0,50,0,131,0.0146499664504585,0
2015,05063,69,639,134,462,0,35,134,497,0.0199190413209891,0.269617706237425
2015,05065,25,474,57,192,17,22,74,214,0.0212935323383085,0.345794392523364
2015,05067,56,1694,6,118,0,6,6,124,0.00984752223634053,0.0483870967741935
2015,05069,78,1077,92,444,14,55,106,499,0.0102367373733229,0.212424849699399
2015,05071,53,538,37,183,0,52,37,235,0.0138414418659442,0.157446808510638
2015,05073,43,140,14,90,0,16,14,106,0.0205705414321754,0.132075471698113
2015,05075,18,382,17,106,0,8,17,114,0.00991994430908458,0.149122807017544
2015,05077,23,250,1,89,0,31,1,120,0.0172043010752688,0.00833333333333333
2015,05079,21,661,0,110,0,4,0,114,0.0113016754238128,0
2015,05081,21,210,17,249,8,42,25,291,0.0322974472807991,0.0859106529209622
2015,05083,15,318,41,167,0,34,41,201,0.0132210747878708,0.203980099502488
2015,05085,285,1805,183,944,63,345,246,1289,0.0281238409006611,0.190845616757176
2015,05087,32,145,0,123,0,16,0,139,0.0129002320185615,0
2015,05089,38,517,60,607,0,0,60,607,0.0482205274864951,0.0988467874794069
2015,05091,7,956,63,1367,0,21,63,1388,0.0472028566570311,0.0453890489913545
2015,05093,124,767,139,699,0,45,139,744,0.0260878712437322,0.186827956989247
2015,05095,6,128,1,110,0,3,1,113,0.0208679593721145,0.00884955752212389
2015,05097,28,248,42,184,0,1,42,185,0.0275215709610235,0.227027027027027
2015,05099,13,145,1,70,30,48,31,118,0.0195623342175066,0.26271186440678
2015,05101,76,217,14,55,4,4,18,59,0.0099594868332208,0.305084745762712
2015,05103,72,383,43,149,0,1,43,150,0.00866150825730454,0.286666666666667
2015,05105,72,308,0,78,0,20,0,98,0.0136661553479292,0
2015,05107,6,107,23,225,0,0,23,225,0.0174243010919229,0.102222222222222
2015,05109,57,464,29,52,0,26,29,78,0.0101655154437638,0.371794871794872
2015,05111,39,742,9,141,0,42,9,183,0.0112242394504416,0.0491803278688525
2015,05113,14,139,35,355,0,0,35,355,0.0251327433628319,0.0985915492957746
2015,05115,130,1314,183,555,0,151,183,706,0.0178729652413863,0.259206798866856
2015,05117,48,184,0,19,0,0,0,19,0.00312911725955204,0
2015,05119,1614,6419,2286,5069,338,1092,2624,6161,0.0235220903773614,0.425904885570524
2015,05121,16,203,82,436,0,0,82,436,0.0355309265748513,0.188073394495413
2015,05123,43,421,47,881,28,106,75,987,0.05283160261214,0.0759878419452888
2015,05125,551,2526,473,1038,0,128,473,1166,0.014876433738629,0.405660377358491
2015,05127,11,126,40,124,0,0,40,124,0.0170681348933242,0.32258064516129
2015,05129,0,62,0,64,0,25,0,89,0.015234508729887,0
2015,05131,376,2143,698,2309,40,139,738,2448,0.0292427699401527,0.301470588235294
2015,05133,43,147,0,241,0,26,0,267,0.0250422059651097,0
2015,05135,74,640,7,167,0,0,7,167,0.0136059964151866,0.0419161676646707
2015,05137,163,440,21,185,63,98,84,283,0.0313921242373821,0.296819787985866
2015,05139,165,528,82,559,1,5,83,564,0.0203993055555556,0.147163120567376
2015,05141,48,268,14,219,4,32,18,251,0.0201768488745981,0.0717131474103586
2015,05143,978,3371,1751,3822,390,726,2141,4548,0.0350787884397344,0.4707563764292
2015,05145,223,1413,188,777,5,95,193,872,0.0173687879693258,0.221330275229358
2015,05147,0,94,3,38,0,0,3,38,0.00771730300568643,0.0789473684210526
2015,05149,58,482,0,113,10,29,10,142,0.00974070517217725,0.0704225352112676
2015,06001,21138,37093,10681,15393,6454,11080,17135,26473,0.0242384788713309,0.647263249348393
2015,06003,25,35,11,109,3,5,14,114,0.149214659685864,0.12280701754386
2015,06005,347,2083,51,185,4,69,55,254,0.00885758125261543,0.216535433070866
2015,06007,806,3883,580,1898,116,331,696,2229,0.0155771730470879,0.312247644683715
2015,06009,269,1296,33,372,19,19,52,391,0.01161995898838,0.132992327365729
2015,06011,35,306,24,114,0,45,24,159,0.0119584837545126,0.150943396226415
2015,06013,12629,26274,4663,8202,2932,5390,7595,13592,0.0183169978020142,0.558784579164214
2015,06015,171,1445,59,397,6,52,65,449,0.0229409360310648,0.144766146993318
2015,06017,1577,5069,514,1608,273,476,787,2084,0.0161680734856008,0.37763915547025
2015,06019,2557,13513,1032,3985,709,2382,1741,6367,0.0111392006438238,0.273441181089995
2015,06021,180,799,40,89,3,3,43,92,0.00514656522712016,0.467391304347826
2015,06023,701,2603,618,1592,25,39,643,1631,0.0180051884969918,0.394236664622931
2015,06025,364,2760,269,1128,212,746,481,1874,0.0174730305544937,0.25667022411953
2015,06027,93,461,76,269,2,32,78,301,0.0227410093683892,0.259136212624585
2015,06029,2222,19744,1791,5344,619,2149,2410,7493,0.0145938060560497,0.321633524622981
2015,06031,610,7528,365,1438,161,495,526,1933,0.0209830442239639,0.272115882048629
2015,06033,717,2704,189,767,20,105,209,872,0.0189071986123157,0.239678899082569
2015,06035,120,4122,52,377,0,80,52,457,0.0191533948030176,0.113785557986871
2015,06037,29092,68094,35224,61671,22631,45042,57855,106713,0.0160394121662833,0.542155126366984
2015,06039,422,5182,82,434,64,291,146,725,0.00765260346847655,0.201379310344828
2015,06041,4379,8806,1698,2746,938,1270,2636,4016,0.0212307041657856,0.656374501992032
2015,06043,113,535,32,163,13,32,45,195,0.0142470957843209,0.230769230769231
2015,06045,387,1934,393,1059,20,96,413,1155,0.0188426839812715,0.357575757575758
2015,06047,887,4928,197,906,91,421,288,1327,0.00870706341655457,0.217030896759608
2015,06049,4,131,32,257,0,0,32,257,0.0381645381645382,0.124513618677043
2015,06051,108,374,26,116,11,36,37,152,0.0156862745098039,0.243421052631579
2015,06053,2170,7716,2661,4939,876,1673,3537,6612,0.0245973907123645,0.534936479128857
2015,06055,1686,3382,499,981,134,407,633,1388,0.0143732913594565,0.456051873198847
2015,06057,1055,2573,598,1128,25,110,623,1238,0.0167485152265379,0.503231017770598
2015,06059,21589,46592,12048,21848,7322,14831,19370,36679,0.0176529502840287,0.528095095286131
2015,06061,3776,10242,1567,3221,374,1102,1941,4323,0.0171441488602294,0.448993754337266
2015,06063,152,488,66,312,9,36,75,348,0.0240497581202488,0.21551724137931
2015,06065,11799,54180,5231,17481,2505,7615,7736,25096,0.0174036181717186,0.308256295824036
2015,06067,8512,30886,4899,11476,2238,5488,7137,16964,0.0176180891788541,0.420714454138175
2015,06069,362,1574,30,153,26,137,56,290,0.00801592127812483,0.193103448275862
2015,06071,9400,51451,3934,14127,2501,6692,6435,20819,0.0163010754372022,0.309092655747154
2015,06073,11763,26408,20507,38641,9528,19728,30035,58369,0.0274234484132465,0.514571090818757
2015,06075,13807,20801,11757,14478,5850,8483,17607,22961,0.0348014162468247,0.766822002526022
2015,06077,3396,15673,1159,3678,607,2061,1766,5739,0.0131718468127298,0.307719114828367
2015,06079,2698,7396,1041,2200,259,651,1300,2851,0.0156108832660749,0.455980357769204
2015,06081,11440,20567,4396,6017,3087,5285,7483,11302,0.0213156400821544,0.662095204388604
2015,06083,2259,6488,2156,4476,864,2192,3020,6668,0.0248790188682061,0.452909418116377
2015,06085,15818,27240,15085,19116,15537,21460,30622,40576,0.0319841340533757,0.754682570977918
2015,06087,2522,6204,911,1486,323,645,1234,2131,0.0122540281307863,0.57907085875176
2015,06089,910,4210,592,2477,244,413,836,2890,0.0232322582719702,0.289273356401384
2015,06091,0,86,1,16,0,0,1,16,0.00657084188911704,0.0625
2015,06093,251,1002,93,527,21,44,114,571,0.0179362337050416,0.199649737302977
2015,06095,2862,11988,1299,3933,839,2032,2138,5965,0.0209466553827461,0.358424140821459
2015,06097,4025,9989,2081,4350,458,947,2539,5297,0.0153022166114416,0.47932792146498
2015,06099,1694,9228,514,2487,193,1017,707,3504,0.0106969176148072,0.201769406392694
2015,06101,424,2561,61,414,92,422,153,836,0.0137472867197264,0.183014354066986
2015,06103,211,1856,110,610,0,90,110,700,0.0163704396632367,0.157142857142857
2015,06105,68,428,5,144,0,0,5,144,0.013953488372093,0.0347222222222222
2015,06107,1059,5851,671,2806,104,846,775,3652,0.0139942674085314,0.212212486308872
2015,06109,277,2658,38,479,0,12,38,491,0.0120134080399305,0.0773930753564155
2015,06111,5273,12799,3133,6849,1284,2803,4417,9652,0.0175246519853223,0.457625362619146
2015,06113,1933,5894,853,1542,1179,1795,2032,3337,0.0276486623085017,0.608930176805514
2015,06115,227,2774,193,988,59,359,252,1347,0.029832565556343,0.187082405345212
2015,08001,4282,16544,2227,6144,300,1493,2527,7637,0.0257274913927274,0.330889092575619
2015,08003,171,703,79,160,0,15,79,175,0.0189189189189189,0.451428571428571
2015,08005,8591,24116,6334,13139,1247,2735,7581,15874,0.039164986886613,0.477573390449792
2015,08007,119,203,258,567,0,20,258,587,0.0648189045936396,0.439522998296422
2015,08009,36,95,19,59,0,0,19,59,0.0220643231114435,0.322033898305085
2015,08011,32,368,2,49,0,11,2,60,0.0123482197983124,0.0333333333333333
2015,08013,3323,7302,5357,7899,1193,1813,6550,9712,0.0488165308697204,0.674423393739704
2015,08014,1497,3940,1338,2176,79,192,1417,2368,0.0579256360078278,0.59839527027027
2015,08015,410,652,112,273,8,36,120,309,0.0215932914046122,0.388349514563107
2015,08017,31,85,7,14,0,5,7,19,0.0147744945567652,0.368421052631579
2015,08019,148,295,126,196,0,0,126,196,0.0278014184397163,0.642857142857143
2015,08021,24,154,12,36,15,25,27,61,0.0115159524259015,0.442622950819672
2015,08023,12,45,3,38,8,8,11,46,0.0173781639591991,0.239130434782609
2015,08025,23,297,0,55,0,0,0,55,0.0154407636159461,0
2015,08027,54,127,10,32,0,0,10,32,0.00949273212696529,0.3125
2015,08029,79,563,143,473,0,22,143,495,0.0227439808858666,0.288888888888889
2015,08031,11593,28777,13022,19177,1914,3695,14936,22872,0.0502229863704933,0.653025533403288
2015,08033,44,88,3,51,0,4,3,55,0.041075429424944,0.0545454545454545
2015,08035,4995,9369,4639,7634,781,979,5420,8613,0.0435301193249875,0.629281318936491
2015,08037,485,970,682,1057,22,291,704,1348,0.0373004233653394,0.522255192878338
2015,08039,230,920,254,513,0,25,254,538,0.0323647957649041,0.472118959107807
2015,08041,2157,6681,8686,22621,1609,5269,10295,27890,0.0672495442752288,0.369128719971316
2015,08043,182,1193,104,1081,9,61,113,1142,0.0318363023054835,0.0989492119089317
2015,08045,498,1274,280,1279,97,126,377,1405,0.0375106791969244,0.268327402135231
2015,08047,55,256,125,214,0,0,125,214,0.049514113836187,0.58411214953271
2015,08049,222,317,208,351,19,19,227,370,0.0353660867902887,0.613513513513513
2015,08051,87,275,154,244,2,2,156,246,0.0250228867866951,0.634146341463415
2015,08053,4,26,10,20,0,0,10,20,0.0275482093663912,0.5
2015,08055,44,168,123,187,2,6,125,193,0.0375778816199377,0.647668393782383
2015,08057,7,29,0,1,0,10,0,11,0.0106589147286822,0
2015,08059,7299,17528,4711,9884,776,1400,5487,11284,0.0290505036982496,0.486263736263736
2015,08061,7,10,12,19,0,0,12,19,0.0198537095088819,0.631578947368421
2015,08063,23,111,8,118,0,8,8,126,0.0227518959913326,0.0634920634920635
2015,08065,94,184,209,294,0,0,209,294,0.0588,0.710884353741497
2015,08067,241,751,1101,1957,49,106,1150,2063,0.0555555555555556,0.557440620455647
2015,08069,1963,4887,3952,7625,353,773,4305,8398,0.040908980198261,0.512622052869731
2015,08071,43,235,32,287,14,14,46,301,0.0289423076923077,0.152823920265781
2015,08073,10,269,19,57,0,0,19,57,0.014368540458785,0.333333333333333
2015,08075,13,748,16,249,0,64,16,313,0.0213520704004366,0.0511182108626198
2015,08077,500,2254,869,3223,124,295,993,3518,0.0354576332684923,0.282262649232518
2015,08079,4,20,1,10,0,0,1,10,0.0151745068285281,0.1
2015,08081,140,339,33,204,8,38,41,242,0.0280840199605431,0.169421487603306
2015,08083,172,582,293,1035,0,20,293,1055,0.0583743706080894,0.277725118483412
2015,08085,372,1186,388,1124,10,61,398,1185,0.0412030598052851,0.335864978902954
2015,08087,64,811,39,296,2,114,41,410,0.0225039793622043,0.1
2015,08089,62,396,7,166,0,4,7,170,0.0137030469127841,0.0411764705882353
2015,08091,94,136,59,204,0,0,59,204,0.0551948051948052,0.28921568627451
2015,08093,310,771,215,427,11,31,226,458,0.0365697860108592,0.493449781659389
2015,08095,28,236,4,37,13,50,17,87,0.0292338709677419,0.195402298850575
2015,08097,393,710,287,456,72,114,359,570,0.0429087624209575,0.629824561403509
2015,08099,46,315,0,144,2,6,2,150,0.0192727739946036,0.0133333333333333
2015,08101,550,2775,620,2245,58,288,678,2533,0.0234001866102525,0.267666798262929
2015,08103,26,104,16,206,10,10,26,216,0.0500695410292072,0.12037037037037
2015,08105,70,368,23,290,2,2,25,292,0.0365594090396895,0.0856164383561644
2015,08107,406,711,182,476,25,31,207,507,0.0298921054183126,0.408284023668639
2015,08109,42,168,20,62,0,0,20,62,0.0139923267885353,0.32258064516129
2015,08111,4,13,5,19,0,0,5,19,0.040084388185654,0.263157894736842
2015,08113,20,127,273,494,14,18,287,512,0.0890279951312815,0.560546875
2015,08115,17,105,0,85,0,2,0,87,0.0511163337250294,0
2015,08117,305,831,590,1078,39,96,629,1174,0.0547242809863422,0.535775127768313
2015,08119,285,893,146,617,16,35,162,652,0.0374906560864815,0.248466257668712
2015,08121,54,256,20,117,6,9,26,126,0.0369068541300527,0.206349206349206
2015,08123,1917,7496,1397,4828,216,542,1613,5370,0.0316500459721338,0.300372439478585
2015,08125,112,319,38,209,58,66,96,275,0.0406684412895593,0.349090909090909
2015,09001,1751,4778,10176,16187,2794,5242,12970,21429,0.0337532604997543,0.605254561575435
2015,09003,3548,9501,5087,9428,1929,3948,7016,13376,0.0216277746158224,0.524521531100478
2015,09005,987,2887,729,1529,100,362,829,1891,0.0139703600821525,0.438392384981491
2015,09007,1778,4163,690,1435,222,346,912,1781,0.0150410864039051,0.512071869736103
2015,09009,3137,8855,5121,9130,1716,3674,6837,12804,0.021661749181171,0.533973758200562
2015,09011,1071,4074,2027,4668,327,604,2354,5272,0.0279133795732514,0.446509863429439
2015,09013,1153,4189,667,1392,300,425,967,1817,0.0190445245681704,0.532195927352779
2015,09015,399,1908,313,1405,47,254,360,1659,0.0206379220262235,0.216998191681736
2015,10001,582,2251,673,2927,173,524,846,3451,0.0312364228819696,0.245146334395827
2015,10003,313,2355,6489,13006,1358,2244,7847,15250,0.0413179477036704,0.51455737704918
2015,10005,276,1423,1853,5677,79,319,1932,5996,0.0395647612323407,0.322214809873249
2015,11001,0,0,21698,29690,5363,6343,27061,36033,0.079376233610602,0.751006022257375
2015,12001,1584,5073,2717,3987,973,1455,3690,5442,0.0359958725791089,0.67805953693495
2015,12003,51,1182,40,332,15,55,55,387,0.0217586866074441,0.142118863049096
2015,12005,721,2787,1118,4907,262,785,1380,5692,0.0467557643811761,0.242445537596627
2015,12007,146,1906,14,140,0,0,14,140,0.00717985537719883,0.1
2015,12009,2092,7420,3529,13200,634,1624,4163,14824,0.0365848542059996,0.280828386400432
2015,12011,9574,30290,9772,25363,6729,18352,16501,43715,0.0339860774865463,0.377467688436463
2015,12013,44,628,0,84,0,0,0,84,0.00813480534572923,0
2015,12015,768,4848,1329,6008,274,775,1603,6783,0.0505401981968557,0.236326109391125
2015,12017,385,2859,570,2913,76,205,646,3118,0.0283083962812318,0.207184092366902
2015,12019,1486,6744,1158,3537,220,640,1378,4177,0.0317937554232824,0.329901843428298
2015,12021,1578,5957,4441,10393,1221,2551,5662,12944,0.0509249423632258,0.437422744128554
2015,12023,329,3217,220,946,21,130,241,1076,0.0230935977507351,0.223977695167286
2015,12027,73,1580,73,494,0,257,73,751,0.0313622316879646,0.0972037283621838
2015,12029,44,952,15,365,0,0,15,365,0.0304649027627076,0.0410958904109589
2015,12031,4560,13573,5725,16380,1060,3090,6785,19470,0.03258664667171,0.348484848484849
2015,12033,1071,3828,2333,7520,317,759,2650,8279,0.0409693286750661,0.320086967025003
2015,12035,654,2148,794,2870,30,313,824,3183,0.0423772816231977,0.258875274897895
2015,12037,31,924,93,236,0,12,93,248,0.0280384397964952,0.375
2015,12039,145,2201,27,205,96,169,123,374,0.0117289177407721,0.328877005347594
2015,12041,49,487,43,168,9,25,52,193,0.0170826694990264,0.269430051813472
2015,12043,49,638,62,270,23,33,85,303,0.030547434217159,0.280528052805281
2015,12045,57,1059,78,343,0,10,78,353,0.0297038034331875,0.220963172804533
2015,12047,34,1093,5,67,0,15,5,82,0.00853189054208719,0.0609756097560976
2015,12049,31,728,27,408,29,103,56,511,0.0291483657520963,0.10958904109589
2015,12051,132,1169,134,558,59,639,193,1197,0.0500522684507631,0.161236424394319
2015,12053,628,4258,491,3770,110,439,601,4209,0.0325026834598485,0.142789261107151
2015,12055,343,2303,424,2538,82,716,506,3254,0.0437424384997984,0.155500921942225
2015,12057,7246,20681,8842,22070,3554,8566,12396,30636,0.0351374197003983,0.404622013317666
2015,12059,80,810,91,355,0,25,91,380,0.0273696341112071,0.239473684210526
2015,12061,771,4180,1031,3771,151,514,1182,4285,0.0398060326808922,0.275845974329055
2015,12063,147,2216,135,585,19,46,154,631,0.017866749723929,0.24405705229794
2015,12065,63,1061,46,192,9,26,55,218,0.0201144122531832,0.252293577981651
2015,12067,38,585,0,49,0,28,0,77,0.0129498822737975,0
2015,12069,2502,8769,1288,7024,230,764,1518,7788,0.0343753034543031,0.194915254237288
2015,12071,1914,9891,6385,21458,990,3984,7375,25442,0.0519883362383756,0.289875009826272
2015,12073,1642,5289,2535,4508,742,1048,3277,5556,0.0339964143450673,0.589812814974802
2015,12075,158,1406,37,617,0,43,37,660,0.0228682304840442,0.0560606060606061
2015,12077,16,683,9,61,8,8,17,69,0.0120713785864241,0.246376811594203
2015,12079,61,994,0,181,0,27,0,208,0.0158633312995729,0
2015,12081,2023,7597,4195,10876,605,2068,4800,12944,0.0514265054688338,0.370828182941904
2015,12083,1280,8160,1704,7527,302,792,2006,8319,0.033424001478547,0.24113475177305
2015,12085,1285,4689,1848,4581,151,532,1999,5113,0.0441483758440258,0.390964208879327
2015,12086,4722,16239,8950,18339,11464,28253,20414,46592,0.0253390082153816,0.438143887362637
2015,12087,573,1894,1200,2681,287,1038,1487,3719,0.0629911924119241,0.399838666308147
2015,12089,362,1948,575,1793,171,200,746,1993,0.0367082312636988,0.374310085298545
2015,12091,791,3185,1737,5852,245,834,1982,6686,0.0513845231599253,0.296440323063117
2015,12093,39,675,32,507,10,49,42,556,0.0208255300022474,0.0755395683453237
2015,12095,7597,25033,7577,20578,4302,11200,11879,31778,0.0396170196850885,0.373812071244257
2015,12097,1367,7245,1132,4441,1087,3341,2219,7782,0.0398835576420423,0.28514520688769
2015,12099,8156,20747,11224,26057,3705,10403,14929,36460,0.0365982682574767,0.409462424574877
2015,12101,2394,10045,2346,8828,325,1552,2671,10380,0.0300085862717945,0.257321772639692
2015,12103,4985,15037,7474,20592,1573,4614,9047,25206,0.0358182231569374,0.358922478774895
2015,12105,2272,10979,2037,10393,615,2534,2652,12927,0.030227424717882,0.205152007426317
2015,12107,131,1510,146,947,20,115,166,1062,0.0207754606987754,0.156308851224105
2015,12109,3002,6940,2748,4826,491,1059,3239,5885,0.0399994562520815,0.550382327952421
2015,12111,1814,8373,1500,5985,170,1231,1670,7216,0.0352416022817179,0.231430155210643
2015,12113,887,4706,1929,5160,116,482,2045,5642,0.0511885320268554,0.362460120524637
2015,12115,2266,8403,4610,11998,838,2199,5448,14197,0.0459542044034725,0.383743044305135
2015,12117,4168,13418,2879,6288,862,2503,3741,8791,0.0292357986384784,0.425548856785349
2015,12119,571,2806,2410,5882,86,593,2496,6475,0.0672944013136699,0.385482625482625
2015,12121,112,1741,76,616,0,29,76,645,0.0212709824225835,0.117829457364341
2015,12123,34,1821,59,231,8,27,67,258,0.0156857976653696,0.25968992248062
2015,12125,22,1517,9,78,0,4,9,82,0.00745251295101336,0.109756097560976
2015,12127,2181,10071,2986,12380,479,1751,3465,14131,0.0384062402326498,0.245205576392329
2015,12129,147,2069,101,346,0,39,101,385,0.0173885551691432,0.262337662337662
2015,12131,405,2271,696,1509,51,51,747,1560,0.0360385335089057,0.478846153846154
2015,12133,90,1737,48,152,0,15,48,167,0.00954449334171572,0.287425149700599
2015,13001,153,384,5,117,0,2,5,119,0.0097564974993851,0.0420168067226891
2015,13003,1,102,8,89,0,10,8,99,0.0188787185354691,0.0808080808080808
2015,13005,21,369,11,31,0,0,11,31,0.00422631220177232,0.354838709677419
2015,13007,4,60,0,6,0,0,0,6,0.0026525198938992,0
2015,13009,167,1149,119,298,0,14,119,312,0.0112339322363447,0.381410256410256
2015,13011,65,498,7,68,0,32,7,100,0.00806842020332419,0.07
2015,13013,289,2269,49,434,4,4,53,438,0.00943213385877641,0.121004566210046
2015,13015,350,2347,106,792,22,59,128,851,0.0128081635110322,0.150411280846063
2015,13017,214,430,0,110,0,45,0,155,0.0136371634699982,0
2015,13019,8,298,0,194,22,27,22,221,0.0173428549007298,0.0995475113122172
2015,13021,1071,3966,374,1242,104,300,478,1542,0.0155065264174091,0.309987029831388
2015,13023,128,303,0,40,0,0,0,40,0.00506457330969866,0
2015,13025,15,340,1,539,0,0,1,539,0.0447043211412457,0.00185528756957328
2015,13027,43,538,0,214,0,13,0,227,0.0211714232419325,0
2015,13029,391,1077,495,891,191,260,686,1151,0.0549744471509767,0.596003475238923
2015,13031,205,1112,202,658,57,67,259,725,0.0189309867613651,0.357241379310345
2015,13033,26,482,26,101,9,9,35,110,0.00749982954932842,0.318181818181818
2015,13035,97,1700,37,219,0,16,37,235,0.014615336774675,0.157446808510638
2015,13037,38,675,2,78,0,1,2,79,0.0174162257495591,0.0253164556962025
2015,13039,109,512,327,1674,54,190,381,1864,0.059034045922407,0.204399141630901
2015,13043,44,415,16,82,0,0,16,82,0.0115492957746479,0.195121951219512
2015,13045,773,3453,294,987,60,303,354,1290,0.0185233049022142,0.274418604651163
2015,13047,78,1081,364,1573,2,2,366,1575,0.0356584935135502,0.232380952380952
2015,13049,0,878,5,381,1,23,6,404,0.0430061741537151,0.0148514851485149
2015,13051,1305,4849,3351,8077,415,1500,3766,9577,0.0523868652666933,0.393233789286833
2015,13053,39,284,618,1417,134,310,752,1727,0.331796349663785,0.435437174290677
2015,13055,16,437,0,210,0,33,0,243,0.0140170742962621,0
2015,13057,2022,6415,1278,3562,95,170,1373,3732,0.0252053166198401,0.367899249732047
2015,13059,855,2558,984,1629,376,533,1360,2162,0.033352874024251,0.62904717853839
2015,13061,2,45,0,100,0,0,0,100,0.0489476260401371,0
2015,13063,1207,9986,706,4105,63,650,769,4755,0.0291279977947257,0.161724500525762
2015,13065,44,236,0,81,0,10,0,91,0.0202989069819317,0
2015,13067,8870,20315,7214,14560,1723,3133,8937,17693,0.0373467806792204,0.505115017238456
2015,13069,83,713,115,273,0,117,115,390,0.0142642917230533,0.294871794871795
2015,13071,139,809,82,656,5,35,87,691,0.0234428009227846,0.125904486251809
2015,13073,866,2622,1617,3534,128,523,1745,4057,0.0456745924524903,0.430120778900666
2015,13075,65,319,22,141,0,115,22,256,0.022941123756609,0.0859375
2015,13077,836,4171,444,1853,225,285,669,2138,0.0244300976975376,0.312909260991581
2015,13079,29,294,0,62,0,6,0,68,0.00775812892184826,0
2015,13081,54,485,10,90,16,36,26,126,0.00820419325432999,0.206349206349206
2015,13083,3,177,36,333,5,5,41,338,0.0302271507780361,0.121301775147929
2015,13085,239,857,38,149,12,12,50,161,0.0100788781770377,0.31055900621118
2015,13087,94,611,15,360,0,15,15,375,0.0208344908050447,0.04
2015,13089,10142,24040,6390,12995,2125,4564,8515,17559,0.0366331469581908,0.484936499800672
2015,13091,19,334,0,88,0,1,0,89,0.00613412364739127,0
2015,13093,9,438,0,15,0,0,0,15,0.00150678051230537,0
2015,13095,536,2534,307,1021,14,75,321,1096,0.0187980241492865,0.292883211678832
2015,13097,1262,4241,501,2139,91,425,592,2564,0.0294185139290468,0.230889235569423
2015,13099,11,62,0,23,0,0,0,23,0.00325871351657693,0
2015,13101,6,145,0,16,0,55,0,71,0.0276803118908382,0
2015,13103,190,877,182,962,0,31,182,993,0.0283925201578315,0.183282980866062
2015,13105,0,164,26,210,0,12,26,222,0.0163970751163306,0.117117117117117
2015,13107,107,644,11,277,0,22,11,299,0.0202013377474495,0.0367892976588629
2015,13109,98,453,13,145,0,0,13,145,0.0208004590446134,0.0896551724137931
2015,13111,91,348,27,641,22,54,49,695,0.038534043025061,0.0705035971223022
2015,13113,1107,3076,821,1759,217,429,1038,2188,0.0300359662850397,0.474405850091408
2015,13115,376,2189,298,909,56,109,354,1018,0.0160709775195757,0.347740667976424
2015,13117,2252,4975,1442,3098,322,705,1764,3803,0.0302189943423813,0.463844333420983
2015,13119,100,670,31,119,11,22,42,141,0.00933527542372881,0.297872340425532
2015,13121,13739,29178,11233,19508,2902,4779,14135,24287,0.0373390524948305,0.581998600074114
2015,13123,155,825,122,653,10,154,132,807,0.0391823655078656,0.163568773234201
2015,13125,10,47,0,3,0,0,0,3,0.00144439094848339,0
2015,13127,657,1936,359,1327,75,195,434,1522,0.0272750080642271,0.28515111695138
2015,13129,252,1185,72,531,0,62,72,593,0.0162568193656277,0.12141652613828
2015,13131,6,395,71,631,0,9,71,640,0.0382203642878471,0.1109375
2015,13133,94,372,65,174,0,45,65,219,0.0181923907625851,0.296803652968037
2015,13135,6290,16408,5591,14244,1514,3726,7105,17970,0.0332671199782292,0.395381190873678
2015,13137,165,1113,30,319,23,47,53,366,0.0124477094174064,0.144808743169399
2015,13139,1146,4404,483,2066,68,246,551,2312,0.0192716451750035,0.238321799307958
2015,13141,25,558,0,43,0,59,0,102,0.0157626332869726,0
2015,13143,114,826,30,305,0,17,30,322,0.0169117647058824,0.093167701863354
2015,13145,266,1377,69,284,26,29,95,313,0.0137028281236319,0.303514376996805
2015,13147,60,546,46,344,0,21,46,365,0.020486052646349,0.126027397260274
2015,13149,33,435,4,117,3,3,7,120,0.0154004106776181,0.0583333333333333
2015,13151,1341,5352,598,2790,314,599,912,3389,0.0253366128634335,0.269105930953083
2015,13153,620,2983,622,2109,242,500,864,2609,0.0275266139838153,0.331161364507474
2015,13155,18,239,12,123,0,0,12,123,0.0190816009928638,0.0975609756097561
2015,13157,212,1387,75,383,30,106,105,489,0.0120375156930803,0.214723926380368
2015,13159,74,600,36,155,4,43,40,198,0.0215897939156035,0.202020202020202
2015,13161,14,104,0,9,0,13,0,22,0.00228429031253245,0
2015,13163,40,402,74,208,0,4,74,212,0.0194620398421004,0.349056603773585
2015,13165,50,357,0,80,0,0,0,80,0.0134589502018843,0
2015,13167,22,406,8,67,0,0,8,67,0.00996430696014277,0.119402985074627
2015,13169,155,1000,8,64,0,36,8,100,0.00519966722129784,0.08
2015,13171,76,558,0,126,0,0,0,126,0.0108200944611421,0
2015,13173,56,663,10,153,90,90,100,243,0.0348637015781923,0.411522633744856
2015,13175,115,740,102,313,9,75,111,388,0.0121733128353152,0.286082474226804
2015,13177,314,1398,96,425,49,53,145,478,0.0254241795649168,0.303347280334728
2015,13179,219,1256,478,2702,180,1103,658,3805,0.10570031668426,0.172930354796321
2015,13181,23,143,40,87,0,0,40,87,0.0154666666666667,0.459770114942529
2015,13183,220,972,73,436,32,74,105,510,0.0516246583662314,0.205882352941176
2015,13185,357,1853,659,2232,154,482,813,2714,0.0421003645388971,0.299557848194547
2015,13187,387,1445,171,435,22,158,193,593,0.0297004908344185,0.325463743676223
2015,13189,51,394,53,252,0,0,53,252,0.0176966292134831,0.21031746031746
2015,13191,65,581,4,154,0,0,4,154,0.0148390826748892,0.025974025974026
2015,13193,10,550,0,54,0,0,0,54,0.00555669890924058,0
2015,13195,121,651,35,253,4,29,39,282,0.0146326276463263,0.138297872340426
2015,13197,20,372,11,71,0,0,11,71,0.0117181052979039,0.154929577464789
2015,13199,119,857,45,74,0,7,45,81,0.00550496126138372,0.555555555555556
2015,13201,0,112,7,23,0,4,7,27,0.00670307845084409,0.259259259259259
2015,13205,26,922,6,221,0,19,6,240,0.0156138182291328,0.025
2015,13207,253,1167,53,383,0,11,53,394,0.0210099717378553,0.134517766497462
2015,13209,54,336,10,71,0,0,10,71,0.011958901802257,0.140845070422535
2015,13211,64,229,44,173,0,49,44,222,0.0183380142078308,0.198198198198198
2015,13213,53,700,14,152,0,13,14,165,0.00642873840878984,0.0848484848484849
2015,13215,816,3735,2423,6407,546,1303,2969,7710,0.0604435664056069,0.385084306095979
2015,13217,254,3043,215,1367,117,173,332,1540,0.023784885786214,0.215584415584416
2015,13219,251,831,169,333,12,31,181,364,0.0162980209545984,0.497252747252747
2015,13221,190,769,54,176,0,13,54,189,0.0179606576071463,0.285714285714286
2015,13223,952,4467,633,1584,27,210,660,1794,0.0193577625275152,0.367892976588629
2015,13225,165,944,0,140,0,21,0,161,0.00967373670612269,0
2015,13227,62,655,167,477,0,21,167,498,0.0230801316216341,0.335341365461847
2015,13229,88,494,45,70,11,11,56,81,0.0065028901734104,0.691358024691358
2015,13231,41,880,27,68,1,1,28,69,0.00580514891468955,0.405797101449275
2015,13233,188,1172,10,185,0,45,10,230,0.00857728883087824,0.0434782608695652
2015,13235,5,400,5,82,0,29,5,111,0.0131221184537179,0.045045045045045
2015,13237,196,713,53,253,12,153,65,406,0.025859872611465,0.160098522167488
2015,13239,0,21,4,105,0,0,4,105,0.0616197183098592,0.0380952380952381
2015,13241,52,168,109,232,20,20,129,252,0.0209111277072442,0.511904761904762
2015,13243,26,238,0,59,0,0,0,59,0.0119748325553075,0
2015,13245,1014,3894,1641,4541,176,713,1817,5254,0.0407738811240367,0.345831747240198
2015,13247,477,2874,386,1592,42,231,428,1823,0.032455047178209,0.234777838727372
2015,13249,15,156,11,41,0,0,11,41,0.0128205128205128,0.268292682926829
2015,13251,29,315,0,43,0,34,0,77,0.00819061801935964,0
2015,13253,50,113,11,65,0,0,11,65,0.0106697307944846,0.169230769230769
2015,13255,294,2169,170,788,0,28,170,816,0.0192298628458312,0.208333333333333
2015,13257,79,404,12,132,29,35,41,167,0.00973080060598998,0.245508982035928
2015,13259,43,532,17,403,18,101,35,504,0.118672003767365,0.0694444444444444
2015,13261,126,821,13,130,0,28,13,158,0.00805259670760919,0.0822784810126582
2015,13263,26,176,0,14,0,8,0,22,0.00466497031382528,0
2015,13265,13,37,1,4,0,5,1,9,0.00687547746371276,0.111111111111111
2015,13267,65,2189,6,160,0,41,6,201,0.0115087317492127,0.0298507462686567
2015,13269,34,373,2,102,0,22,2,124,0.021689697393738,0.0161290322580645
2015,13271,32,129,0,1,0,6,0,7,0.000569522414775039,0
2015,13273,17,346,0,26,0,0,0,26,0.00424143556280587,0
2015,13275,115,637,93,472,0,74,93,546,0.018038256962569,0.17032967032967
2015,13277,92,729,120,306,6,76,126,382,0.0149499060738885,0.329842931937173
2015,13279,74,340,7,143,0,50,7,193,0.0110747690365525,0.0362694300518135
2015,13281,39,153,102,249,0,18,102,267,0.0338103077117893,0.382022471910112
2015,13283,8,249,0,12,0,15,0,27,0.00566037735849057,0
2015,13285,296,1585,173,1053,95,257,268,1310,0.0297679914559047,0.204580152671756
2015,13287,6,155,0,24,0,57,0,81,0.0147245955280858,0
2015,13289,26,239,0,0,1,3,1,3,0.000496442164487837,0.333333333333333
2015,13291,19,206,90,323,34,34,124,357,0.0212639228065996,0.34733893557423
2015,13293,26,434,19,193,0,0,19,193,0.0107002273105284,0.0984455958549223
2015,13295,175,1457,398,1404,0,34,398,1438,0.0304570678188673,0.276773296244784
2015,13297,482,1767,110,1006,0,117,110,1123,0.0198112375407956,0.0979519145146928
2015,13299,192,1316,57,414,17,44,74,458,0.0192041595035431,0.161572052401747
2015,13301,28,99,8,10,0,0,8,10,0.00261028452101279,0.8
2015,13303,52,668,9,51,0,23,9,74,0.00522820404126042,0.121621621621622
2015,13305,169,709,194,635,0,63,194,698,0.0346642828764402,0.277936962750716
2015,13307,0,21,0,61,0,8,0,69,0.037156704361874,0
2015,13309,0,80,0,15,0,0,0,15,0.00252908447142135,0
2015,13311,177,410,20,137,0,0,20,137,0.00707461915827524,0.145985401459854
2015,13313,116,1574,270,1190,31,124,301,1314,0.0201815417223425,0.229071537290715
2015,13315,14,557,0,80,0,9,0,89,0.0138672483639763,0
2015,13317,25,259,47,88,0,0,47,88,0.0124982246839938,0.534090909090909
2015,13319,7,180,0,22,0,17,0,39,0.00608804246019357,0
2015,13321,43,478,7,149,0,0,7,149,0.0104152104012303,0.0469798657718121
2015,15001,301,1180,1653,4095,325,773,1978,4868,0.036564389529425,0.4063270336894
2015,15003,437,1743,9053,23536,3282,8032,12335,31568,0.0473020962884157,0.390743791180943
2015,15005,0,0,2,2,0,0,2,2,0.0256410256410256,1
2015,15007,222,586,610,1244,66,359,676,1603,0.0327390070052897,0.42170929507174
2015,15009,158,1037,1150,3254,352,970,1502,4224,0.0375446642845715,0.355587121212121
2015,16001,1473,5690,4550,10011,723,1327,5273,11338,0.0413210490254676,0.46507320515082
2015,16003,32,181,14,98,0,0,14,98,0.0339100346020761,0.142857142857143
2015,16005,203,1696,503,1551,59,144,562,1695,0.0327447647013368,0.331563421828909
2015,16007,39,88,30,95,0,0,30,95,0.0242656449553001,0.315789473684211
2015,16009,13,112,24,128,0,6,24,134,0.0209965528047634,0.17910447761194
2015,16011,118,803,100,415,0,9,100,424,0.0156781541192131,0.235849056603774
2015,16013,35,146,217,424,60,65,277,489,0.0326173959445037,0.566462167689162
2015,16015,50,368,49,142,0,3,49,145,0.0278578290105668,0.337931034482759
2015,16017,163,644,225,998,0,26,225,1024,0.0340561394173207,0.2197265625
2015,16019,416,1658,615,1732,162,386,777,2118,0.0325415603970132,0.36685552407932
2015,16021,25,125,130,361,6,27,136,388,0.0507322175732218,0.350515463917526
2015,16023,5,50,16,41,0,1,16,42,0.0239589275527667,0.380952380952381
2015,16025,0,9,10,24,0,0,10,24,0.0330578512396694,0.416666666666667
2015,16027,670,4469,1054,3752,12,235,1066,3987,0.0332885256030258,0.267368949084525
2015,16029,24,72,7,67,0,34,7,101,0.0229180848649875,0.0693069306930693
2015,16031,164,609,86,296,1,50,87,346,0.0253479853479853,0.251445086705202
2015,16033,0,9,4,12,0,0,4,12,0.0222634508348794,0.333333333333333
2015,16035,63,379,47,177,0,0,47,177,0.0265486725663717,0.265536723163842
2015,16037,34,93,0,21,2,2,2,23,0.00698663426488457,0.0869565217391304
2015,16039,94,434,101,641,61,462,162,1103,0.0704792332268371,0.14687216681777
2015,16041,15,63,107,348,2,22,109,370,0.0496844366859138,0.294594594594595
2015,16043,36,204,60,176,0,23,60,199,0.0243157380254154,0.301507537688442
2015,16045,71,427,111,488,0,22,111,510,0.0432056929854287,0.217647058823529
2015,16047,55,275,5,126,10,33,15,159,0.016624843161857,0.0943396226415094
2015,16049,116,502,55,379,0,5,55,384,0.0322174679083816,0.143229166666667
2015,16051,163,568,111,270,23,76,134,346,0.022722795035135,0.38728323699422
2015,16053,47,582,43,212,0,166,43,378,0.0280623608017817,0.113756613756614
2015,16055,165,1388,1125,4148,81,183,1206,4331,0.0441056662185832,0.278457631032094
2015,16057,180,517,432,1099,123,165,555,1264,0.059123438888629,0.439082278481013
2015,16059,7,58,50,238,0,0,50,238,0.0399664147774979,0.210084033613445
2015,16061,18,127,9,42,0,0,9,42,0.0153846153846154,0.214285714285714
2015,16063,38,147,11,51,0,1,11,52,0.0165079365079365,0.211538461538462
2015,16065,56,523,330,927,32,118,362,1045,0.0668457749632188,0.346411483253589
2015,16067,34,542,13,154,0,131,13,285,0.0224568591915531,0.0456140350877193
2015,16069,92,422,235,923,0,4,235,927,0.0336980624522883,0.253505933117584
2015,16071,0,7,6,128,0,0,6,128,0.047779022023143,0.046875
2015,16073,40,450,9,329,0,16,9,345,0.0472279260780287,0.0260869565217391
2015,16075,35,426,110,784,29,38,139,822,0.0556382834709625,0.169099756690998
2015,16077,11,171,3,79,3,15,6,94,0.0200597524541187,0.0638297872340425
2015,16079,32,243,52,180,1,5,53,185,0.0201371503211059,0.286486486486487
2015,16081,24,71,246,505,108,121,354,626,0.0942203491872366,0.565495207667732
2015,16083,353,1976,296,1383,0,153,296,1536,0.0303977834949535,0.192708333333333
2015,16085,8,467,142,377,0,0,142,377,0.0518712162905889,0.376657824933687
2015,16087,8,211,16,154,2,10,18,164,0.0234957020057307,0.109756097560976
2015,17001,102,325,107,664,6,36,113,700,0.0151876762855283,0.161428571428571
2015,17003,9,124,62,147,0,0,62,147,0.0296909715209049,0.421768707482993
2015,17005,112,621,34,155,0,0,34,155,0.0129555332664661,0.219354838709677
2015,17007,114,1258,164,441,3,52,167,493,0.0142197865589847,0.338742393509128
2015,17009,7,614,0,39,39,39,39,78,0.0154180668116228,0.5
2015,17011,200,602,55,214,0,1,55,215,0.0089673006339673,0.255813953488372
2015,17013,0,39,8,24,0,8,8,32,0.00887656033287101,0.25
2015,17015,22,236,16,125,4,24,20,149,0.0136384439359268,0.134228187919463
2015,17017,69,311,33,150,35,80,68,230,0.0258050039268484,0.295652173913043
2015,17019,1115,2446,1931,3284,1274,1735,3205,5019,0.0426256518268137,0.638573421000199
2015,17021,107,959,93,302,0,30,93,332,0.0138223906074358,0.280120481927711
2015,17023,30,156,30,223,10,27,40,250,0.0222796542197665,0.16
2015,17025,35,178,14,62,0,0,14,62,0.00661968823403801,0.225806451612903
2015,17027,95,1030,101,262,0,1,101,263,0.0098875897590135,0.384030418250951
2015,17029,248,893,165,654,37,42,202,696,0.0215146831530139,0.290229885057471
2015,17031,14952,30156,33692,53378,14537,24159,48229,77537,0.0219205756904019,0.622012716509537
2015,17033,42,660,9,135,0,3,9,138,0.00990809879379667,0.0652173913043478
2015,17035,35,342,36,152,0,0,36,152,0.0200342691445894,0.236842105263158
2015,17037,861,2490,265,594,207,272,472,866,0.0143220983693315,0.545034642032333
2015,17039,32,426,24,91,0,6,24,97,0.00834911344465485,0.247422680412371
2015,17041,23,173,62,117,0,22,62,139,0.0105446821423153,0.446043165467626
2015,17043,11038,21773,4999,8118,2357,4356,7356,12474,0.0198794547094578,0.58970658970659
2015,17045,69,328,75,310,0,0,75,310,0.0242357907903995,0.241935483870968
2015,17047,11,119,11,26,0,2,11,28,0.00604621032174476,0.392857142857143
2015,17049,77,461,84,212,45,62,129,274,0.0118409680207433,0.470802919708029
2015,17051,63,877,40,199,0,0,40,199,0.0130201517927244,0.201005025125628
2015,17053,90,393,64,97,11,15,75,112,0.0115882048629074,0.669642857142857
2015,17055,115,537,46,275,7,63,53,338,0.0122078954021743,0.156804733727811
2015,17057,65,1035,30,265,10,52,40,317,0.0121731116316578,0.126182965299685
2015,17059,22,77,0,32,0,2,0,34,0.00873362445414847,0
2015,17061,51,276,0,80,0,0,0,80,0.00842992623814542,0
2015,17063,143,951,74,212,37,39,111,251,0.00760490834722012,0.442231075697211
2015,17065,16,149,3,15,0,5,3,20,0.00342348510783978,0.15
2015,17067,48,160,119,315,0,25,119,340,0.0252412769116555,0.35
2015,17069,13,76,5,28,0,0,5,28,0.00916530278232406,0.178571428571429
2015,17071,53,178,55,154,0,7,55,161,0.0309258547829428,0.341614906832298
2015,17073,143,876,111,352,28,46,139,398,0.0115419192065656,0.349246231155779
2015,17075,111,545,29,197,12,24,41,221,0.0108781256152786,0.18552036199095
2015,17077,317,1221,288,938,150,293,438,1231,0.0351152441807394,0.355808285946385
2015,17079,17,165,3,28,0,10,3,38,0.00561465721040189,0.0789473684210526
2015,17081,137,1069,84,313,16,44,100,357,0.0133343293616703,0.280112044817927
2015,17083,75,441,100,170,0,15,100,185,0.0119193350943882,0.540540540540541
2015,17085,119,355,44,180,0,17,44,197,0.0119961027889417,0.223350253807107
2015,17087,15,781,36,88,9,12,45,100,0.0106997646051787,0.45
2015,17089,4077,11154,1069,3589,396,1461,1465,5050,0.0151013585241936,0.29009900990099
2015,17091,274,1707,172,718,48,229,220,947,0.0129596430966294,0.232312565997888
2015,17093,1108,3594,131,1140,92,92,223,1232,0.0164240388204554,0.181006493506494
2015,17095,176,1270,85,262,10,77,95,339,0.00932574069489147,0.28023598820059
2015,17097,4650,9280,4247,9045,1515,2702,5762,11747,0.0259948041372168,0.490508214863369
2015,17099,462,2394,231,660,0,54,231,714,0.0091484509135638,0.323529411764706
2015,17101,18,1219,35,229,0,56,35,285,0.0231462681718509,0.12280701754386
2015,17103,215,1534,106,244,11,61,117,305,0.012226899178192,0.383606557377049
2015,17105,188,1594,49,222,7,46,56,268,0.0100918813074258,0.208955223880597
2015,17107,124,2514,63,165,1,30,64,195,0.0093543125779526,0.328205128205128
2015,17109,174,569,176,243,6,46,182,289,0.0157561879838622,0.629757785467128
2015,17111,1813,4900,1003,2898,60,248,1063,3146,0.0155004385057301,0.337889383343929
2015,17113,1221,2494,1350,2315,595,717,1945,3032,0.0291726400661965,0.641490765171504
2015,17115,412,1727,362,946,46,144,408,1090,0.014648962477153,0.374311926605505
2015,17117,89,1026,112,343,0,43,112,386,0.0117643473225443,0.290155440414508
2015,17119,999,3657,728,2396,152,272,880,2668,0.0145819441863516,0.329835082458771
2015,17121,48,488,71,339,2,47,73,386,0.0145254760292015,0.189119170984456
2015,17123,65,297,9,50,4,24,13,74,0.00849305635257661,0.175675675675676
2015,17125,30,321,24,77,0,11,24,88,0.00875883348263163,0.272727272727273
2015,17127,29,136,21,320,0,3,21,323,0.0304774485752029,0.065015479876161
2015,17129,44,256,7,107,0,0,7,107,0.0121356470454803,0.0654205607476635
2015,17131,31,230,18,76,0,4,18,80,0.00703173068471478,0.225
2015,17133,77,674,189,496,12,33,201,529,0.0226416709467557,0.379962192816635
2015,17135,53,2255,39,261,0,5,39,266,0.0127358038877717,0.146616541353383
2015,17137,279,1178,48,276,61,84,109,360,0.0149452009299236,0.302777777777778
2015,17139,51,310,25,49,6,39,31,88,0.00863930885529158,0.352272727272727
2015,17141,143,1000,88,314,6,122,94,436,0.0121418028906402,0.215596330275229
2015,17143,1239,3285,1002,2232,386,611,1388,2843,0.0229207649392112,0.488216672529019
2015,17145,95,824,34,83,0,5,34,88,0.00574525037539988,0.386363636363636
2015,17147,144,445,53,73,0,5,53,78,0.00674332151811187,0.67948717948718
2015,17149,34,370,27,143,0,56,27,199,0.017693607184138,0.135678391959799
2015,17151,11,72,13,67,0,0,13,67,0.0212833545108005,0.194029850746269
2015,17153,0,53,0,51,0,8,0,59,0.0145535273803651,0
2015,17155,5,123,0,48,4,6,4,54,0.0128571428571429,0.0740740740740741
2015,17157,39,900,61,289,0,25,61,314,0.0130610207562081,0.194267515923567
2015,17159,154,312,46,98,14,23,60,121,0.0107622520679534,0.495867768595041
2015,17161,213,1621,503,1849,69,362,572,2211,0.0219219100120962,0.258706467661692
2015,17163,728,2930,1505,4000,338,770,1843,4770,0.0268588642698274,0.386373165618449
2015,17165,25,451,0,96,9,31,9,127,0.0073794305636258,0.0708661417322835
2015,17167,1125,3104,937,1927,176,552,1113,2479,0.018233974476849,0.448971359419121
2015,17169,4,116,0,18,0,5,0,23,0.0042521723054169,0
2015,17171,11,173,0,9,0,0,0,9,0.00247456695078361,0
2015,17173,98,445,26,92,0,4,26,96,0.00612635609444799,0.270833333333333
2015,17175,2,81,30,41,0,0,30,41,0.00981565717021786,0.731707317073171
2015,17177,168,790,102,311,0,24,102,335,0.0102215170562031,0.304477611940298
2015,17179,747,2943,419,1046,43,124,462,1170,0.0124333170389577,0.394871794871795
2015,17181,81,323,46,125,0,0,46,125,0.0100160256410256,0.368
2015,17183,102,1053,90,745,8,99,98,844,0.0155607588635484,0.116113744075829
2015,17185,13,73,21,80,0,18,21,98,0.0120793787748059,0.214285714285714
2015,17187,72,358,26,125,0,13,26,138,0.0118934758252176,0.188405797101449
2015,17189,34,230,17,102,11,14,28,116,0.0112994350282486,0.241379310344828
2015,17191,39,227,15,138,0,25,15,163,0.0141137760845095,0.0920245398773006
2015,17193,13,301,44,126,0,0,44,126,0.0122116689280868,0.349206349206349
2015,17195,99,685,70,337,18,102,88,439,0.0110343094130954,0.200455580865604
2015,17197,4593,13111,1803,3771,558,1373,2361,5144,0.0117690394642616,0.45898133748056
2015,17199,357,1699,152,645,6,52,158,697,0.0148168618864395,0.226685796269727
2015,17201,971,3596,736,2592,195,609,931,3201,0.0163827870698303,0.290846610434239
2015,17203,290,1011,89,237,7,24,96,261,0.0100896860986547,0.367816091954023
2015,18001,69,407,20,109,7,58,27,167,0.0079858454475899,0.161676646706587
2015,18003,971,3270,1323,4325,127,414,1450,4739,0.0203196953975182,0.305971723992403
2015,18005,399,1369,525,1269,443,677,968,1946,0.0362937819389011,0.49743062692703
2015,18007,44,476,27,103,0,0,27,103,0.0174813306177868,0.262135922330097
2015,18009,11,293,5,30,0,15,5,45,0.00514933058702369,0.111111111111111
2015,18011,674,1674,402,917,19,64,421,981,0.0245784581464686,0.429153924566769
2015,18013,84,377,16,63,15,15,31,78,0.00706777818050018,0.397435897435897
2015,18015,97,653,15,96,0,2,15,98,0.00712830957230143,0.153061224489796
2015,18017,175,759,28,133,27,97,55,230,0.0089016177722734,0.239130434782609
2015,18019,470,1885,314,1753,17,70,331,1823,0.0234913598701081,0.181568842567197
2015,18021,72,462,69,205,0,2,69,207,0.0113517959967096,0.333333333333333
2015,18023,125,671,7,124,0,19,7,143,0.00665147216149588,0.048951048951049
2015,18025,5,182,11,127,0,3,11,130,0.017593720395182,0.0846153846153846
2015,18027,84,431,80,158,11,14,91,172,0.00856062114274338,0.529069767441861
2015,18029,68,484,233,1207,14,40,247,1247,0.0366872609591056,0.198075380914194
2015,18031,8,351,155,325,5,5,160,330,0.0187138482477033,0.484848484848485
2015,18033,124,828,25,434,33,56,58,490,0.0174222222222222,0.118367346938776
2015,18035,591,2037,311,1028,20,141,331,1169,0.0164418627547504,0.283147989734816
2015,18037,95,466,150,357,2,4,152,361,0.0126653334736694,0.421052631578947
2015,18039,388,2512,534,1713,123,187,657,1900,0.0150113375101722,0.345789473684211
2015,18041,68,403,31,99,9,31,40,130,0.00785451030149236,0.307692307692308
2015,18043,269,1205,297,1210,33,84,330,1294,0.0251481877368574,0.255023183925811
2015,18045,98,321,5,116,0,17,5,133,0.0114104323953329,0.037593984962406
2015,18047,119,477,113,265,0,21,113,286,0.0183792815371763,0.395104895104895
2015,18049,66,538,29,197,0,8,29,205,0.0146522764634408,0.141463414634146
2015,18051,98,515,52,221,1,17,53,238,0.010403007255879,0.222689075630252
2015,18053,193,838,22,699,15,113,37,812,0.0180164189039272,0.0455665024630542
2015,18055,17,690,37,204,0,4,37,208,0.00913322209537192,0.177884615384615
2015,18057,4042,7529,3710,5413,379,902,4089,6315,0.0330995660104409,0.64750593824228
2015,18059,406,1733,147,550,13,36,160,586,0.0121783947795004,0.273037542662116
2015,18061,156,634,57,518,0,24,57,542,0.0199506754518349,0.105166051660517
2015,18063,971,4828,811,1587,250,401,1061,1988,0.019711857852518,0.533702213279678
2015,18065,163,1699,20,283,0,20,20,303,0.00872620453301846,0.066006600660066
2015,18067,204,1127,220,921,52,186,272,1107,0.0194108364018937,0.245709123757904
2015,18069,104,755,49,319,8,68,57,387,0.0155916361145804,0.147286821705426
2015,18071,142,722,70,362,6,26,76,388,0.0132103094889517,0.195876288659794
2015,18073,100,587,21,353,0,44,21,397,0.0180216986699351,0.052896725440806
2015,18075,50,275,10,96,0,0,10,96,0.00689655172413793,0.104166666666667
2015,18077,131,1010,49,405,33,85,82,490,0.0222970513287222,0.16734693877551
2015,18079,69,657,0,221,9,32,9,253,0.013535926381681,0.0355731225296443
2015,18081,1027,4939,548,2120,220,398,768,2518,0.0262155127537741,0.305003971405878
2015,18083,151,590,58,413,42,44,100,457,0.0183666907804839,0.218818380743982
2015,18085,356,1435,334,907,37,73,371,980,0.0190973575493024,0.378571428571429
2015,18087,60,634,19,278,0,13,19,291,0.0134336626350291,0.0652920962199313
2015,18089,664,2760,1708,8628,329,837,2037,9465,0.0290536164308714,0.215213946117274
2015,18091,342,3789,340,1424,12,92,352,1516,0.0196502871067674,0.232189973614776
2015,18093,177,901,40,223,11,18,51,241,0.00753077932629211,0.211618257261411
2015,18095,570,2997,173,1000,50,137,223,1137,0.0126795432241948,0.19613016710642
2015,18097,5250,14867,4092,9867,930,2498,5022,12365,0.02049564146468,0.40614638091387
2015,18099,136,732,36,271,5,31,41,302,0.00977884272900949,0.135761589403974
2015,18101,61,277,17,95,0,10,17,105,0.014724442574674,0.161904761904762
2015,18103,121,1636,31,217,0,5,31,222,0.00891029500301023,0.13963963963964
2015,18105,923,2440,1605,2416,798,991,2403,3407,0.0429006749269669,0.705312591722923
2015,18107,145,661,81,413,14,24,95,437,0.0171608089534655,0.217391304347826
2015,18109,358,2740,107,428,14,31,121,459,0.00973984636930781,0.263616557734205
2015,18111,36,366,41,198,36,36,77,234,0.0237732398658945,0.329059829059829
2015,18113,172,1243,112,281,0,77,112,358,0.0114501375295849,0.312849162011173
2015,18115,17,97,0,149,0,16,0,165,0.0375255856265636,0
2015,18117,24,324,12,89,0,16,12,105,0.00781424425094887,0.114285714285714
2015,18119,17,784,13,83,0,0,13,83,0.00555853201178677,0.156626506024096
2015,18121,112,761,15,209,0,2,15,211,0.0174871539864081,0.0710900473933649
2015,18123,75,777,54,275,0,3,54,278,0.020355861462986,0.194244604316547
2015,18125,6,219,20,62,0,0,20,62,0.00690653893282834,0.32258064516129
2015,18127,778,2981,893,2256,35,138,928,2394,0.0213199868197241,0.387635756056809
2015,18129,65,409,58,229,14,34,72,263,0.0149152157885782,0.273764258555133
2015,18131,15,361,18,32,13,33,31,65,0.00719743107075628,0.476923076923077
2015,18133,132,1805,27,268,15,29,42,297,0.0120218579234973,0.141414141414141
2015,18135,31,371,43,200,2,11,45,211,0.0120002274924643,0.213270142180095
2015,18137,87,441,58,168,0,35,58,203,0.0105067025516278,0.285714285714286
2015,18139,29,254,54,163,26,33,80,196,0.0167952013710368,0.408163265306122
2015,18141,632,2891,1679,3788,533,886,2212,4674,0.0270401610607796,0.473256311510484
2015,18143,50,399,38,167,11,31,49,198,0.0121816168327796,0.247474747474747
2015,18145,207,1328,38,421,27,63,65,484,0.0158917783031258,0.134297520661157
2015,18147,75,416,51,131,7,7,58,138,0.009536314007325,0.420289855072464
2015,18149,73,542,2,168,1,19,3,187,0.0118354430379747,0.0160427807486631
2015,18151,158,615,111,568,0,37,111,605,0.0261440732898319,0.183471074380165
2015,18153,61,640,17,93,0,6,17,99,0.00658945686900958,0.171717171717172
2015,18155,59,310,2,63,2,17,4,80,0.0113394755492558,0.05
2015,18157,649,2949,990,2212,797,1253,1787,3465,0.0348847745326044,0.515728715728716
2015,18159,40,352,35,45,0,3,35,48,0.00437118659502778,0.729166666666667
2015,18161,6,109,24,155,0,4,24,159,0.0320370743501914,0.150943396226415
2015,18163,780,2514,861,2447,27,224,888,2671,0.0219414620521962,0.332459752901535
2015,18165,60,228,8,118,3,29,11,147,0.0132468234658016,0.0748299319727891
2015,18167,351,1910,589,1553,65,240,654,1793,0.025842809991208,0.364751812604573
2015,18169,53,683,101,274,0,14,101,288,0.0130547119350891,0.350694444444444
2015,18171,16,179,20,63,0,0,20,63,0.0106185740771953,0.317460317460317
2015,18173,463,1518,209,474,48,134,257,608,0.0146534271666827,0.422697368421053
2015,18175,49,469,23,173,0,18,23,191,0.0101015443198646,0.120418848167539
2015,18177,200,866,231,1153,13,27,244,1180,0.0254568204862684,0.206779661016949
2015,18179,135,435,17,138,0,14,17,152,0.00810839645791102,0.111842105263158
2015,18181,97,496,15,99,8,86,23,185,0.0110171510242973,0.124324324324324
2015,18183,183,958,63,225,0,10,63,235,0.0102988868437199,0.268085106382979
2015,19001,47,282,18,48,0,3,18,51,0.00955593029792018,0.352941176470588
2015,19003,6,44,7,15,1,11,8,26,0.00925925925925926,0.307692307692308
2015,19005,26,172,7,196,0,21,7,217,0.0218573730862208,0.032258064516129
2015,19007,18,260,16,192,0,0,16,192,0.0213238560639716,0.0833333333333333
2015,19009,24,129,1,19,0,4,1,23,0.00541049164902376,0.0434782608695652
2015,19011,133,508,36,107,0,12,36,119,0.00681167716084717,0.302521008403361
2015,19013,450,1897,449,1299,76,196,525,1495,0.0180040223033106,0.351170568561873
2015,19015,278,802,138,379,0,18,138,397,0.021673854888901,0.347607052896725
2015,19017,168,517,73,172,37,76,110,248,0.0153932096083421,0.443548387096774
2015,19019,103,386,43,156,7,52,50,208,0.014916810097533,0.240384615384615
2015,19021,83,293,121,363,4,135,125,498,0.0384674803027962,0.251004016064257
2015,19023,59,226,0,37,0,7,0,44,0.00420650095602294,0
2015,19025,67,504,3,59,3,5,6,64,0.00901408450704225,0.09375
2015,19027,95,347,64,147,0,24,64,171,0.0121233605104573,0.374269005847953
2015,19029,80,278,11,64,9,21,20,85,0.00885232243282649,0.235294117647059
2015,19031,70,377,2,58,0,5,2,63,0.00490768871231596,0.0317460317460317
2015,19033,308,808,126,336,3,13,129,349,0.0113087715887366,0.369627507163324
2015,19035,29,241,37,82,0,16,37,98,0.0115375559218272,0.377551020408163
2015,19037,31,135,13,48,2,15,15,63,0.00748752079866889,0.238095238095238
2015,19039,24,170,23,114,0,0,23,114,0.0184705119896306,0.201754385964912
2015,19041,86,406,79,181,0,18,79,199,0.0172428732345551,0.396984924623116
2015,19043,32,252,57,190,2,6,59,196,0.0156050955414013,0.301020408163265
2015,19045,142,356,109,757,18,67,127,824,0.0247284076586039,0.154126213592233
2015,19047,39,177,18,131,11,13,29,144,0.0128159487362051,0.201388888888889
2015,19049,1508,3000,725,1172,40,173,765,1345,0.0275310107667745,0.568773234200744
2015,19051,26,194,25,115,0,2,25,117,0.0210886806056236,0.213675213675214
2015,19053,51,203,39,92,0,0,39,92,0.0182431092603609,0.423913043478261
2015,19055,51,399,16,63,0,0,16,63,0.00527196652719665,0.253968253968254
2015,19057,64,713,99,415,39,80,138,495,0.0177013302817909,0.278787878787879
2015,19059,52,206,83,158,4,6,87,164,0.0129675021744287,0.530487804878049
2015,19061,309,910,504,1653,213,275,717,1928,0.0302602253821766,0.371887966804979
2015,19063,29,133,30,234,3,23,33,257,0.0384155455904335,0.1284046692607
2015,19065,28,458,45,162,0,17,45,179,0.0127720299678915,0.251396648044693
2015,19067,61,218,110,300,1,22,111,322,0.0289620435330095,0.34472049689441
2015,19069,47,118,36,111,0,0,36,111,0.0151287992367453,0.324324324324324
2015,19071,5,69,15,77,4,12,19,89,0.0175924095671081,0.213483146067416
2015,19073,38,222,0,64,0,10,0,74,0.0115408608858391,0
2015,19075,68,234,31,57,0,7,31,64,0.0074618164859508,0.484375
2015,19077,32,234,28,68,2,9,30,77,0.0100653594771242,0.38961038961039
2015,19079,77,292,47,104,1,2,48,106,0.00989082765699356,0.452830188679245
2015,19081,29,167,17,37,7,12,24,49,0.00623965363555329,0.489795918367347
2015,19083,84,333,25,134,3,3,28,137,0.0111928104575163,0.204379562043796
2015,19085,29,218,40,123,0,17,40,140,0.0138861337036302,0.285714285714286
2015,19087,76,510,49,198,3,3,52,201,0.0146330809551543,0.258706467661692
2015,19089,20,117,0,65,0,0,0,65,0.0100790820282214,0
2015,19091,42,210,4,89,0,10,4,99,0.0146601510439805,0.0404040404040404
2015,19093,31,93,15,66,0,0,15,66,0.0132291040288635,0.227272727272727
2015,19095,93,520,28,190,0,3,28,193,0.0169774806474314,0.145077720207254
2015,19097,86,375,35,145,0,8,35,153,0.0111216108163117,0.228758169934641
2015,19099,137,1160,72,290,4,32,76,322,0.0124961192176343,0.236024844720497
2015,19101,47,241,82,195,171,206,253,401,0.0329580011506534,0.630922693266833
2015,19103,793,2623,1706,2922,554,748,2260,3670,0.0449209904649996,0.615803814713896
2015,19105,111,432,8,106,0,36,8,142,0.00974337861945931,0.0563380281690141
2015,19107,50,257,10,14,0,0,10,14,0.00194769059543684,0.714285714285714
2015,19109,65,314,22,95,2,11,24,106,0.00978853079693416,0.226415094339623
2015,19111,32,338,91,409,23,49,114,458,0.0184231697506034,0.248908296943231
2015,19113,746,2854,1042,2693,322,465,1364,3158,0.022016174010039,0.431918936035465
2015,19115,38,209,12,51,0,10,12,61,0.00795617581844268,0.19672131147541
2015,19117,8,215,29,120,9,13,38,133,0.0217854217854218,0.285714285714286
2015,19119,54,158,30,124,0,4,30,128,0.0168177637629746,0.234375
2015,19121,97,513,0,121,0,9,0,130,0.0122873345935728,0
2015,19123,83,341,24,308,8,17,32,325,0.021704287431548,0.0984615384615385
2015,19125,294,767,187,322,0,15,187,337,0.0156025741932497,0.554896142433234
2015,19127,202,818,117,445,8,58,125,503,0.0184526211526468,0.248508946322068
2015,19129,104,273,95,247,0,11,95,258,0.0253263963875528,0.368217054263566
2015,19131,22,84,13,65,1,3,14,68,0.00927567862501705,0.205882352941176
2015,19133,17,261,21,75,0,5,21,80,0.0120627261761158,0.2625
2015,19135,44,197,23,120,0,11,23,131,0.0243178021162057,0.175572519083969
2015,19137,29,176,59,195,0,0,59,195,0.0263941526800217,0.302564102564103
2015,19139,86,580,68,336,27,84,95,420,0.0148075024679171,0.226190476190476
2015,19141,91,387,10,199,23,34,33,233,0.0237198411890461,0.141630901287554
2015,19143,18,90,32,94,0,2,32,96,0.0219278209227958,0.333333333333333
2015,19145,86,473,128,407,0,4,128,411,0.0369970294355928,0.311435523114355
2015,19147,82,303,13,59,2,3,15,62,0.00976531737281462,0.241935483870968
2015,19149,92,323,23,162,11,32,34,194,0.0114908487827993,0.175257731958763
2015,19151,34,167,3,71,0,5,3,76,0.0150465254405068,0.0394736842105263
2015,19153,2918,8185,2709,6761,482,1234,3191,7995,0.0269069614821546,0.399124452782989
2015,19155,236,1005,476,1780,32,145,508,1925,0.0307743957027753,0.263896103896104
2015,19157,77,404,50,147,24,45,74,192,0.0158363576377433,0.385416666666667
2015,19159,49,98,10,38,0,27,10,65,0.0183719615602035,0.153846153846154
2015,19161,40,205,28,54,0,14,28,68,0.00948263840468554,0.411764705882353
2015,19163,402,1230,1630,4031,211,422,1841,4453,0.0389953850060862,0.41342914888839
2015,19165,95,171,51,106,2,7,53,113,0.0133239004834336,0.469026548672566
2015,19167,40,291,76,461,0,74,76,535,0.0261128465443186,0.142056074766355
2015,19169,386,1515,868,1246,799,866,1667,2112,0.0439094367866276,0.789299242424242
2015,19171,54,266,10,63,5,5,15,68,0.00568324279147514,0.220588235294118
2015,19173,9,135,4,74,3,30,7,104,0.0237172177879133,0.0673076923076923
2015,19175,15,237,24,53,12,22,36,75,0.00882041632365048,0.48
2015,19177,5,121,20,79,0,0,20,79,0.0151631477927063,0.253164556962025
2015,19179,110,507,100,358,33,105,133,463,0.0192603685677441,0.287257019438445
2015,19181,463,1655,122,379,39,54,161,433,0.0140056928451287,0.371824480369515
2015,19183,110,478,84,237,4,12,88,249,0.0165922569467582,0.353413654618474
2015,19185,4,96,22,74,0,5,22,79,0.018003646308113,0.278481012658228
2015,19187,152,1135,124,596,101,121,225,717,0.0285191519828169,0.313807531380753
2015,19189,34,178,57,179,0,0,57,179,0.0242219215155616,0.318435754189944
2015,19191,49,296,116,183,2,14,118,197,0.014516247881512,0.598984771573604
2015,19193,158,879,474,1624,6,164,480,1788,0.027465859690625,0.268456375838926
2015,19195,16,184,14,80,0,1,14,81,0.0151175811870101,0.172839506172839
2015,19197,18,237,16,158,2,33,18,191,0.0211986681465039,0.0942408376963351
2015,20001,15,214,27,51,0,0,27,51,0.00577903682719547,0.529411764705882
2015,20003,21,247,17,88,0,0,17,88,0.0164056674123788,0.193181818181818
2015,20005,32,180,7,56,0,17,7,73,0.00719211822660099,0.0958904109589041
2015,20007,11,54,3,77,0,1,3,78,0.0232004759071981,0.0384615384615385
2015,20009,113,519,63,389,4,41,67,430,0.0236172900532762,0.155813953488372
2015,20011,11,198,12,104,0,2,12,106,0.0110774375587836,0.113207547169811
2015,20013,70,270,20,119,2,4,22,123,0.0183746638780998,0.178861788617886
2015,20015,607,2090,223,906,28,63,251,969,0.0226470656975249,0.259029927760578
2015,20017,25,144,8,30,0,5,8,35,0.0181347150259067,0.228571428571429
2015,20019,23,99,0,68,0,0,0,68,0.0266875981161695,0
2015,20021,56,160,42,296,0,13,42,309,0.0215541294642857,0.135922330097087
2015,20023,9,55,0,47,13,13,13,60,0.0308166409861325,0.216666666666667
2015,20025,18,51,26,71,0,2,26,73,0.0489276139410188,0.356164383561644
2015,20027,18,154,28,174,62,83,90,257,0.0439016057396652,0.350194552529183
2015,20029,27,200,50,102,0,25,50,127,0.0199874095058231,0.393700787401575
2015,20031,40,242,24,133,3,19,27,152,0.0255548083389375,0.177631578947368
2015,20033,4,41,0,11,0,0,0,11,0.00789662598707825,0
2015,20035,59,902,125,621,17,126,142,747,0.0318631632827163,0.190093708165997
2015,20037,84,378,218,464,15,31,233,495,0.0209772428698563,0.470707070707071
2015,20039,6,85,15,48,0,0,15,48,0.0218678815489749,0.3125
2015,20041,47,491,136,422,0,21,136,443,0.0330745109750635,0.306997742663657
2015,20043,30,62,4,133,0,0,4,133,0.0259107734268459,0.0300751879699248
2015,20045,736,1624,1185,1792,402,559,1587,2351,0.036309441072449,0.675031901318588
2015,20047,14,86,6,38,0,0,6,38,0.0180952380952381,0.157894736842105
2015,20049,7,74,0,14,0,0,0,14,0.00694444444444444,0
2015,20051,168,650,105,262,3,91,108,353,0.0201323143606707,0.305949008498584
2015,20053,43,335,6,52,0,12,6,64,0.0136664531283365,0.09375
2015,20055,75,411,127,406,16,108,143,514,0.0238670133729569,0.278210116731518
2015,20057,134,509,99,454,58,200,157,654,0.0320808397920141,0.240061162079511
2015,20059,92,457,108,360,0,0,108,360,0.0211864406779661,0.3
2015,20061,202,888,351,1544,136,779,487,2323,0.117876896534226,0.209642703400775
2015,20063,14,47,7,26,14,14,21,40,0.0202224469160768,0.525
2015,20065,14,42,2,9,0,0,2,9,0.00469483568075117,0.222222222222222
2015,20067,15,171,36,70,0,1,36,71,0.014931650893796,0.507042253521127
2015,20069,18,121,14,87,0,4,14,91,0.0240868184224457,0.153846153846154
2015,20071,0,16,0,5,0,10,0,15,0.0167785234899329,0
2015,20073,35,123,0,13,0,0,0,13,0.00282854656222802,0
2015,20075,0,54,12,52,2,4,14,56,0.0327485380116959,0.25
2015,20077,20,84,18,79,0,5,18,84,0.0205529728407145,0.214285714285714
2015,20079,207,791,51,335,0,118,51,453,0.0197325434507993,0.112582781456954
2015,20081,4,80,9,43,0,0,9,43,0.0170162247724575,0.209302325581395
2015,20083,2,55,8,14,11,11,19,25,0.0179726815240834,0.76
2015,20085,83,339,92,192,0,0,92,192,0.021349938841321,0.479166666666667
2015,20087,176,623,11,70,0,0,11,70,0.00532683966212617,0.157142857142857
2015,20089,7,49,0,20,0,6,0,26,0.0113935144609991,0
2015,20091,2758,6601,7826,14076,1101,1787,8927,15863,0.0419204718728776,0.562756099098531
2015,20093,33,126,0,67,0,28,0,95,0.0378787878787879,0
2015,20095,45,120,24,193,0,0,24,193,0.0352189781021898,0.124352331606218
2015,20097,14,46,9,19,0,0,9,19,0.0112426035502959,0.473684210526316
2015,20099,28,460,81,261,0,3,81,264,0.0185902401239349,0.306818181818182
2015,20101,2,34,1,10,0,3,1,13,0.0112165660051769,0.0769230769230769
2015,20103,305,1800,1692,3393,423,547,2115,3940,0.0752698443022256,0.536802030456853
2015,20105,17,89,6,57,0,7,6,64,0.0284318080852954,0.09375
2015,20107,24,183,41,105,2,4,43,109,0.0163639093229245,0.394495412844037
2015,20109,9,54,1,21,1,9,2,30,0.0154320987654321,0.0666666666666667
2015,20111,70,522,53,621,0,30,53,651,0.0328439533827758,0.0814132104454685
2015,20113,145,646,63,260,29,52,92,312,0.0156744536548606,0.294871794871795
2015,20115,29,330,35,61,8,28,43,89,0.0105101558809636,0.48314606741573
2015,20117,40,188,26,98,5,5,31,103,0.0145995747696669,0.300970873786408
2015,20119,28,118,5,44,0,3,5,47,0.0164048865619546,0.106382978723404
2015,20121,134,793,69,348,31,31,100,379,0.0174188804118026,0.263852242744063
2015,20123,57,147,27,28,0,1,27,29,0.00670830441822808,0.931034482758621
2015,20125,125,589,111,487,38,71,149,558,0.0244908707865169,0.267025089605735
2015,20127,42,126,13,175,0,41,13,216,0.0516005733397038,0.0601851851851852
2015,20129,26,83,3,11,0,0,3,11,0.00548628428927681,0.272727272727273
2015,20131,76,136,24,52,0,13,24,65,0.00957008244994111,0.369230769230769
2015,20133,155,573,18,66,8,28,26,94,0.00863494396472534,0.276595744680851
2015,20135,23,33,0,12,0,0,0,12,0.00525164113785558,0
2015,20137,33,417,8,42,0,0,8,42,0.0102514034659507,0.19047619047619
2015,20139,34,450,56,170,0,4,56,174,0.0157195771975788,0.32183908045977
2015,20141,36,95,14,78,0,8,14,86,0.031352533722202,0.162790697674419
2015,20143,35,176,2,32,0,0,2,32,0.0076960076960077,0.0625
2015,20145,61,470,82,231,0,7,82,238,0.0477815699658703,0.34453781512605
2015,20147,38,125,16,24,0,0,16,24,0.00629590766002099,0.666666666666667
2015,20149,176,557,180,432,5,43,185,475,0.0335026096769643,0.389473684210526
2015,20151,21,198,116,154,0,23,116,177,0.0277299075669748,0.655367231638418
2015,20153,8,23,31,36,0,0,31,36,0.0188186095138526,0.861111111111111
2015,20155,278,1460,146,796,119,290,265,1086,0.0250571052813733,0.244014732965009
2015,20157,20,65,10,64,0,0,10,64,0.0177432769614638,0.15625
2015,20159,39,263,11,74,0,2,11,76,0.0118731448211217,0.144736842105263
2015,20161,439,1488,761,1903,281,923,1042,2826,0.0766352098926131,0.368719037508846
2015,20163,7,139,3,20,0,5,3,25,0.00684743905779239,0.12
2015,20165,17,75,9,36,0,0,9,36,0.0153191489361702,0.25
2015,20167,62,186,7,106,0,1,7,107,0.0214471838043696,0.0654205607476635
2015,20169,174,914,248,487,0,78,248,565,0.0154329418191751,0.438938053097345
2015,20171,0,196,17,17,0,0,17,17,0.00494186046511628,1
2015,20173,1542,4788,2042,5379,359,1034,2401,6413,0.0198464399887352,0.374395758615313
2015,20175,52,281,119,387,0,65,119,452,0.034092623321768,0.263274336283186
2015,20177,528,2452,812,2047,129,401,941,2448,0.0204564256407257,0.384395424836601
2015,20179,0,63,5,10,0,0,5,10,0.00554323725055432,0.5
2015,20181,22,182,94,275,0,0,94,275,0.0668611718939947,0.341818181818182
2015,20183,5,28,5,31,0,0,5,31,0.0112932604735883,0.161290322580645
2015,20185,16,86,3,20,4,4,7,24,0.00798668885191348,0.291666666666667
2015,20187,1,35,14,24,0,5,14,29,0.0217717717717718,0.482758620689655
2015,20189,15,133,4,155,0,5,4,160,0.0442477876106195,0.025
2015,20191,146,632,54,173,2,34,56,207,0.0131270213710445,0.270531400966184
2015,20193,45,128,36,96,0,0,36,96,0.0191961607678464,0.375
2015,20195,14,117,8,36,0,0,8,36,0.0169651272384543,0.222222222222222
2015,20197,17,208,5,72,0,2,5,74,0.0154327424400417,0.0675675675675676
2015,20199,12,29,0,14,0,0,0,14,0.0130232558139535,0
2015,20201,4,94,7,91,0,0,7,91,0.0225694444444444,0.0769230769230769
2015,20203,1,17,8,37,0,0,8,37,0.0264853256979241,0.216216216216216
2015,20205,22,175,19,104,0,0,19,104,0.0165842768298517,0.182692307692308
2015,20207,23,87,2,13,0,0,2,13,0.00553898593949723,0.153846153846154
2015,20209,725,2678,794,3185,166,596,960,3781,0.0375822515555732,0.253901084369214
2015,21001,67,406,61,281,0,11,61,292,0.0231122368212759,0.208904109589041
2015,21003,65,465,0,337,10,44,10,381,0.0277615855435733,0.026246719160105
2015,21005,126,716,31,74,0,10,31,84,0.00570458404074703,0.369047619047619
2015,21007,13,135,4,100,0,4,4,104,0.0179186767746382,0.0384615384615385
2015,21009,174,780,97,400,2,33,99,433,0.01478673633166,0.228637413394919
2015,21011,51,439,0,61,0,41,0,102,0.0126913027248974,0
2015,21013,20,393,103,436,0,0,103,436,0.0223681510363226,0.236238532110092
2015,21015,827,3169,894,2639,448,485,1342,3124,0.0386801213396892,0.429577464788732
2015,21017,61,529,59,224,0,0,59,224,0.016170950043315,0.263392857142857
2015,21019,177,940,160,1013,14,37,174,1050,0.0301446945337621,0.165714285714286
2015,21021,218,1202,55,471,8,30,63,501,0.0254147009587582,0.125748502994012
2015,21023,20,119,10,44,0,0,10,44,0.00775467042650687,0.227272727272727
2015,21025,4,170,40,113,0,15,40,128,0.0135421074904782,0.3125
2015,21027,7,425,18,236,0,68,18,304,0.021978021978022,0.0592105263157895
2015,21029,309,2434,95,568,6,49,101,617,0.0117892081932131,0.163695299837925
2015,21031,6,179,6,119,0,0,6,119,0.0132931188561215,0.0504201680672269
2015,21033,153,347,42,155,0,0,42,155,0.0172164833944241,0.270967741935484
2015,21035,117,368,143,347,66,192,209,539,0.0234154394196099,0.387755102040816
2015,21037,567,1593,701,1760,12,66,713,1826,0.0297626809231973,0.390470974808324
2015,21039,23,72,1,24,0,0,1,24,0.00678925035360679,0.0416666666666667
2015,21041,12,318,49,224,0,6,49,230,0.0324537886270636,0.21304347826087
2015,21043,56,582,59,216,0,81,59,297,0.0161474473984668,0.198653198653199
2015,21045,47,352,16,186,0,41,16,227,0.0205429864253394,0.0704845814977974
2015,21047,194,1330,205,2936,235,716,440,3652,0.0866265003083638,0.120481927710843
2015,21049,134,1191,64,463,0,35,64,498,0.0200523454801691,0.1285140562249
2015,21051,34,325,10,263,0,17,10,280,0.0187680139419532,0.0357142857142857
2015,21053,0,169,0,57,0,0,0,57,0.00818142672599397,0
2015,21055,0,168,0,100,4,4,4,104,0.016059295861643,0.0384615384615385
2015,21057,32,77,16,73,0,8,16,81,0.0169385194479297,0.197530864197531
2015,21059,211,1508,181,723,32,231,213,954,0.0144150133724181,0.223270440251572
2015,21061,35,288,5,130,0,0,5,130,0.0152474783016655,0.0384615384615385
2015,21063,7,555,0,5,0,0,0,5,0.000884173297966401,0
2015,21065,36,248,0,29,0,9,0,38,0.00372184133202742,0
2015,21067,2026,7180,3447,6341,886,1922,4333,8263,0.0415138513479567,0.524385816289483
2015,21069,47,195,4,135,0,0,4,135,0.0137502546343451,0.0296296296296296
2015,21071,124,929,19,81,0,0,19,81,0.00301003344481605,0.234567901234568
2015,21073,424,1864,142,626,10,103,152,729,0.021124311793683,0.208504801097394
2015,21075,19,277,0,149,0,4,0,153,0.0340151178301467,0
2015,21077,40,303,39,157,8,11,47,168,0.0299305184393373,0.279761904761905
2015,21079,104,508,0,78,9,25,9,103,0.00861924686192469,0.087378640776699
2015,21081,94,792,33,104,0,6,33,110,0.00700012727504136,0.3
2015,21083,54,302,33,272,34,96,67,368,0.0144973211471793,0.182065217391304
2015,21085,48,569,0,213,0,12,0,225,0.0128278221208666,0
2015,21087,11,280,0,42,0,18,0,60,0.00758054327226785,0
2015,21089,92,621,139,606,0,12,139,618,0.0239730012801117,0.224919093851133
2015,21091,63,284,5,177,0,0,5,177,0.0305435720448663,0.0282485875706215
2015,21093,422,2288,1256,3638,190,758,1446,4396,0.0632964248174972,0.328935395814377
2015,21095,26,310,7,108,0,5,7,113,0.00578804487015315,0.0619469026548673
2015,21097,23,470,50,202,0,0,50,202,0.0157689305230289,0.247524752475248
2015,21099,81,343,4,79,11,16,15,95,0.0076342012214722,0.157894736842105
2015,21101,147,841,143,664,17,78,160,742,0.0231701224081939,0.215633423180593
2015,21103,57,506,0,33,0,5,0,38,0.00360223717887951,0
2015,21105,36,217,13,77,0,0,13,77,0.0226537216828479,0.168831168831169
2015,21107,73,824,49,179,11,33,60,212,0.00656773753833762,0.283018867924528
2015,21109,0,135,0,95,0,0,0,95,0.01028027269776,0
2015,21111,2010,7556,4783,10218,919,2467,5702,12685,0.0245864781154179,0.449507292077257
2015,21113,457,1878,350,604,65,71,415,675,0.0207794606575545,0.614814814814815
2015,21115,44,396,35,111,0,0,35,111,0.00685650750509605,0.315315315315315
2015,21117,821,3061,1248,3685,118,269,1366,3954,0.0362492894992574,0.345472938796156
2015,21119,7,218,32,214,0,11,32,225,0.02057801353576,0.142222222222222
2015,21121,69,776,44,356,22,42,66,398,0.0186898332942005,0.165829145728643
2015,21123,20,380,36,70,0,13,36,83,0.00845558272208639,0.433734939759036
2015,21125,46,1514,138,635,0,19,138,654,0.0160877693594411,0.211009174311927
2015,21127,22,244,4,180,17,22,21,202,0.0185372120767184,0.103960396039604
2015,21129,4,295,2,109,0,0,2,109,0.0212227414330218,0.018348623853211
2015,21131,5,180,0,142,0,0,0,142,0.0183842568617297,0
2015,21133,32,196,19,54,0,0,19,54,0.00322503583373149,0.351851851851852
2015,21135,23,211,17,256,0,0,17,256,0.0269331930562862,0.06640625
2015,21137,152,919,40,109,0,0,40,109,0.0064919594997022,0.36697247706422
2015,21139,12,58,8,52,0,10,8,62,0.00910024952297079,0.129032258064516
2015,21141,64,466,63,369,0,0,63,369,0.0202191780821918,0.170731707317073
2015,21143,42,462,39,165,0,20,39,185,0.0279076783828632,0.210810810810811
2015,21145,230,1143,246,825,0,90,246,915,0.0198748859637691,0.268852459016393
2015,21147,5,401,4,411,0,20,4,431,0.035112016293279,0.00928074245939675
2015,21149,25,156,3,32,4,4,7,36,0.00547528517110266,0.194444444444444
2015,21151,307,1821,332,1155,48,87,380,1242,0.0235964662296951,0.305958132045089
2015,21153,10,114,0,0,0,9,0,9,0.00100987432675045,0
2015,21155,89,629,56,75,0,55,56,130,0.00969715052961361,0.430769230769231
2015,21157,73,469,70,277,25,25,95,302,0.0133527877260468,0.314569536423841
2015,21159,0,355,29,219,0,8,29,227,0.0258984597832288,0.127753303964758
2015,21161,121,496,14,300,7,16,21,316,0.0270362765229295,0.0664556962025316
2015,21163,115,883,209,689,11,97,220,786,0.0409247110278038,0.279898218829517
2015,21165,1,192,0,43,0,23,0,66,0.0146536412078153,0
2015,21167,141,799,62,144,0,10,62,154,0.0102982479604119,0.402597402597403
2015,21169,17,197,48,158,0,0,48,158,0.0227207362668967,0.30379746835443
2015,21171,14,249,13,58,14,16,27,74,0.00988379858421264,0.364864864864865
2015,21173,91,1167,5,309,0,0,5,309,0.0167606856151009,0.0161812297734628
2015,21175,29,603,10,112,0,0,10,112,0.0114169215086646,0.0892857142857143
2015,21177,1,597,32,207,0,10,32,217,0.00996464159434265,0.147465437788018
2015,21179,97,1317,29,244,15,29,44,273,0.00925360992475086,0.161172161172161
2015,21181,11,125,0,47,0,8,0,55,0.0112566516577978,0
2015,21183,0,653,33,258,0,1,33,259,0.0159188690842041,0.127413127413127
2015,21185,754,2654,409,927,73,109,482,1036,0.024733210781388,0.465250965250965
2015,21187,8,242,32,69,1,6,33,75,0.0102207686017989,0.44
2015,21189,5,66,0,0,0,0,0,0,0,NA
2015,21191,50,299,25,97,0,0,25,97,0.0098257698541329,0.257731958762887
2015,21193,121,608,10,164,0,13,10,177,0.00905973281465936,0.0564971751412429
2015,21195,151,842,127,636,0,75,127,711,0.0160196471622017,0.178621659634318
2015,21197,35,283,6,36,0,16,6,52,0.00619785458879619,0.115384615384615
2015,21199,123,1060,64,675,0,21,64,696,0.0156922868802561,0.0919540229885057
2015,21201,7,58,7,21,0,0,7,21,0.0133587786259542,0.333333333333333
2015,21203,18,343,2,58,0,12,2,70,0.00592216582064298,0.0285714285714286
2015,21205,229,797,108,236,0,0,108,236,0.0173312770801204,0.457627118644068
2015,21207,39,231,3,48,0,14,3,62,0.00501050589946662,0.0483870967741935
2015,21209,248,1165,264,790,27,111,291,901,0.0279154789936795,0.322974472807991
2015,21211,112,1007,138,547,28,101,166,648,0.0216678927305557,0.256172839506173
2015,21213,31,399,155,269,0,0,155,269,0.0223812297196106,0.576208178438662
2015,21215,95,635,27,79,0,0,27,79,0.00657183262623742,0.341772151898734
2015,21217,97,480,0,134,14,63,14,197,0.0120283306875076,0.0710659898477157
2015,21219,23,260,48,206,4,26,52,232,0.0285714285714286,0.224137931034483
2015,21221,34,128,27,148,5,13,32,161,0.0157765801077903,0.198757763975155
2015,21223,4,223,0,53,29,29,29,82,0.0136190001660854,0.353658536585366
2015,21225,5,306,19,60,0,0,19,60,0.00626239432209581,0.316666666666667
2015,21227,431,2135,562,2301,115,384,677,2685,0.0371930018977435,0.252141527001862
2015,21229,39,300,22,92,0,10,22,102,0.0127963869025216,0.215686274509804
2015,21231,10,209,0,259,0,0,0,259,0.0178141550312951,0
2015,21233,12,335,7,62,0,0,7,62,0.00677595628415301,0.112903225806452
2015,21235,70,719,110,333,0,0,110,333,0.014507275420406,0.33033033033033
2015,21237,33,186,0,30,0,0,0,30,0.00596184419713832,0
2015,21239,179,571,129,232,9,87,138,319,0.0183007285870002,0.432601880877743
2015,22001,209,1323,117,622,14,217,131,839,0.0210904703250295,0.156138259833135
2015,22003,44,730,61,450,0,71,61,521,0.0293240276917881,0.117082533589251
2015,22005,535,1728,329,1194,76,409,405,1603,0.0218869470234844,0.252651278852152
2015,22007,43,297,42,165,0,15,42,180,0.0116504854368932,0.233333333333333
2015,22009,114,1068,7,115,3,15,10,130,0.00465416010310755,0.0769230769230769
2015,22011,164,1166,49,487,40,96,89,583,0.0243963677449052,0.152658662092624
2015,22013,41,406,26,102,0,11,26,113,0.0117732861012711,0.230088495575221
2015,22015,881,3079,1094,2756,76,287,1170,3043,0.0379450090404639,0.384488991127177
2015,22017,886,3983,841,2462,198,421,1039,2883,0.017144080445758,0.360388484217829
2015,22019,432,2206,792,3175,170,340,962,3515,0.0275388207273696,0.273684210526316
2015,22021,3,314,4,61,5,36,9,97,0.0142731018246027,0.0927835051546392
2015,22023,7,51,0,96,0,4,0,100,0.0220896841175171,0
2015,22025,16,450,107,118,0,2,107,120,0.0172141730024387,0.891666666666667
2015,22027,43,552,0,122,0,15,0,137,0.0116160759708326,0
2015,22029,45,713,8,261,0,26,8,287,0.0210287221570926,0.0278745644599303
2015,22031,25,384,13,204,0,43,13,247,0.0136095652653039,0.0526315789473684
2015,22033,2111,6062,2628,4917,544,992,3172,5909,0.0212939238982764,0.536808258588594
2015,22035,10,314,4,169,0,0,4,169,0.0340863251311012,0.0236686390532544
2015,22037,30,877,63,152,0,0,63,152,0.0106929300035174,0.414473684210526
2015,22039,64,888,0,280,0,142,0,422,0.019499122077442,0
2015,22041,63,713,21,198,0,10,21,208,0.0153482880755608,0.100961538461538
2015,22043,24,486,3,573,0,46,3,619,0.0396439093121558,0.00484652665589661
2015,22045,240,1255,74,534,0,196,74,730,0.015390453702142,0.101369863013699
2015,22047,117,1631,2,236,0,8,2,244,0.0106806741081199,0.00819672131147541
2015,22049,50,756,37,270,3,28,40,298,0.0266404434114071,0.134228187919463
2015,22051,2039,7593,1710,4807,567,1357,2277,6164,0.0204233098750215,0.369402985074627
2015,22053,72,831,60,180,0,13,60,193,0.00934127099365955,0.310880829015544
2015,22055,1735,5221,1330,4251,200,574,1530,4825,0.0320681106731977,0.317098445595855
2015,22057,341,1952,150,374,34,272,184,646,0.00999473961073119,0.284829721362229
2015,22059,47,502,0,246,0,19,0,265,0.0260775437905924,0
2015,22061,247,725,187,377,70,99,257,476,0.0186974624872339,0.539915966386555
2015,22063,912,3018,44,1319,0,126,44,1445,0.0166470818644732,0.0304498269896194
2015,22065,11,457,24,147,0,22,24,169,0.0215726321164156,0.142011834319527
2015,22067,45,297,42,127,0,0,42,127,0.00703679078014184,0.330708661417323
2015,22069,98,733,12,240,4,16,16,256,0.0109224336547487,0.0625
2015,22071,2242,6147,4703,8236,889,1426,5592,9662,0.0373549220193772,0.578762161043262
2015,22073,548,3077,463,1253,32,79,495,1332,0.0134618883027106,0.371621621621622
2015,22075,68,255,115,376,0,52,115,428,0.0282881692002644,0.268691588785047
2015,22077,23,188,5,90,0,38,5,128,0.00827300930713547,0.0390625
2015,22079,212,1815,252,998,24,181,276,1179,0.013623600374389,0.234096692111959
2015,22081,6,186,0,2,0,14,0,16,0.00276481769483325,0
2015,22083,111,595,71,150,0,9,71,159,0.0115510352342899,0.446540880503145
2015,22085,35,331,26,131,4,15,30,146,0.00892857142857143,0.205479452054795
2015,22087,105,1182,53,408,54,130,107,538,0.0197206847256332,0.198884758364312
2015,22089,218,1272,119,454,35,124,154,578,0.0167750174135129,0.26643598615917
2015,22091,14,309,0,6,0,0,0,6,0.00082815734989648,0
2015,22093,5,338,0,51,0,2,0,53,0.00366224433388612,0
2015,22095,165,759,27,175,11,11,38,186,0.00648286919242968,0.204301075268817
2015,22097,161,1444,52,433,1,19,53,452,0.00840570546556822,0.117256637168142
2015,22099,141,967,4,194,40,216,44,410,0.0117162942218666,0.107317073170732
2015,22101,67,541,142,525,14,99,156,624,0.0176820629073392,0.25
2015,22103,1481,4624,1993,4536,181,494,2174,5030,0.0306836412881029,0.43220675944334
2015,22105,413,2377,227,1328,32,74,259,1402,0.0175805986432091,0.184736091298145
2015,22107,0,40,0,13,0,0,0,13,0.00389805097451274,0
2015,22109,281,1886,114,1105,17,136,131,1241,0.0170417873964928,0.105560032232071
2015,22111,31,243,30,67,0,11,30,78,0.00503908521222301,0.384615384615385
2015,22113,179,1449,42,312,14,78,56,390,0.010141196661206,0.143589743589744
2015,22115,88,455,605,1945,175,552,780,2497,0.0801399319596893,0.312374849819784
2015,22117,60,979,51,528,27,93,78,621,0.0198073488134728,0.1256038647343
2015,22119,86,714,12,237,25,70,37,307,0.0110702437617193,0.120521172638436
2015,22121,187,967,48,378,0,15,48,393,0.0240631888317414,0.122137404580153
2015,22123,12,239,3,99,0,0,3,99,0.0127610208816705,0.0303030303030303
2015,22125,216,540,10,96,9,9,19,105,0.00953505266981475,0.180952380952381
2015,22127,4,405,29,176,0,0,29,176,0.0171189572998736,0.164772727272727
2015,23001,519,2065,332,943,28,106,360,1049,0.0141714625381643,0.343183984747378
2015,23003,122,391,115,794,11,49,126,843,0.0164809384164223,0.149466192170818
2015,23005,1591,4366,3323,5914,568,1209,3891,7123,0.0350084781166294,0.546258598904956
2015,23007,80,502,146,298,3,15,149,313,0.0145954768011191,0.476038338658147
2015,23009,236,856,205,649,44,198,249,847,0.0207526829029255,0.293978748524203
2015,23011,684,2191,571,1323,36,54,607,1377,0.0159268083925143,0.44081336238199
2015,23013,182,658,274,631,65,72,339,703,0.0236207244136819,0.48221906116643
2015,23015,121,676,184,365,29,43,213,408,0.0157219374975916,0.522058823529412
2015,23017,134,1033,248,732,14,59,262,791,0.0189157519669034,0.331226295828066
2015,23019,541,2357,766,1933,108,188,874,2121,0.0200018860807243,0.412069778406412
2015,23021,39,268,49,146,16,23,65,169,0.0129323538414448,0.384615384615385
2015,23023,376,1147,179,447,0,26,179,473,0.0184003734536684,0.378435517970402
2015,23025,143,1067,117,584,27,31,144,615,0.0164161973146838,0.234146341463415
2015,23027,257,742,245,618,34,92,279,710,0.0251416430594901,0.392957746478873
2015,23029,53,393,174,354,78,105,252,459,0.0194664744051911,0.549019607843137
2015,23031,781,2764,2034,4066,178,364,2212,4430,0.0308073186505977,0.499322799097065
2015,24001,89,713,221,997,50,128,271,1125,0.0220143631489345,0.240888888888889
2015,24003,3565,9971,4996,9866,923,1921,5919,11787,0.0311285999128494,0.502163400356325
2015,24005,4718,15097,4153,8197,1367,2898,5520,11095,0.0196380023222225,0.497521406038756
2015,24009,613,1689,742,1291,129,227,871,1518,0.025220136235255,0.573781291172596
2015,24011,164,1065,51,286,0,19,51,305,0.0138882564546241,0.167213114754098
2015,24013,1273,2779,390,1198,93,188,483,1386,0.0121607749203759,0.348484848484849
2015,24015,122,1042,621,1684,32,145,653,1829,0.0267268715385852,0.357025697102242
2015,24017,648,2688,732,2218,73,252,805,2470,0.0246598045186346,0.325910931174089
2015,24019,277,713,65,241,9,81,74,322,0.0139418081052996,0.229813664596273
2015,24021,1738,3864,1645,3444,462,834,2107,4278,0.0264428277383903,0.492519869097709
2015,24023,42,295,105,527,0,22,105,549,0.0257940236797594,0.191256830601093
2015,24025,1347,4123,1520,3061,242,509,1762,3570,0.0210324146625976,0.493557422969188
2015,24027,4052,7252,3384,4737,750,1551,4134,6288,0.0307755557513288,0.657442748091603
2015,24029,81,230,171,405,0,22,171,427,0.0307858687815429,0.400468384074941
2015,24031,4189,9286,17133,23664,5926,10151,23059,33815,0.0484042971965159,0.681916309330179
2015,24033,3494,9497,7278,18670,1921,4376,9199,23046,0.0390032392692858,0.399158205328474
2015,24035,409,1433,286,426,156,236,442,662,0.0195188111805637,0.667673716012085
2015,24037,550,1821,727,2188,181,441,908,2629,0.0367975365665897,0.345378470901483
2015,24039,45,1558,208,390,9,11,217,401,0.0237179866327557,0.541147132169576
2015,24041,229,1019,266,762,45,86,311,848,0.0300997408866645,0.366745283018868
2015,24043,447,3310,721,2475,40,138,761,2613,0.025294032234645,0.291236127057023
2015,24045,396,1643,357,1435,214,250,571,1685,0.0266875732522411,0.338872403560831
2015,24047,442,1225,196,813,65,167,261,980,0.0255161819459994,0.266326530612245
2015,24510,5027,13356,5297,8112,1382,2534,6679,10646,0.0253382077133255,0.627371782829232
2015,25001,1499,3166,1173,2442,119,504,1292,2946,0.0179133882207007,0.438560760353021
2015,25003,371,869,593,1761,85,241,678,2002,0.0215005262366561,0.338661338661339
2015,25005,1687,6341,1436,4600,401,1022,1837,5622,0.0147562928160844,0.326752045535397
2015,25007,109,160,280,427,5,90,285,517,0.0404728354470017,0.551257253384913
2015,25009,4372,10037,3273,7062,1084,3371,4357,10433,0.0199474593900089,0.417617176267612
2015,25011,593,1351,547,975,55,268,602,1243,0.0237812810897681,0.484312148028962
2015,25013,1379,3995,1036,3615,376,2032,1412,5647,0.0181945889865868,0.250044271294493
2015,25015,1094,2405,1461,2005,492,712,1953,2717,0.0276908651739215,0.718807508281192
2015,25017,15327,25380,16799,22486,8252,12776,25051,35262,0.0325588352612684,0.71042481991946
2015,25019,60,238,111,132,27,27,138,159,0.0208743599842458,0.867924528301887
2015,25021,10939,18980,4874,7083,2489,3679,7363,10762,0.0224785751733098,0.68416651180078
2015,25023,3536,9865,1451,3765,351,1392,1802,5157,0.0149350555322261,0.349427961993407
2015,25025,10797,18817,10045,13060,4184,7490,14229,20550,0.0401834948494732,0.692408759124088
2015,25027,3913,9475,2950,6742,985,2752,3935,9494,0.0172841618892787,0.414472298293659
2015,26001,53,334,25,141,6,37,31,178,0.0207121247381894,0.174157303370787
2015,26003,44,541,19,161,0,13,19,174,0.0237380627557981,0.109195402298851
2015,26005,623,2796,246,643,4,165,250,808,0.0106871238674691,0.309405940594059
2015,26007,85,517,58,216,12,30,70,246,0.011605415860735,0.284552845528455
2015,26009,146,630,57,163,3,33,60,196,0.0113314447592068,0.306122448979592
2015,26011,36,431,10,56,4,18,14,74,0.00648156258211439,0.189189189189189
2015,26013,31,375,18,53,0,3,18,56,0.00849385712118914,0.321428571428571
2015,26015,263,1260,155,401,10,44,165,445,0.0108871165043793,0.370786516853933
2015,26017,306,1670,155,606,75,135,230,741,0.00987486507016352,0.310391363022942
2015,26019,126,502,68,184,6,18,74,202,0.0156213749903333,0.366336633663366
2015,26021,283,1199,1302,2618,432,525,1734,3143,0.0294175456987486,0.551702195354757
2015,26023,85,784,45,342,3,36,48,378,0.0126709573612228,0.126984126984127
2015,26025,462,2692,393,1266,60,153,453,1419,0.0156243118255891,0.319238900634249
2015,26027,77,730,162,765,0,30,162,795,0.0218610790298631,0.20377358490566
2015,26029,254,704,105,293,14,57,119,350,0.0185028547261578,0.34
2015,26031,101,650,95,285,0,20,95,305,0.0158854166666667,0.311475409836066
2015,26033,127,1355,231,445,9,108,240,553,0.0210402161092722,0.433996383363472
2015,26035,98,940,3,143,2,23,5,166,0.0074828705373242,0.0301204819277108
2015,26037,761,2126,200,536,27,56,227,592,0.0115107913669065,0.383445945945946
2015,26039,88,556,5,65,7,27,12,92,0.00888974780171997,0.130434782608696
2015,26041,174,547,94,456,9,39,103,495,0.0186524983043183,0.208080808080808
2015,26043,110,292,75,446,12,49,87,495,0.026280860100876,0.175757575757576
2015,26045,1246,4293,320,936,118,199,438,1135,0.0151977718861305,0.385903083700441
2015,26047,306,799,206,395,17,41,223,436,0.0185650415158612,0.511467889908257
2015,26049,1324,5948,766,3085,108,465,874,3550,0.0127268881503709,0.246197183098592
2015,26051,107,639,18,68,0,22,18,90,0.00478265490487831,0.2
2015,26053,25,483,52,217,8,8,60,225,0.018698578908003,0.266666666666667
2015,26055,781,2828,487,1005,82,176,569,1181,0.0185321763145919,0.481795088907705
2015,26057,66,1379,41,172,9,48,50,220,0.00776287932251235,0.227272727272727
2015,26059,60,705,132,359,3,92,135,451,0.0144634725161952,0.299334811529933
2015,26061,96,383,198,402,86,160,284,562,0.0261626553698617,0.505338078291815
2015,26063,157,745,13,77,15,59,28,136,0.00574542689366736,0.205882352941176
2015,26065,2335,6558,1535,3221,850,1212,2385,4433,0.0261909404042373,0.538010376720054
2015,26067,322,2433,30,421,10,117,40,538,0.0125066834042355,0.0743494423791822
2015,26069,164,790,84,450,11,34,95,484,0.0248001639680262,0.196280991735537
2015,26071,14,64,11,167,3,17,14,184,0.0204899777282851,0.0760869565217391
2015,26073,408,1565,146,463,106,285,252,748,0.0203144944461041,0.336898395721925
2015,26075,920,5048,393,1050,78,227,471,1277,0.0116817300303707,0.368833202819107
2015,26077,1988,4779,1070,2933,242,472,1312,3405,0.0214503052179994,0.385315712187959
2015,26079,119,628,16,181,8,22,24,203,0.0164719246997728,0.118226600985222
2015,26081,4146,10801,2973,6165,869,1647,3842,7812,0.0194335609537669,0.491807475678443
2015,26083,16,49,18,31,0,0,18,31,0.0179814385150812,0.580645161290323
2015,26085,23,413,23,111,4,11,27,122,0.0138667879063424,0.221311475409836
2015,26087,489,2370,179,534,28,156,207,690,0.0113061003785086,0.3
2015,26089,293,742,158,255,6,12,164,267,0.0161115133960898,0.614232209737828
2015,26091,254,1934,306,885,24,129,330,1014,0.01506261233827,0.325443786982249
2015,26093,1732,4404,456,1257,106,256,562,1513,0.0119742944425978,0.371447455386649
2015,26095,24,291,8,29,0,8,8,37,0.00760378133990958,0.216216216216216
2015,26097,91,254,37,115,7,30,44,145,0.0172372800760818,0.303448275862069
2015,26099,4505,18759,1240,4334,1160,2714,2400,7048,0.0118938530987639,0.340522133938706
2015,26101,97,687,109,285,12,44,121,329,0.0181497214100513,0.367781155015198
2015,26103,238,1237,335,923,39,95,374,1018,0.0228046594982079,0.367387033398821
2015,26105,189,832,129,388,7,57,136,445,0.0216745409380936,0.30561797752809
2015,26107,208,870,90,216,16,53,106,269,0.0101620641456688,0.394052044609665
2015,26109,22,286,88,438,6,26,94,464,0.0267543100962925,0.202586206896552
2015,26111,321,1669,643,1310,217,258,860,1568,0.0273666573582798,0.548469387755102
2015,26113,67,444,30,111,0,5,30,116,0.0111828786272052,0.258620689655172
2015,26115,431,2596,392,1685,59,203,451,1888,0.0182703194402779,0.238877118644068
2015,26117,216,1769,62,416,8,32,70,448,0.010379740969857,0.15625
2015,26119,29,382,13,137,8,13,21,150,0.0200937709310114,0.14
2015,26121,626,4225,172,1099,77,177,249,1276,0.0111061789000009,0.195141065830721
2015,26123,167,1259,74,353,0,49,74,402,0.012222560048647,0.18407960199005
2015,26125,10844,27115,6837,11295,4141,6039,10978,17334,0.0202853334487993,0.633321795315565
2015,26127,170,752,47,203,8,58,55,261,0.0146703389354168,0.210727969348659
2015,26129,55,590,18,103,4,13,22,116,0.00738806445449334,0.189655172413793
2015,26131,6,52,11,47,0,8,11,55,0.0107003891050584,0.2
2015,26133,61,510,40,155,6,9,46,164,0.0102840659685207,0.280487804878049
2015,26135,22,285,15,58,0,25,15,83,0.0132228771706229,0.180722891566265
2015,26137,217,799,52,250,9,12,61,262,0.0154253753311746,0.232824427480916
2015,26139,1590,5599,908,1719,290,578,1198,2297,0.0137328638132761,0.52154984762734
2015,26141,66,421,51,120,0,11,51,131,0.0129357164016984,0.389312977099237
2015,26143,59,741,37,248,0,32,37,280,0.0147414973149416,0.132142857142857
2015,26145,639,2975,385,1476,140,346,525,1822,0.0137889279903129,0.28814489571899
2015,26147,577,3351,279,1247,48,165,327,1412,0.0126625414761008,0.231586402266289
2015,26149,148,921,109,597,7,24,116,621,0.0152963200157643,0.186795491143317
2015,26151,109,996,38,247,6,38,44,285,0.00971237731733915,0.154385964912281
2015,26153,29,148,11,46,0,5,11,51,0.0082470892626132,0.215686274509804
2015,26155,239,1353,144,530,3,41,147,571,0.0120466676512163,0.257443082311734
2015,26157,141,1057,73,324,3,43,76,367,0.00962395762311848,0.20708446866485
2015,26159,229,1090,119,636,141,314,260,950,0.0186805623832465,0.273684210526316
2015,26161,3190,7473,4275,6011,2106,2759,6381,8770,0.0399329745284995,0.727594070695553
2015,26163,5896,19061,3499,10705,1956,4466,5455,15171,0.0129601422873442,0.359567596071452
2015,26165,87,720,35,204,0,24,35,228,0.010084479632005,0.153508771929825
2015,27001,56,409,4,91,2,22,6,113,0.00922750285807611,0.0530973451327434
2015,27003,2257,9331,794,2767,186,699,980,3466,0.0152393179679737,0.282746682054241
2015,27005,140,615,124,371,9,71,133,442,0.0194936932169004,0.300904977375566
2015,27007,334,824,113,333,18,35,131,368,0.0134404674945215,0.355978260869565
2015,27009,410,1772,18,375,0,26,18,401,0.0153223033128272,0.0448877805486284
2015,27011,37,100,6,27,4,8,10,35,0.00935078813785733,0.285714285714286
2015,27013,400,1171,181,459,49,74,230,533,0.0141627251953021,0.431519699812383
2015,27015,114,279,43,168,0,21,43,189,0.0108328079325959,0.227513227513228
2015,27017,218,878,51,214,2,15,53,229,0.00936528709308032,0.231441048034935
2015,27019,1556,3484,532,896,45,170,577,1066,0.0173839304642781,0.541275797373358
2015,27021,126,636,64,183,7,26,71,209,0.0101352989670724,0.339712918660287
2015,27023,68,393,11,37,3,5,14,42,0.00497100248550124,0.333333333333333
2015,27025,451,2227,107,347,14,65,121,412,0.0112267698512181,0.293689320388349
2015,27027,134,528,402,1138,42,84,444,1222,0.033435482105724,0.363338788870704
2015,27029,35,179,8,66,0,16,8,82,0.0137399463806971,0.0975609756097561
2015,27031,17,72,17,44,10,54,27,98,0.0239667400342382,0.275510204081633
2015,27033,60,315,60,138,0,3,60,141,0.0177180196029153,0.425531914893617
2015,27035,315,1409,138,581,22,85,160,666,0.0150291104391389,0.24024024024024
2015,27037,3728,9790,2153,4221,574,1527,2727,5748,0.0210669061188587,0.474425887265136
2015,27039,109,552,31,87,2,17,33,104,0.00792985131528784,0.317307692307692
2015,27041,192,833,98,236,0,26,98,262,0.0100846805234796,0.374045801526718
2015,27043,44,291,41,93,0,5,41,98,0.00956564177647633,0.418367346938776
2015,27045,70,353,59,182,5,19,64,201,0.0139225600886611,0.318407960199005
2015,27047,119,452,48,228,4,42,52,270,0.0123057290005013,0.192592592592593
2015,27049,259,1085,160,468,16,50,176,518,0.0160093954753369,0.33976833976834
2015,27051,20,118,10,34,0,2,10,36,0.0084230229293402,0.277777777777778
2015,27053,11376,23222,10149,18038,3677,6307,13826,24345,0.0296397934163012,0.567919490655165
2015,27055,41,182,93,329,4,7,97,336,0.0251534660877377,0.288690476190476
2015,27057,175,535,40,196,2,5,42,201,0.0134286477819348,0.208955223880597
2015,27059,300,1362,35,200,0,65,35,265,0.0102391715930605,0.132075471698113
2015,27061,231,942,102,509,15,50,117,559,0.0171925939595251,0.209302325581395
2015,27063,73,228,11,94,8,17,19,111,0.0154919748778786,0.171171171171171
2015,27065,100,545,54,154,4,17,58,171,0.0151555437383675,0.339181286549708
2015,27067,148,600,101,410,18,35,119,445,0.0155692393814289,0.267415730337079
2015,27069,7,67,7,22,2,3,9,25,0.0078003120124805,0.36
2015,27071,9,203,67,114,0,18,67,132,0.0137571651902032,0.507575757575758
2015,27073,40,111,8,26,2,11,10,37,0.00719424460431655,0.27027027027027
2015,27075,45,195,34,127,28,44,62,171,0.0210022107590273,0.362573099415205
2015,27077,13,134,1,41,0,0,1,41,0.013856032443393,0.024390243902439
2015,27079,159,647,67,263,10,18,77,281,0.0148945192409626,0.274021352313167
2015,27081,9,95,26,70,0,0,26,70,0.0168634064080944,0.371428571428571
2015,27083,126,382,76,225,19,24,95,249,0.015206106870229,0.381526104417671
2015,27085,234,835,19,41,6,24,25,65,0.00263777290804318,0.384615384615385
2015,27087,10,111,7,29,0,0,7,29,0.00858496151568976,0.241379310344828
2015,27089,34,143,17,98,0,8,17,106,0.0160241874527589,0.160377358490566
2015,27091,70,240,35,261,4,41,39,302,0.0207802931259891,0.129139072847682
2015,27093,111,648,24,104,1,72,25,176,0.0111639708214399,0.142045454545455
2015,27095,87,907,23,106,0,15,23,121,0.00685358255451713,0.190082644628099
2015,27097,132,726,34,101,16,61,50,162,0.00713593515989781,0.308641975308642
2015,27099,140,737,85,292,44,114,129,406,0.015633423180593,0.317733990147783
2015,27101,31,162,20,54,2,10,22,64,0.0103879240383055,0.34375
2015,27103,325,1222,75,260,40,61,115,321,0.0150428792352031,0.358255451713396
2015,27105,40,199,64,222,3,82,67,304,0.0218077474892396,0.220394736842105
2015,27107,25,79,3,63,0,8,3,71,0.0151095977867631,0.0422535211267606
2015,27109,722,2324,1342,2358,400,655,1742,3013,0.0300311973606834,0.578161301028875
2015,27111,233,894,174,590,16,50,190,640,0.0155524774610581,0.296875
2015,27113,57,367,57,233,0,6,57,239,0.0250026153363323,0.238493723849372
2015,27115,153,1007,40,309,0,33,40,342,0.0162046908315565,0.116959064327485
2015,27117,70,153,7,153,0,53,7,206,0.0324052225892717,0.0339805825242718
2015,27119,177,600,115,539,30,43,145,582,0.0277129660492357,0.24914089347079
2015,27121,35,347,11,95,3,13,14,108,0.013595166163142,0.12962962962963
2015,27123,6785,16448,3847,6552,1238,2692,5085,9244,0.026708580608253,0.550086542622241
2015,27125,27,107,0,14,0,3,0,17,0.00606493043168034,0
2015,27127,80,262,19,104,18,33,37,137,0.0128109220123434,0.27007299270073
2015,27129,53,338,35,114,2,16,37,130,0.012152940076657,0.284615384615385
2015,27131,443,2685,209,555,0,124,209,679,0.0166666666666667,0.30780559646539
2015,27133,36,101,79,214,9,9,88,223,0.0343024150130749,0.394618834080717
2015,27135,72,289,14,81,0,16,14,97,0.00922053231939163,0.144329896907216
2015,27137,810,2465,757,1840,135,243,892,2083,0.0153041357167523,0.42822851656265
2015,27139,1429,4694,376,1006,63,231,439,1237,0.0141250356836997,0.354890864995958
2015,27141,827,3940,206,751,76,147,282,898,0.0155487065830938,0.314031180400891
2015,27143,32,244,6,146,3,37,9,183,0.0178327811342818,0.0491803278688525
2015,27145,841,3657,439,1107,102,330,541,1437,0.0153188495405411,0.376478775226166
2015,27147,71,714,147,347,39,45,186,392,0.0161802947125108,0.474489795918367
2015,27149,41,226,4,102,32,48,36,150,0.026168876482903,0.24
2015,27151,39,173,41,76,0,7,41,83,0.0122999407231772,0.493975903614458
2015,27153,99,571,74,147,4,24,78,171,0.0102727381953622,0.456140350877193
2015,27155,5,37,8,41,2,8,10,49,0.0195296931048226,0.204081632653061
2015,27157,137,531,71,137,6,23,77,160,0.0106213489113117,0.48125
2015,27159,44,378,17,83,0,21,17,104,0.0110216193302247,0.163461538461538
2015,27161,106,519,28,227,11,27,39,254,0.0190162461630606,0.153543307086614
2015,27163,3030,7614,1498,2767,212,548,1710,3315,0.0201279933938893,0.515837104072398
2015,27165,65,277,14,46,0,4,14,50,0.00667467627820051,0.28
2015,27167,27,96,43,154,8,11,51,165,0.0363676438175006,0.309090909090909
2015,27169,78,326,160,558,23,42,183,600,0.0193685841564982,0.305
2015,27171,999,3431,215,685,39,169,254,854,0.0103844937863275,0.297423887587822
2015,27173,29,211,30,104,8,21,38,125,0.0177809388335704,0.304
2015,28001,55,88,48,434,22,268,70,702,0.031183368869936,0.0997150997150997
2015,28003,82,743,151,729,0,0,151,729,0.028839306907192,0.207133058984911
2015,28005,52,140,3,10,0,0,3,10,0.00107805088400172,0.3
2015,28007,44,469,23,375,2,14,25,389,0.0305074111834366,0.06426735218509
2015,28009,5,125,61,231,0,2,61,233,0.0408771929824561,0.261802575107296
2015,28011,82,574,132,376,17,25,149,401,0.018816573600488,0.371571072319202
2015,28013,11,365,6,67,8,35,14,102,0.0102750075551526,0.137254901960784
2015,28015,14,182,0,21,24,24,24,45,0.00614586178639716,0.533333333333333
2015,28017,0,445,47,76,0,0,47,76,0.00670785525154457,0.618421052631579
2015,28019,16,216,15,169,0,0,15,169,0.0296439221189265,0.0887573964497041
2015,28021,1,60,0,15,0,9,0,24,0.00449943757030371,0
2015,28023,16,161,23,114,6,21,29,135,0.0120913569189431,0.214814814814815
2015,28025,18,169,27,82,0,16,27,98,0.00732162868883078,0.275510204081633
2015,28027,27,269,38,265,0,0,38,265,0.0173247907949791,0.143396226415094
2015,28029,60,377,42,110,0,16,42,126,0.00670533766164653,0.333333333333333
2015,28031,194,599,19,54,0,45,19,99,0.00772954403497814,0.191919191919192
2015,28033,250,2414,1290,4397,28,317,1318,4714,0.0433910162002945,0.279592702588036
2015,28035,639,2760,238,857,30,228,268,1085,0.0234407068939443,0.247004608294931
2015,28037,22,45,0,12,0,26,0,38,0.00715900527505652,0
2015,28039,66,746,6,198,0,41,6,239,0.0159973226238286,0.0251046025104603
2015,28041,26,1488,16,136,0,0,16,136,0.0135701456795051,0.117647058823529
2015,28043,115,332,0,75,0,40,0,115,0.00802792321116928,0
2015,28045,260,1152,177,1251,41,45,218,1296,0.0409258849906843,0.16820987654321
2015,28047,583,3408,1436,5697,237,693,1673,6390,0.0500031300863904,0.261815336463224
2015,28049,1254,4163,715,1721,72,314,787,2035,0.0132166887486036,0.386732186732187
2015,28051,30,91,42,164,0,43,42,207,0.0183153424172713,0.202898550724638
2015,28053,2,120,0,0,0,0,0,0,0,NA
2015,28055,7,140,0,16,0,0,0,16,0.015732546705998,0
2015,28057,52,563,32,281,0,22,32,303,0.0194717563138616,0.105610561056106
2015,28059,483,1924,517,2020,35,249,552,2269,0.024200343433697,0.243278977523138
2015,28061,54,186,0,73,0,3,0,76,0.00674117438353734,0
2015,28063,0,137,0,26,0,0,0,26,0.00528885272579333,0
2015,28065,3,240,31,80,0,0,31,80,0.00965250965250965,0.3875
2015,28067,140,628,227,526,0,14,227,540,0.0121340134372964,0.42037037037037
2015,28069,24,346,0,88,0,0,0,88,0.0130467012601927,0
2015,28071,147,736,547,1037,118,128,665,1165,0.0407656239065015,0.570815450643777
2015,28073,987,3245,466,1165,13,43,479,1208,0.0319949147155419,0.396523178807947
2015,28075,312,1782,384,1373,0,11,384,1384,0.0263278039872166,0.277456647398844
2015,28077,9,109,6,77,0,7,6,84,0.00999048525214082,0.0714285714285714
2015,28079,23,347,25,122,8,53,33,175,0.0120664690064125,0.188571428571429
2015,28081,407,1907,267,711,116,156,383,867,0.0155800747556067,0.441753171856978
2015,28083,20,305,13,243,19,75,32,318,0.0164604793208758,0.10062893081761
2015,28085,67,225,74,131,0,12,74,143,0.00627688526029321,0.517482517482518
2015,28087,133,959,343,993,54,102,397,1095,0.0281209070597601,0.362557077625571
2015,28089,1459,2863,790,1287,90,184,880,1471,0.0223603806280972,0.598232494901428
2015,28091,118,445,25,338,13,70,38,408,0.0232650966527912,0.0931372549019608
2015,28093,36,572,21,240,0,37,21,277,0.0113236857166217,0.075812274368231
2015,28095,76,494,35,121,0,27,35,148,0.00600820038160192,0.236486486486486
2015,28097,16,133,0,18,0,53,0,71,0.0102541883304448,0
2015,28099,137,649,0,184,0,7,0,191,0.0102588892469653,0
2015,28101,74,503,0,112,0,0,0,112,0.00806451612903226,0
2015,28103,23,118,10,46,0,31,10,77,0.0105841924398625,0.12987012987013
2015,28105,189,534,309,660,38,94,347,754,0.0307805355976486,0.460212201591512
2015,28107,52,377,4,170,0,0,4,170,0.0076662908680947,0.0235294117647059
2015,28109,91,531,141,1248,0,17,141,1265,0.0344302005933426,0.111462450592885
2015,28111,26,230,25,175,0,19,25,194,0.0234696346479555,0.128865979381443
2015,28113,119,493,88,498,33,64,121,562,0.0219745845552297,0.215302491103203
2015,28115,24,615,25,308,0,0,25,308,0.0156902699949058,0.0811688311688312
2015,28117,128,661,85,137,34,34,119,171,0.0102395209580838,0.695906432748538
2015,28119,14,167,0,84,0,5,0,89,0.0174407211444248,0
2015,28121,1348,5098,728,1714,21,211,749,1925,0.0194252154432986,0.389090909090909
2015,28123,87,743,54,105,0,22,54,127,0.0069357216973404,0.425196850393701
2015,28125,40,101,0,24,0,0,0,24,0.00769724182168056,0
2015,28127,48,295,30,235,0,5,30,240,0.0133741989412092,0.125
2015,28129,15,190,5,22,0,0,5,22,0.00204898947564497,0.227272727272727
2015,28131,16,288,48,140,0,7,48,147,0.0125813077713112,0.326530612244898
2015,28133,66,1388,62,181,8,19,70,200,0.0110809463128151,0.35
2015,28135,15,142,8,818,0,7,8,825,0.0754389173372348,0.0096969696969697
2015,28137,88,573,0,244,0,0,0,244,0.013403647549989,0
2015,28139,3,286,16,76,0,7,16,83,0.0057367984517556,0.192771084337349
2015,28141,20,333,27,136,0,53,27,189,0.0138807285546416,0.142857142857143
2015,28143,109,377,0,122,0,0,0,122,0.0189765126769326,0
2015,28145,49,419,13,174,0,0,13,174,0.00945395273023635,0.0747126436781609
2015,28147,1,205,20,197,0,0,20,197,0.019880916338682,0.101522842639594
2015,28149,74,408,76,292,28,77,104,369,0.011601584606678,0.281842818428184
2015,28151,163,662,57,410,12,66,69,476,0.0151616499442586,0.144957983193277
2015,28153,13,101,39,109,0,0,39,109,0.00814161936062145,0.357798165137615
2015,28155,19,160,16,103,0,0,16,103,0.0152637818612922,0.155339805825243
2015,28157,7,366,21,73,0,3,21,76,0.0118842845973417,0.276315789473684
2015,28159,142,469,9,130,0,3,9,133,0.0105388272583201,0.0676691729323308
2015,28161,11,223,16,88,0,28,16,116,0.0137164479129715,0.137931034482759
2015,28163,34,352,154,781,22,113,176,894,0.0484054361362283,0.196868008948546
2015,29001,79,299,210,412,6,66,216,478,0.0351780983220489,0.451882845188285
2015,29003,97,336,39,218,7,24,46,242,0.0201481974856382,0.190082644628099
2015,29005,16,80,13,127,0,6,13,133,0.0335519677093845,0.0977443609022556
2015,29007,86,1331,18,322,0,40,18,362,0.0206444254348446,0.0497237569060773
2015,29009,114,763,92,619,3,106,95,725,0.0293712526332847,0.131034482758621
2015,29011,36,199,27,174,0,4,27,178,0.021675596687774,0.151685393258427
2015,29013,35,370,26,180,0,10,26,190,0.0166374781085814,0.136842105263158
2015,29015,56,593,19,413,0,0,19,413,0.0285437832607644,0.0460048426150121
2015,29017,49,300,0,13,0,9,0,22,0.00255992552943914,0
2015,29019,1216,3319,1562,2735,492,635,2054,3370,0.0337502879290142,0.609495548961424
2015,29021,272,2652,391,1679,66,159,457,1838,0.0308166926546284,0.248639825897715
2015,29023,117,713,53,514,0,30,53,544,0.018530503798072,0.0974264705882353
2015,29025,23,298,13,64,0,0,13,64,0.0102350871581641,0.203125
2015,29027,203,2233,117,684,41,77,158,761,0.0255798319327731,0.207621550591327
2015,29029,293,1244,246,1069,15,39,261,1108,0.033711625642742,0.235559566787004
2015,29031,513,1854,377,871,21,120,398,991,0.0199790331035039,0.401614530776993
2015,29033,41,212,0,84,0,2,0,86,0.0137490007993605,0
2015,29035,21,114,20,49,0,17,20,66,0.01552210724365,0.303030303030303
2015,29037,351,1976,247,1088,27,99,274,1187,0.0176592231132005,0.230834035383319
2015,29039,56,442,18,194,0,16,18,210,0.0215760813726497,0.0857142857142857
2015,29041,26,173,4,9,0,5,4,14,0.00258207303578015,0.285714285714286
2015,29043,640,2824,244,1132,16,101,260,1233,0.023098106067702,0.210867802108678
2015,29045,10,151,5,71,0,4,5,75,0.0156087408949011,0.0666666666666667
2015,29047,1329,6520,1415,3980,141,303,1556,4283,0.0278739522049253,0.363296754611254
2015,29049,172,806,53,204,0,7,53,211,0.0150595960316894,0.251184834123223
2015,29051,633,2980,425,762,50,97,475,859,0.0165147844811012,0.552968568102445
2015,29053,34,803,31,202,0,7,31,209,0.0174793008279669,0.148325358851675
2015,29055,105,814,7,220,0,0,7,220,0.0130115921457298,0.0318181818181818
2015,29057,32,302,17,79,4,4,21,83,0.0151128914785142,0.253012048192771
2015,29059,45,525,40,240,9,9,49,249,0.021805762325948,0.196787148594378
2015,29061,30,230,8,78,0,5,8,83,0.0151542815409896,0.0963855421686747
2015,29063,46,1169,30,246,0,3,30,249,0.0261939827477383,0.120481927710843
2015,29065,65,485,14,171,0,7,14,178,0.0163302752293578,0.0786516853932584
2015,29067,59,368,4,147,22,56,26,203,0.0209364686468647,0.12807881773399
2015,29069,41,595,22,474,0,27,22,501,0.0241760362881822,0.0439121756487026
2015,29071,309,1735,135,453,8,97,143,550,0.00794717297383213,0.26
2015,29073,79,433,67,143,0,0,67,143,0.0134411128865495,0.468531468531469
2015,29075,40,166,20,58,2,4,22,62,0.0134548611111111,0.354838709677419
2015,29077,1693,6228,1091,4406,275,572,1366,4978,0.0270674402292413,0.274407392527119
2015,29079,52,345,1,73,0,21,1,94,0.0136508858553587,0.0106382978723404
2015,29081,15,138,11,135,0,8,11,143,0.0238691370388917,0.0769230769230769
2015,29083,93,505,23,143,12,14,35,157,0.0100576553491352,0.222929936305732
2015,29085,15,344,0,81,0,3,0,84,0.0116488697822771,0
2015,29087,16,90,27,52,0,6,27,58,0.0170688640376692,0.46551724137931
2015,29089,61,239,25,43,0,3,25,46,0.00698769557952301,0.543478260869565
2015,29091,51,779,77,408,16,30,93,438,0.016119534815251,0.212328767123288
2015,29093,38,365,2,67,0,2,2,69,0.00951855428334943,0.0289855072463768
2015,29095,2325,8338,5051,11824,575,1218,5626,13042,0.0286047664375419,0.431375555896335
2015,29097,197,1706,528,1965,31,73,559,2038,0.0269231277329353,0.274288518155054
2015,29099,1140,4827,340,1458,59,161,399,1619,0.0108071665064616,0.246448424953675
2015,29101,137,1205,176,780,101,428,277,1208,0.0390319557982487,0.229304635761589
2015,29103,25,60,11,75,0,3,11,78,0.0284256559766764,0.141025641025641
2015,29105,186,916,149,598,50,50,199,648,0.0269651699887645,0.307098765432099
2015,29107,150,959,110,286,19,29,129,315,0.0140205634931232,0.40952380952381
2015,29109,127,1136,65,457,0,24,65,481,0.0188649645056281,0.135135135135135
2015,29111,31,181,0,151,0,0,0,151,0.0227135980746089,0
2015,29113,184,1226,30,96,0,17,30,113,0.00322857142857143,0.265486725663717
2015,29115,34,240,0,41,0,0,0,41,0.00481956036205478,0
2015,29117,54,613,30,128,0,8,30,136,0.0127412403972269,0.220588235294118
2015,29119,45,354,23,643,21,39,44,682,0.0460624071322437,0.0645161290322581
2015,29121,19,336,2,70,17,17,19,87,0.00816901408450704,0.218390804597701
2015,29123,65,303,15,48,0,1,15,49,0.0057837582625118,0.306122448979592
2015,29125,48,496,29,130,1,1,30,131,0.0205393540294763,0.229007633587786
2015,29127,147,554,69,266,14,27,83,293,0.0151986720614172,0.283276450511945
2015,29129,11,63,9,28,0,0,9,28,0.0109717868338558,0.321428571428571
2015,29131,90,541,62,222,0,0,62,222,0.0129627467009226,0.279279279279279
2015,29133,30,582,45,342,0,22,45,364,0.0368570271364925,0.123626373626374
2015,29135,68,1018,27,166,0,2,27,168,0.0159015617605301,0.160714285714286
2015,29137,69,383,37,160,0,11,37,171,0.028023598820059,0.216374269005848
2015,29139,33,422,6,71,16,27,22,98,0.011776015380918,0.224489795918367
2015,29141,47,715,22,266,22,35,44,301,0.0208651046721198,0.146179401993355
2015,29143,32,350,4,99,0,0,4,99,0.00786525780567252,0.0404040404040404
2015,29145,317,1799,168,830,7,23,175,853,0.0218673092698934,0.205158264947245
2015,29147,61,800,112,251,36,52,148,303,0.024249699879952,0.488448844884488
2015,29149,18,151,59,287,0,3,59,290,0.0376330132364391,0.203448275862069
2015,29151,49,231,0,64,0,0,0,64,0.00695652173913044,0
2015,29153,34,272,11,205,0,0,11,205,0.0287961792386571,0.0536585365853659
2015,29155,72,228,84,351,0,40,84,391,0.0342082239720035,0.214833759590793
2015,29157,74,362,41,262,0,0,41,262,0.0203605843953994,0.156488549618321
2015,29159,218,954,136,463,26,74,162,537,0.0193179365421973,0.301675977653631
2015,29161,333,1270,430,759,158,255,588,1014,0.036493198013388,0.579881656804734
2015,29163,74,981,13,176,2,2,15,178,0.0139411027568922,0.0842696629213483
2015,29165,912,2958,1033,2666,188,390,1221,3056,0.0482902471398774,0.399541884816754
2015,29167,77,645,77,322,0,13,77,335,0.0169800800851538,0.229850746268657
2015,29169,310,1274,1667,3987,529,1394,2196,5381,0.188423559072764,0.408102583162981
2015,29171,20,55,14,46,0,0,14,46,0.0132488479262673,0.304347826086957
2015,29173,32,187,45,90,8,8,53,98,0.0134099616858238,0.540816326530612
2015,29175,95,1335,28,379,26,33,54,412,0.0241076653013458,0.131067961165049
2015,29177,100,627,53,130,0,16,53,146,0.00926513516943775,0.363013698630137
2015,29179,0,96,7,26,0,0,7,26,0.00547945205479452,0.269230769230769
2015,29181,13,254,37,141,0,3,37,144,0.0149114631873253,0.256944444444444
2015,29183,2400,7719,1641,3295,432,626,2073,3921,0.015703472305659,0.528691660290742
2015,29185,31,391,10,236,3,11,13,247,0.0348771533465123,0.0526315789473684
2015,29186,65,488,0,101,6,6,6,107,0.00861721832970927,0.0560747663551402
2015,29187,270,2991,97,797,0,160,97,957,0.0208278924001045,0.101358411703239
2015,29189,5530,17034,7647,13472,1550,2771,9197,16243,0.0236564965432066,0.566213137967124
2015,29195,121,466,22,134,10,27,32,161,0.0105907117484542,0.198757763975155
2015,29197,9,107,2,47,0,0,2,47,0.016090380006847,0.0425531914893617
2015,29199,26,103,3,153,0,0,3,153,0.0492594977462975,0.0196078431372549
2015,29201,76,693,45,354,11,23,56,377,0.0142857142857143,0.148541114058355
2015,29203,5,93,2,122,0,0,2,122,0.0210598998791645,0.0163934426229508
2015,29205,8,121,4,52,4,7,8,59,0.013804398689752,0.135593220338983
2015,29207,60,679,18,296,0,26,18,322,0.0155001444112833,0.0559006211180124
2015,29209,201,1061,88,551,0,30,88,581,0.0243544600938967,0.151462994836489
2015,29211,6,108,14,120,0,0,14,120,0.026857654431513,0.116666666666667
2015,29213,180,1209,231,2079,33,77,264,2156,0.0586235962694075,0.122448979591837
2015,29215,72,782,83,430,0,58,83,488,0.0275986879312295,0.170081967213115
2015,29217,71,369,49,360,4,32,53,392,0.0281771132834963,0.135204081632653
2015,29219,63,855,21,189,4,55,25,244,0.0107488986784141,0.102459016393443
2015,29221,51,754,55,108,0,2,55,110,0.0063871791894089,0.5
2015,29223,0,231,33,119,7,7,40,126,0.0130909090909091,0.317460317460317
2015,29225,195,1481,64,447,0,1,64,448,0.0187895818479218,0.142857142857143
2015,29227,0,11,8,23,0,0,8,23,0.0155300472653612,0.347826086956522
2015,29229,102,507,9,255,0,7,9,262,0.0210577077640251,0.0343511450381679
2015,29510,3932,10556,3602,6224,670,1166,4272,7390,0.0338822968437655,0.57807848443843
2015,30001,23,148,32,210,0,9,32,219,0.0352713802544693,0.146118721461187
2015,30003,11,81,36,88,7,20,43,108,0.0144694533762058,0.398148148148148
2015,30005,25,141,24,63,0,18,24,81,0.0201142289545567,0.296296296296296
2015,30007,102,224,11,141,0,7,11,148,0.0360448124695567,0.0743243243243243
2015,30009,20,134,103,227,9,9,112,236,0.0303967027305513,0.474576271186441
2015,30011,0,15,3,6,3,3,6,9,0.00989010989010989,0.666666666666667
2015,30013,211,1166,656,1607,86,246,742,1853,0.0334960231381056,0.400431732325958
2015,30015,16,77,28,83,4,7,32,90,0.0232858990944373,0.355555555555556
2015,30017,45,225,110,283,0,0,110,283,0.0341911320526761,0.3886925795053
2015,30019,4,15,30,34,0,0,30,34,0.025621703089676,0.882352941176471
2015,30021,39,220,30,278,0,0,30,278,0.0427429274292743,0.107913669064748
2015,30023,60,297,20,127,6,6,26,133,0.0197946122934961,0.195488721804511
2015,30025,4,54,20,48,0,0,20,48,0.02284626368396,0.416666666666667
2015,30027,84,397,7,70,0,2,7,72,0.00850360222038502,0.0972222222222222
2015,30029,158,603,837,2434,51,119,888,2553,0.0392081579998157,0.347826086956522
2015,30031,509,1516,1365,2377,119,159,1484,2536,0.0421823020625416,0.585173501577287
2015,30033,0,0,7,11,0,0,7,11,0.0145502645502645,0.636363636363636
2015,30035,53,279,53,102,0,6,53,108,0.0136037284292732,0.490740740740741
2015,30037,4,32,1,17,0,1,1,18,0.031304347826087,0.0555555555555556
2015,30039,31,140,24,58,0,0,24,58,0.0233400402414487,0.413793103448276
2015,30041,79,236,10,156,19,49,29,205,0.0198971173444628,0.141463414634146
2015,30043,125,529,77,223,0,0,77,223,0.0267482307784575,0.345291479820628
2015,30045,15,67,1,28,0,1,1,29,0.0190039318479685,0.0344827586206897
2015,30047,156,536,141,486,13,64,154,550,0.027915947619531,0.28
2015,30049,490,1129,611,1202,52,113,663,1315,0.0289877435852218,0.504182509505703
2015,30051,4,35,12,25,18,21,30,46,0.027495517035266,0.652173913043478
2015,30053,89,256,35,457,0,15,35,472,0.0324867506366577,0.0741525423728814
2015,30055,13,20,4,16,0,0,4,16,0.0122699386503067,0.25
2015,30057,44,124,36,146,0,86,36,232,0.0384870603848706,0.155172413793103
2015,30059,35,59,6,33,0,0,6,33,0.0234708392603129,0.181818181818182
2015,30061,0,21,29,160,0,0,29,160,0.051249199231262,0.18125
2015,30063,708,2095,861,2142,209,390,1070,2532,0.0345670248057994,0.42259083728278
2015,30065,0,160,12,31,0,0,12,31,0.00905902980713033,0.387096774193548
2015,30067,64,118,17,223,3,13,20,236,0.0200543847722638,0.0847457627118644
2015,30069,4,28,0,0,0,0,0,0,0,NA
2015,30071,4,56,9,42,0,31,9,73,0.0245791245791246,0.123287671232877
2015,30073,31,159,19,63,5,14,24,77,0.0182984790874525,0.311688311688312
2015,30075,2,32,12,20,0,0,12,20,0.0151745068285281,0.6
2015,30077,84,483,24,108,0,0,24,108,0.0201154777425964,0.222222222222222
2015,30079,16,16,0,0,0,0,0,0,0,NA
2015,30081,228,1025,190,925,31,128,221,1053,0.0354116222760291,0.209876543209877
2015,30083,27,202,146,603,0,0,146,603,0.0810266057511422,0.24212271973466
2015,30085,9,57,49,110,0,0,49,110,0.0175215036635871,0.445454545454545
2015,30087,28,194,3,43,0,0,3,43,0.00731416907637353,0.0697674418604651
2015,30089,3,69,54,130,0,0,54,130,0.0152349701160202,0.415384615384615
2015,30091,1,18,15,75,0,14,15,89,0.033648393194707,0.168539325842697
2015,30093,174,836,256,782,16,50,272,832,0.0356530682207748,0.326923076923077
2015,30095,45,194,43,168,5,5,48,173,0.0258093391018947,0.277456647398844
2015,30097,7,71,11,40,2,2,13,42,0.016361511492014,0.30952380952381
2015,30099,26,173,13,36,0,1,13,37,0.00879068662390116,0.351351351351351
2015,30101,2,292,137,194,4,4,141,198,0.0535714285714286,0.712121212121212
2015,30103,0,0,0,5,0,0,0,5,0.00851788756388416,0
2015,30105,50,115,7,71,0,0,7,71,0.0132265275707899,0.0985915492957746
2015,30107,4,35,1,5,0,0,1,5,0.00334224598930481,0.2
2015,30109,0,4,0,2,0,0,0,2,0.00278164116828929,0
2015,30111,433,2438,1008,3081,86,223,1094,3304,0.0316924375551548,0.331113801452785
2015,31001,143,689,61,232,1,51,62,283,0.0139264799960632,0.219081272084806
2015,31003,55,141,4,36,0,14,4,50,0.0109385254867644,0.08
2015,31005,5,11,0,0,0,0,0,0,0,NA
2015,31007,6,27,7,39,0,0,7,39,0.062200956937799,0.179487179487179
2015,31009,3,25,3,6,0,0,3,6,0.0161725067385445,0.5
2015,31011,18,73,9,12,0,8,9,20,0.00536768652710682,0.45
2015,31013,17,136,5,62,0,0,5,62,0.00824248869981388,0.0806451612903226
2015,31015,11,24,2,7,0,2,2,9,0.00610997963340122,0.222222222222222
2015,31017,25,45,0,1,4,4,4,5,0.00216637781629116,0.8
2015,31019,316,1154,224,600,0,57,224,657,0.0226340992868708,0.340943683409437
2015,31021,24,126,19,58,0,0,19,58,0.0122233930453109,0.327586206896552
2015,31023,18,235,4,19,12,15,16,34,0.00590996002085868,0.470588235294118
2015,31025,235,695,83,271,0,42,83,313,0.0180914398011676,0.26517571884984
2015,31027,46,184,4,107,0,0,4,107,0.0181079708918599,0.0373831775700935
2015,31029,0,62,18,64,0,17,18,81,0.0292102416155788,0.222222222222222
2015,31031,19,58,52,160,0,11,52,171,0.0405021316911416,0.304093567251462
2015,31033,9,85,118,297,40,95,158,392,0.056176554886787,0.403061224489796
2015,31035,22,150,18,62,0,1,18,63,0.0143573381950775,0.285714285714286
2015,31037,16,154,23,116,5,55,28,171,0.0262874711760184,0.16374269005848
2015,31039,30,176,3,62,0,0,3,62,0.0101672679567071,0.0483870967741935
2015,31041,32,145,17,103,0,2,17,105,0.0139054429876838,0.161904761904762
2015,31043,7,138,46,382,0,30,46,412,0.0323594093622369,0.111650485436893
2015,31045,24,169,125,312,0,0,125,312,0.0565012676566461,0.400641025641026
2015,31047,81,546,40,299,4,25,44,324,0.0211875490452524,0.135802469135802
2015,31049,13,24,11,41,0,10,11,51,0.036849710982659,0.215686274509804
2015,31051,11,82,22,50,0,3,22,53,0.0133333333333333,0.415094339622642
2015,31053,113,747,72,311,17,43,89,354,0.0142026078234704,0.251412429378531
2015,31055,2377,6638,3801,8404,1084,1923,4885,10327,0.0297614930603587,0.473031858235693
2015,31057,8,26,0,31,2,2,2,33,0.0232394366197183,0.0606060606060606
2015,31059,34,147,17,47,4,9,21,56,0.0136186770428016,0.375
2015,31061,29,97,12,53,0,0,12,53,0.0231643356643357,0.226415094339623
2015,31063,16,53,11,36,0,4,11,40,0.0232288037166086,0.275
2015,31065,26,119,15,35,0,3,15,38,0.0109699769053118,0.394736842105263
2015,31067,161,517,76,224,9,12,85,236,0.0152750809061489,0.360169491525424
2015,31069,6,32,11,50,0,4,11,54,0.0371389270976616,0.203703703703704
2015,31071,0,33,0,0,0,0,0,0,0,NA
2015,31073,4,85,0,0,0,0,0,0,0,NA
2015,31075,4,22,0,2,0,0,0,2,0.00380952380952381,0
2015,31077,26,74,3,20,0,0,3,20,0.0116076610562972,0.15
2015,31079,188,959,171,894,55,144,226,1038,0.0265894769199242,0.217726396917148
2015,31081,19,126,59,65,4,6,63,71,0.0114923923599871,0.887323943661972
2015,31083,1,77,10,24,0,0,10,24,0.00953137410643368,0.416666666666667
2015,31085,4,24,0,14,0,0,0,14,0.0173697270471464,0
2015,31087,7,48,2,23,0,2,2,25,0.0119789171058936,0.08
2015,31089,78,218,30,144,0,16,30,160,0.0220963955254799,0.1875
2015,31091,0,12,7,7,0,4,7,11,0.0201465201465201,0.636363636363636
2015,31093,28,169,18,46,0,4,18,50,0.011258725512272,0.36
2015,31095,61,203,2,63,0,0,2,63,0.011846558856713,0.0317460317460317
2015,31097,28,291,1,27,1,6,2,33,0.00878360393931328,0.0606060606060606
2015,31099,20,322,45,63,0,0,45,63,0.0138644366197183,0.714285714285714
2015,31101,63,165,72,328,7,8,79,336,0.0562248995983936,0.235119047619048
2015,31103,6,9,0,9,0,0,0,9,0.0166358595194085,0
2015,31105,6,36,6,133,0,0,6,133,0.0508798775822494,0.0451127819548872
2015,31107,48,114,24,104,0,3,24,107,0.0179469976517947,0.224299065420561
2015,31109,747,3615,1619,3826,532,1225,2151,5051,0.0274345367740113,0.425856266085924
2015,31111,232,674,56,392,18,42,74,434,0.017782512496927,0.170506912442396
2015,31113,3,28,6,26,0,0,6,26,0.0454545454545455,0.230769230769231
2015,31115,2,11,0,12,0,0,0,12,0.0286396181384248,0
2015,31117,1,6,2,2,0,0,2,2,0.00611620795107034,1
2015,31119,135,725,112,439,5,43,117,482,0.021060910600367,0.242738589211618
2015,31121,44,401,6,53,0,23,6,76,0.0139963167587477,0.0789473684210526
2015,31123,5,103,31,111,0,0,31,111,0.0330750893921335,0.279279279279279
2015,31125,14,55,5,32,0,3,5,35,0.0135975135975136,0.142857142857143
2015,31127,88,186,11,119,0,4,11,123,0.0262708244340026,0.0894308943089431
2015,31129,50,111,17,55,11,11,28,66,0.0203703703703704,0.424242424242424
2015,31131,102,378,26,159,0,25,26,184,0.0169694733929724,0.141304347826087
2015,31133,9,20,2,20,0,0,2,20,0.010136847440446,0.1
2015,31135,0,55,26,82,3,3,29,85,0.0413223140495868,0.341176470588235
2015,31137,44,226,71,176,11,31,82,207,0.0326601451562007,0.396135265700483
2015,31139,20,169,37,94,0,0,37,94,0.0192622950819672,0.393617021276596
2015,31141,62,395,54,200,0,51,54,251,0.0118128765060241,0.215139442231076
2015,31143,11,82,18,27,0,2,18,29,0.00788900979325354,0.620689655172414
2015,31145,14,201,6,188,12,12,18,200,0.0270599377621431,0.09
2015,31147,4,17,0,80,0,0,0,80,0.0134386023853519,0
2015,31149,0,33,8,16,3,4,11,20,0.0189933523266857,0.55
2015,31151,42,331,0,63,0,44,0,107,0.0122467666246996,0
2015,31153,1147,4152,1515,3467,251,623,1766,4090,0.0383961847898536,0.431784841075795
2015,31155,134,744,85,209,10,26,95,235,0.016583162797262,0.404255319148936
2015,31157,95,344,204,859,7,12,211,871,0.0355626326963907,0.242250287026406
2015,31159,90,441,79,187,0,3,79,190,0.0176203282945377,0.415789473684211
2015,31161,26,121,18,90,0,0,18,90,0.0237467018469657,0.2
2015,31163,14,30,0,36,0,4,0,40,0.0176756517896597,0
2015,31165,1,6,0,8,0,0,0,8,0.00889877641824249,0
2015,31167,50,187,2,39,0,0,2,39,0.00970632155301145,0.0512820512820513
2015,31169,59,108,9,52,0,0,9,52,0.0137529754033325,0.173076923076923
2015,31171,14,28,4,4,0,2,4,6,0.0125,0.666666666666667
2015,31173,18,83,4,58,0,1,4,59,0.0155426765015806,0.0677966101694915
2015,31175,28,99,0,47,0,0,0,47,0.0157190635451505,0
2015,31177,118,394,55,240,0,0,55,240,0.0176043424044598,0.229166666666667
2015,31179,49,218,40,85,0,0,40,85,0.016368187945311,0.470588235294118
2015,31181,16,89,14,49,0,3,14,52,0.0199692780337942,0.269230769230769
2015,31183,3,21,0,3,0,0,0,3,0.00474683544303797,0
2015,31185,74,468,8,103,2,8,10,111,0.011809766996489,0.0900900900900901
2015,32001,63,394,219,726,18,60,237,786,0.0483573274270949,0.301526717557252
2015,32003,557,2957,17094,59288,3024,8498,20118,67786,0.0497816279604338,0.29678694715723
2015,32005,190,713,351,1586,16,119,367,1705,0.0481339280673028,0.21524926686217
2015,32007,159,645,252,1375,55,90,307,1465,0.0456215744892875,0.209556313993174
2015,32009,10,10,0,53,0,0,0,53,0.062870699881376,0
2015,32011,44,44,40,62,0,0,40,62,0.0499597099113618,0.645161290322581
2015,32013,61,491,64,430,22,68,86,498,0.0462481426448737,0.172690763052209
2015,32015,0,104,3,72,0,0,3,72,0.018887722980063,0.0416666666666667
2015,32017,96,359,88,155,0,5,88,160,0.0458190148911798,0.55
2015,32019,170,1432,256,1699,37,92,293,1791,0.0496176861702128,0.163595756560581
2015,32021,8,76,16,154,0,0,16,154,0.0451083772700644,0.103896103896104
2015,32023,73,1008,352,1709,26,78,378,1787,0.0558489858424227,0.21152770005596
2015,32027,26,571,4,113,0,5,4,118,0.0235387991222821,0.0338983050847458
2015,32029,104,220,8,138,0,0,8,138,0.0417928528164749,0.0579710144927536
2015,32031,607,3201,3998,11890,620,1847,4618,13737,0.0468425521467372,0.33617238116037
2015,32033,18,357,54,168,0,4,54,172,0.0246559633027523,0.313953488372093
2015,32510,376,2485,386,1906,24,87,410,1993,0.0516736238948378,0.205720020070246
2015,33001,301,1060,370,929,14,52,384,981,0.0222757101659892,0.391437308868502
2015,33003,286,685,531,1253,8,24,539,1277,0.0351606597097938,0.422083007047768
2015,33005,189,580,733,1632,95,170,828,1802,0.0344649517069905,0.459489456159822
2015,33007,67,479,112,449,4,11,116,460,0.0191109264644786,0.252173913043478
2015,33009,296,1027,1941,3019,414,505,2355,3524,0.0573474369406021,0.668274687854711
2015,33011,1092,3486,3774,7930,707,1432,4481,9362,0.033566744470379,0.478637043366802
2015,33013,933,3423,756,1919,112,185,868,2104,0.0203982704128129,0.41254752851711
2015,33015,1022,2883,3469,6616,380,557,3849,7173,0.0336822235057123,0.53659556670849
2015,33017,690,2304,696,2223,255,357,951,2580,0.03201985727583,0.368604651162791
2015,33019,202,741,333,696,10,37,343,733,0.0233491542700602,0.46793997271487
2015,34001,938,3182,989,2847,379,1142,1368,3989,0.0212844291248253,0.342943093507145
2015,34003,5036,9651,6735,11030,3134,4634,9869,15664,0.0240791241495291,0.630043411644535
2015,34005,2207,6503,1941,5320,842,1788,2783,7108,0.0228080026953745,0.39153066966798
2015,34007,1919,7476,2866,5972,505,1572,3371,7544,0.0217836362848851,0.446845174973489
2015,34009,343,1218,731,1504,75,226,806,1730,0.0244834418341353,0.465895953757225
2015,34011,458,4310,241,1101,80,477,321,1578,0.0149373822663549,0.203422053231939
2015,34013,3862,9514,3542,7521,1183,3161,4725,10682,0.0203617925697185,0.442332896461337
2015,34015,1057,4231,910,1918,169,541,1079,2459,0.0125434864669095,0.438796258641724
2015,34017,4752,8342,9173,12737,4560,7343,13733,20080,0.0430626832254979,0.683914342629482
2015,34019,1086,2414,722,1018,151,171,873,1189,0.0134265323637021,0.734230445752733
2015,34021,2459,6836,2434,4550,1534,2302,3968,6852,0.0277114963075604,0.579100992410975
2015,34023,5885,11210,4530,7297,3619,5794,8149,13091,0.0232384752890386,0.622488732717134
2015,34025,3961,8044,2497,5411,617,1528,3114,6939,0.0159541447667922,0.448767833981842
2015,34027,4097,7498,2966,4567,961,1761,3927,6328,0.0182969495446003,0.620575221238938
2015,34029,2894,8738,1509,4500,271,1026,1780,5526,0.0137299771167048,0.322113644589215
2015,34031,2216,5147,1109,2717,403,1470,1512,4187,0.0126260494065425,0.361117745402436
2015,34033,179,1084,142,651,26,146,168,797,0.0177099304490812,0.210790464240903
2015,34035,3486,5786,2231,2864,1133,1795,3364,4659,0.0204587969753124,0.72204335694355
2015,34037,672,2240,499,1236,137,303,636,1539,0.0151392933029039,0.413255360623782
2015,34039,3726,8994,1860,4435,644,2129,2504,6564,0.0177799447424021,0.381474710542352
2015,34041,482,2066,415,1434,71,331,486,1765,0.0236088817549492,0.275354107648725
2015,35001,2311,8362,5756,11569,1104,2569,6860,14138,0.0313201979610192,0.485217145282218
2015,35003,3,48,13,34,1,1,14,35,0.0124025513819986,0.4
2015,35005,244,811,219,1178,76,199,295,1377,0.0335215930668484,0.214233841684822
2015,35006,167,688,33,251,0,92,33,343,0.0188928669787937,0.0962099125364431
2015,35007,138,393,51,281,10,10,61,291,0.0307156428119063,0.209621993127148
2015,35009,84,505,560,1628,53,215,613,1843,0.0605951011014302,0.332609875203473
2015,35011,0,27,54,66,0,0,54,66,0.0476534296028881,0.818181818181818
2015,35013,291,1977,1158,3033,249,596,1407,3629,0.0284897824602171,0.387710112978782
2015,35015,89,549,312,1057,23,94,335,1151,0.0318439618204454,0.291051259774109
2015,35017,72,227,117,534,25,25,142,559,0.0272456986888921,0.254025044722719
2015,35019,4,277,10,29,0,17,10,46,0.0139817629179331,0.217391304347826
2015,35021,0,4,0,11,3,4,3,15,0.0351288056206089,0.2
2015,35023,12,53,37,121,2,13,39,134,0.0435630689206762,0.291044776119403
2015,35025,127,652,278,1147,19,101,297,1248,0.0305059887558054,0.237980769230769
2015,35027,226,537,250,643,16,31,266,674,0.0448615548455804,0.394658753709199
2015,35028,173,336,398,510,66,80,464,590,0.0464091874459215,0.786440677966102
2015,35029,97,328,37,500,20,105,57,605,0.0378953961791419,0.0942148760330579
2015,35031,54,366,229,619,20,92,249,711,0.0165291177496222,0.350210970464135
2015,35033,0,109,4,4,0,0,4,4,0.00126262626262626,1
2015,35035,188,864,541,2123,87,991,628,3114,0.0739632321504917,0.201669877970456
2015,35037,34,125,34,93,0,4,34,97,0.0158522634417388,0.350515463917526
2015,35039,133,428,34,262,3,23,37,285,0.0106307583274274,0.129824561403509
2015,35041,73,391,21,259,6,80,27,339,0.0303328561202577,0.079646017699115
2015,35043,694,2616,887,2088,78,167,965,2255,0.0247291310260122,0.427937915742794
2015,35045,91,740,519,1811,45,173,564,1984,0.025160103988333,0.284274193548387
2015,35047,6,226,127,266,0,88,127,354,0.0181185382331866,0.358757062146893
2015,35049,938,2444,2079,3587,162,553,2241,4140,0.0387803849936771,0.541304347826087
2015,35051,10,136,75,194,0,11,75,205,0.0227398779811425,0.365853658536585
2015,35053,17,134,25,234,0,42,25,276,0.0244745943069965,0.0905797101449275
2015,35055,82,305,399,682,23,65,422,747,0.0306675424911733,0.564926372155288
2015,35057,9,394,35,261,0,172,35,433,0.0395469905927482,0.0808314087759815
2015,35059,10,318,29,109,0,0,29,109,0.0349807445442875,0.26605504587156
2015,35061,92,1846,128,885,62,137,190,1022,0.020356538193407,0.185909980430528
2015,36001,2570,6310,1187,2539,582,1013,1769,3552,0.0174097165039407,0.498029279279279
2015,36003,113,608,147,353,63,84,210,437,0.0142959958126145,0.480549199084668
2015,36005,5192,22826,1597,6368,2000,8851,3597,15219,0.0170010310763968,0.236349300216834
2015,36007,543,2340,891,1804,215,434,1106,2238,0.0170489605314278,0.494191242180518
2015,36009,141,877,193,534,17,58,210,592,0.0110844817255842,0.35472972972973
2015,36011,373,2103,248,457,29,162,277,619,0.011134495350134,0.447495961227787
2015,36013,243,1595,197,1074,72,312,269,1386,0.0153452685421995,0.194083694083694
2015,36015,323,1960,351,847,28,93,379,940,0.0154775822040736,0.403191489361702
2015,36017,155,741,89,324,7,24,96,348,0.00996620654103901,0.275862068965517
2015,36019,148,2333,137,499,28,245,165,744,0.0134909697541162,0.221774193548387
2015,36021,268,939,197,457,14,101,211,558,0.0122392577482398,0.378136200716846
2015,36023,188,732,58,186,13,20,71,206,0.00676252380014444,0.344660194174757
2015,36025,298,1219,63,327,34,47,97,374,0.0112471055243136,0.259358288770053
2015,36027,1614,6358,952,2079,491,933,1443,3012,0.0149019646647305,0.479083665338645
2015,36029,2323,7363,2878,5747,1341,2816,4219,8563,0.0134989634977812,0.492701156136868
2015,36031,218,1237,226,731,57,86,283,817,0.028222045666517,0.346389228886169
2015,36033,212,2725,89,375,21,89,110,464,0.0129797471187199,0.237068965517241
2015,36035,234,1397,130,343,51,76,181,419,0.0108045384218669,0.431980906921241
2015,36037,318,1253,47,258,9,62,56,320,0.00771158665895508,0.175
2015,36039,73,957,95,336,0,6,95,342,0.00971066753740879,0.277777777777778
2015,36041,3,46,7,59,0,0,7,59,0.0166384658770446,0.11864406779661
2015,36043,210,933,106,259,4,33,110,292,0.00655649362313634,0.376712328767123
2015,36045,404,1979,1355,3723,500,1937,1855,5660,0.0765920593250156,0.32773851590106
2015,36047,16720,29505,12612,19102,6733,14882,19345,33984,0.0195800182871287,0.569238465160075
2015,36049,111,316,68,219,14,58,82,277,0.014972972972973,0.296028880866426
2015,36051,239,1628,157,433,0,40,157,473,0.0111173788370235,0.331923890063425
2015,36053,249,1280,180,462,119,198,299,660,0.0138620515836344,0.453030303030303
2015,36055,2801,7293,2764,5699,1483,3185,4247,8884,0.0176111899645556,0.478050427735254
2015,36057,163,1096,44,280,12,169,56,449,0.0130999270605398,0.124721603563474
2015,36059,8786,17295,2167,4491,1647,3553,3814,8044,0.00863289278106001,0.474142217802089
2015,36061,15891,27586,30970,35820,15548,20460,46518,56280,0.0457919865650803,0.826545842217484
2015,36063,1097,3373,318,1059,71,263,389,1322,0.00880101191665002,0.294251134644478
2015,36065,776,4296,478,1569,166,441,644,2010,0.0125552807135897,0.320398009950249
2015,36067,1819,5405,1793,3839,866,1907,2659,5746,0.0183154619984445,0.462756700313261
2015,36069,1305,3076,415,786,21,104,436,890,0.0117924528301887,0.489887640449438
2015,36071,1596,4420,1352,3405,179,516,1531,3921,0.0165246415657319,0.390461616934455
2015,36073,133,1660,28,169,0,38,28,207,0.00699702541914548,0.135265700483092
2015,36075,215,1773,151,556,21,85,172,641,0.00801290064503225,0.268330733229329
2015,36077,280,1028,227,416,87,102,314,518,0.0129170614931924,0.606177606177606
2015,36079,1181,2557,213,578,103,200,316,778,0.0111898974499115,0.406169665809769
2015,36081,13869,30404,6577,11867,5665,15493,12242,27360,0.0168975149659734,0.447441520467836
2015,36083,1623,5112,495,1296,185,336,680,1632,0.0149305619087699,0.416666666666667
2015,36085,1115,3959,998,1754,373,1062,1371,2816,0.00873755379521979,0.486860795454545
2015,36087,1380,2772,952,1900,315,896,1267,2796,0.0138483712314451,0.453147353361946
2015,36089,347,2081,358,857,109,276,467,1133,0.0157151575676875,0.412180052956752
2015,36091,1943,4865,1380,2375,622,963,2002,3338,0.0212798510792926,0.599760335530258
2015,36093,1003,3019,401,787,340,445,741,1232,0.0116534241392357,0.601461038961039
2015,36095,164,580,25,154,10,32,35,186,0.00839767032371665,0.188172043010753
2015,36097,99,456,26,104,0,46,26,150,0.0112926296770308,0.173333333333333
2015,36099,184,1738,84,282,13,47,97,329,0.0132017174270695,0.29483282674772
2015,36101,431,1760,233,666,75,123,308,789,0.0115496091577129,0.390367553865653
2015,36103,4729,11687,2990,5553,1440,3129,4430,8682,0.00848705240622892,0.510251094217922
2015,36105,442,1961,92,413,97,230,189,643,0.0121051244399262,0.29393468118196
2015,36107,198,600,116,584,20,25,136,609,0.0173267326732673,0.223316912972085
2015,36109,781,1706,1650,2085,969,1087,2619,3172,0.0534699863459367,0.825662042875158
2015,36111,979,4191,373,1157,38,290,411,1447,0.0112380493790725,0.28403593642018
2015,36113,367,1709,187,459,0,57,187,516,0.0109222530321952,0.362403100775194
2015,36115,266,2577,195,743,0,42,195,785,0.0175454281307973,0.248407643312102
2015,36117,383,1523,150,795,11,138,161,933,0.0145603795374387,0.172561629153269
2015,36119,7719,14256,4363,6913,2003,4273,6366,11186,0.0169675604998347,0.569104237439657
2015,36121,159,1990,88,332,7,42,95,374,0.0126082999022351,0.254010695187166
2015,36123,193,554,61,347,7,37,68,384,0.0232262747232807,0.177083333333333
2015,37001,718,2600,459,1545,253,576,712,2121,0.0204711945873428,0.335690711928336
2015,37003,98,924,0,229,0,34,0,263,0.0100535168195719,0
2015,37005,29,60,9,163,0,9,9,172,0.021443710260566,0.0523255813953488
2015,37007,98,819,8,210,0,11,8,221,0.012161567246313,0.0361990950226244
2015,37009,103,524,42,137,3,43,45,180,0.00890251743409664,0.25
2015,37011,116,979,47,210,2,24,49,234,0.0179159329300972,0.209401709401709
2015,37013,103,473,92,354,10,106,102,460,0.0136705399863295,0.221739130434783
2015,37015,78,557,0,170,4,6,4,176,0.0119394885014585,0.0227272727272727
2015,37017,47,467,12,217,4,114,16,331,0.0137893684385936,0.0483383685800604
2015,37019,895,2736,1639,3721,55,168,1694,3889,0.0438548021515804,0.435587554641296
2015,37021,2017,4956,2910,6399,206,362,3116,6761,0.0380419186946125,0.460878568259133
2015,37023,370,1999,278,879,6,81,284,960,0.0152734909472746,0.295833333333333
2015,37025,1454,4458,1014,2651,140,306,1154,2957,0.0239985066874432,0.390260399053094
2015,37027,121,1636,84,587,0,33,84,620,0.0107601527247484,0.135483870967742
2015,37029,86,285,34,222,0,0,34,222,0.0324182242990654,0.153153153153153
2015,37031,479,1555,501,1180,86,188,587,1368,0.0269668237103038,0.429093567251462
2015,37033,7,704,21,269,0,26,21,295,0.0174483941562666,0.0711864406779661
2015,37035,708,3359,317,1408,7,92,324,1500,0.0141835924202882,0.216
2015,37037,660,1423,625,1005,87,100,712,1105,0.0224024328433857,0.644343891402715
2015,37039,129,211,192,776,0,17,192,793,0.0387301587301587,0.242118537200504
2015,37041,40,152,17,251,0,0,17,251,0.0238638524434303,0.0677290836653386
2015,37043,58,168,72,261,0,0,72,261,0.0328798185941043,0.275862068965517
2015,37045,137,1160,159,818,57,116,216,934,0.0141566630289802,0.231263383297645
2015,37047,231,1640,91,556,11,121,102,677,0.0172141985353946,0.150664697193501
2015,37049,394,2267,732,2854,171,637,903,3491,0.0519633235092733,0.258665138928674
2015,37051,978,3656,2850,9182,799,2974,3649,12156,0.0610173575207557,0.300180980585719
2015,37053,120,250,126,413,23,65,149,478,0.0277213941889462,0.311715481171548
2015,37055,230,390,426,988,3,12,429,1000,0.038856077090457,0.429
2015,37057,810,3190,416,1246,10,138,426,1384,0.0121983465247052,0.307803468208093
2015,37059,261,885,25,339,27,64,52,403,0.0137886201115407,0.129032258064516
2015,37061,78,1630,72,348,0,127,72,475,0.012025012025012,0.151578947368421
2015,37063,4280,8521,4362,6714,1386,2278,5748,8992,0.0463882956222078,0.63923487544484
2015,37065,136,1538,5,423,0,33,5,456,0.0122452267783775,0.0109649122807018
2015,37067,1738,6648,2336,4457,287,625,2623,5082,0.0212580836770378,0.516135379771743
2015,37069,473,1893,158,496,7,139,165,635,0.0149905571293673,0.259842519685039
2015,37071,924,3416,435,2163,24,285,459,2448,0.0171606426828926,0.1875
2015,37073,0,56,51,154,0,23,51,177,0.0216222819447838,0.288135593220339
2015,37075,28,67,18,167,0,2,18,169,0.0280917553191489,0.106508875739645
2015,37077,167,1517,180,683,71,186,251,869,0.0217244568885778,0.288837744533947
2015,37079,50,1358,0,258,2,62,2,320,0.021700800217008,0.00625
2015,37081,2039,6627,2530,6578,579,1449,3109,8027,0.0240323585063831,0.387317802416843
2015,37083,136,1152,76,378,23,44,99,422,0.0114363143631436,0.234597156398104
2015,37085,643,3685,1136,3051,105,369,1241,3420,0.0438118907008621,0.362865497076023
2015,37087,492,1350,354,1395,16,30,370,1425,0.0324475715554341,0.259649122807018
2015,37089,565,2258,1350,2676,27,135,1377,2811,0.0348495555472905,0.489861259338314
2015,37091,85,495,129,727,5,12,134,739,0.0439044676806084,0.181326116373478
2015,37093,434,2608,401,1418,110,546,511,1964,0.0620164829959898,0.260183299389002
2015,37095,27,355,0,65,0,2,0,67,0.016144578313253,0
2015,37097,805,2526,925,2560,202,362,1127,2922,0.0262897450200637,0.385694729637235
2015,37099,239,935,204,479,0,21,204,500,0.0192130341223486,0.408
2015,37101,698,3763,377,2113,4,49,381,2162,0.0185828233514406,0.17622571692877
2015,37103,81,408,2,59,0,0,2,59,0.00790460878885316,0.0338983050847458
2015,37105,399,1597,435,758,87,114,522,872,0.0222983685367974,0.598623853211009
2015,37107,78,899,26,307,31,172,57,479,0.0118941199841081,0.118997912317328
2015,37109,304,1820,423,1435,0,36,423,1471,0.0265164488508337,0.287559483344663
2015,37111,118,856,18,238,15,99,33,337,0.0105576441102757,0.0979228486646884
2015,37113,71,190,333,1042,0,13,333,1055,0.0416699581325539,0.31563981042654
2015,37115,139,506,44,165,0,25,44,190,0.0127817019845274,0.231578947368421
2015,37117,31,312,22,142,0,18,22,160,0.00948654096999881,0.1375
2015,37119,4937,13144,13901,26223,2514,4317,16415,30540,0.0468561574268697,0.537491814014407
2015,37121,84,296,22,66,0,41,22,107,0.00954249531793454,0.205607476635514
2015,37123,53,822,32,112,12,39,44,151,0.00798012895042807,0.291390728476821
2015,37125,400,1294,1033,1648,223,310,1256,1958,0.029618648554616,0.6414708886619
2015,37127,329,2511,124,662,0,82,124,744,0.0115263060048336,0.166666666666667
2015,37129,1876,5233,1343,3459,247,711,1590,4170,0.0290167698837938,0.381294964028777
2015,37131,90,811,62,329,0,3,62,332,0.0218651211801897,0.186746987951807
2015,37133,506,2227,1792,6320,160,1233,1952,7553,0.077258267442693,0.258440354825897
2015,37135,1977,3809,2217,3168,925,1166,3142,4334,0.0513756682748729,0.724965389940009
2015,37137,99,620,25,100,18,38,43,138,0.0139619587211655,0.311594202898551
2015,37139,85,864,169,677,0,33,169,710,0.0266126916301211,0.238028169014084
2015,37141,420,2593,275,965,78,127,353,1092,0.0283319928391666,0.323260073260073
2015,37143,9,234,61,274,0,4,61,278,0.0279649934614224,0.219424460431655
2015,37145,33,476,56,266,27,79,83,345,0.0125981376666058,0.240579710144928
2015,37147,886,2898,968,2074,88,320,1056,2394,0.0233599718977782,0.441102756892231
2015,37149,59,222,207,454,9,32,216,486,0.0314848406322882,0.444444444444444
2015,37151,401,2402,89,673,0,69,89,742,0.00765611457344505,0.119946091644205
2015,37153,94,845,157,398,0,27,157,425,0.0138459032415703,0.369411764705882
2015,37155,210,1940,182,689,20,113,202,802,0.00946312684365782,0.251870324189526
2015,37157,172,1539,101,684,45,187,146,871,0.0133204869394996,0.167623421354765
2015,37159,483,3191,331,1278,0,104,331,1382,0.0146997819496889,0.239507959479016
2015,37161,284,930,243,629,0,28,243,657,0.0138827258320127,0.36986301369863
2015,37163,303,1816,73,477,4,122,77,599,0.0140775558166863,0.128547579298831
2015,37165,93,1051,112,440,43,93,155,533,0.0224543960904916,0.290806754221388
2015,37167,294,1467,98,354,0,5,98,359,0.00861758563575698,0.272980501392758
2015,37169,91,688,14,118,0,49,14,167,0.00497764530551416,0.0838323353293413
2015,37171,100,776,66,401,14,46,80,447,0.00878278809313292,0.178970917225951
2015,37173,8,180,46,163,11,35,57,198,0.0201239963410916,0.287878787878788
2015,37175,176,704,177,554,53,73,230,627,0.0255438768027377,0.366826156299841
2015,37177,0,361,0,29,0,0,0,29,0.00927406459865686,0
2015,37179,1224,3829,1624,3715,96,334,1720,4049,0.0302758398947187,0.424796245986663
2015,37181,113,702,56,207,0,20,56,227,0.00765392137028795,0.246696035242291
2015,37183,8152,16427,11418,20192,2501,4740,13919,24932,0.0391335740072202,0.558278517567784
2015,37185,66,825,77,272,16,23,93,295,0.0200094960320152,0.315254237288136
2015,37187,19,70,28,108,0,3,28,111,0.0127527573529412,0.252252252252252
2015,37189,404,1220,391,671,89,187,480,858,0.0297699594046008,0.559440559440559
2015,37191,748,3219,338,1593,69,341,407,1934,0.0237726479337218,0.210444674250259
2015,37193,119,944,156,254,0,46,156,300,0.00614943117761607,0.52
2015,37195,441,1584,179,770,27,153,206,923,0.0168433730542528,0.223185265438787
2015,37197,85,446,31,284,0,23,31,307,0.0115910292229857,0.100977198697068
2015,37199,22,348,23,167,0,10,23,177,0.0136342628254506,0.129943502824859
2015,38001,6,39,15,37,3,3,18,40,0.0231749710312862,0.45
2015,38003,47,217,23,207,0,9,23,216,0.0277171820864879,0.106481481481481
2015,38005,47,123,5,63,0,1,5,64,0.0165932071558206,0.078125
2015,38007,23,53,12,46,0,0,12,46,0.0641562064156206,0.260869565217391
2015,38009,1,74,24,83,7,11,31,94,0.0201284796573876,0.329787234042553
2015,38011,3,22,9,57,0,0,9,57,0.0255147717099373,0.157894736842105
2015,38013,14,59,11,83,0,1,11,84,0.0580912863070539,0.130952380952381
2015,38015,743,2136,621,1678,39,103,660,1781,0.03004081908039,0.370578326782706
2015,38017,806,1818,1874,5130,196,458,2070,5588,0.0555931394006924,0.370436649964209
2015,38019,3,35,5,14,0,3,5,17,0.00589663544918488,0.294117647058824
2015,38021,13,70,62,136,0,2,62,138,0.0390492359932088,0.449275362318841
2015,38023,9,32,0,43,0,13,0,56,0.0305010893246187,0
2015,38025,16,125,8,132,0,14,8,146,0.0501029512697323,0.0547945205479452
2015,38027,4,41,9,51,0,7,9,58,0.0338587273788675,0.155172413793103
2015,38029,16,38,4,6,0,13,4,19,0.00759089093088294,0.210526315789474
2015,38031,24,94,9,35,0,5,9,40,0.0164880461665293,0.225
2015,38033,2,2,23,65,0,1,23,66,0.054726368159204,0.348484848484849
2015,38035,177,703,747,2056,143,275,890,2331,0.0587212817412334,0.381810381810382
2015,38037,3,49,7,49,7,7,14,56,0.0302539168017288,0.25
2015,38039,13,69,6,29,2,10,8,39,0.022083805209513,0.205128205128205
2015,38041,22,109,2,92,2,2,4,94,0.0489328474752733,0.0425531914893617
2015,38043,10,40,8,27,1,9,9,36,0.0201117318435754,0.25
2015,38045,15,57,31,70,0,4,31,74,0.0247243568326094,0.418918918918919
2015,38047,6,31,0,13,0,6,0,19,0.0131487889273356,0
2015,38049,29,150,22,74,0,10,22,84,0.0205983325159392,0.261904761904762
2015,38051,4,38,4,14,0,0,4,14,0.00641613198900092,0.285714285714286
2015,38053,43,208,30,213,0,2,30,215,0.0365025466893039,0.13953488372093
2015,38055,84,287,32,180,0,9,32,189,0.0274549680418361,0.169312169312169
2015,38057,104,301,44,149,6,14,50,163,0.0262988060664731,0.306748466257669
2015,38059,209,934,149,574,0,31,149,605,0.0301610249763199,0.246280991735537
2015,38061,60,260,22,155,0,8,22,163,0.027575706310269,0.134969325153374
2015,38063,18,96,1,47,0,0,1,47,0.0200170357751278,0.0212765957446809
2015,38065,0,50,0,0,0,0,0,0,0,NA
2015,38067,53,175,11,91,4,19,15,110,0.0210043918273821,0.136363636363636
2015,38069,0,98,0,50,0,13,0,63,0.0196998123827392,0
2015,38071,58,225,55,100,0,5,55,105,0.0133046122655854,0.523809523809524
2015,38073,11,165,4,55,0,10,4,65,0.0169094693028096,0.0615384615384615
2015,38075,19,72,2,12,0,0,2,12,0.00697674418604651,0.166666666666667
2015,38077,124,236,32,238,21,58,53,296,0.028295574036899,0.179054054054054
2015,38079,42,165,0,47,0,6,0,53,0.00647051642046148,0
2015,38081,4,51,14,30,0,20,14,50,0.0181422351233672,0.28
2015,38083,1,21,6,15,0,0,6,15,0.0142314990512334,0.4
2015,38085,12,45,19,66,0,10,19,76,0.0333187198597107,0.25
2015,38087,9,9,0,7,0,0,0,7,0.0134099616858238,0
2015,38089,109,444,284,1004,0,52,284,1056,0.0561821664183869,0.268939393939394
2015,38091,15,73,2,8,0,0,2,8,0.00544959128065395,0.25
2015,38093,127,510,91,376,0,5,91,381,0.0262288310615448,0.238845144356955
2015,38095,11,65,3,11,0,0,3,11,0.00667070952092177,0.272727272727273
2015,38097,64,150,19,79,3,9,22,88,0.0161024702653248,0.25
2015,38099,52,101,9,151,25,32,34,183,0.0236678737713399,0.185792349726776
2015,38101,259,997,749,2389,157,527,906,2916,0.0706635002180972,0.310699588477366
2015,38103,18,78,12,26,1,1,13,27,0.00859325270528326,0.481481481481481
2015,38105,51,352,411,1494,20,24,431,1518,0.0788325716659742,0.283926218708827
2015,39001,5,322,44,110,0,0,44,110,0.005754341912534,0.4
2015,39003,332,1936,209,975,9,79,218,1054,0.0151934498068385,0.206831119544592
2015,39005,200,1125,103,266,124,129,227,395,0.0112378730547099,0.574683544303797
2015,39007,167,1418,124,810,26,168,150,978,0.0141659062269152,0.153374233128834
2015,39009,237,947,350,617,110,207,460,824,0.0232959203867575,0.558252427184466
2015,39011,255,936,77,290,18,29,95,319,0.0103002906038101,0.297805642633229
2015,39013,198,1797,208,720,22,58,230,778,0.0153023091145116,0.295629820051414
2015,39015,43,875,118,539,0,1,118,540,0.0177971129127941,0.218518518518519
2015,39017,2172,7012,1382,3632,262,679,1644,4311,0.0181869573654857,0.381350034794711
2015,39019,106,533,59,248,0,15,59,263,0.0130378742811818,0.224334600760456
2015,39021,116,1093,100,358,0,43,100,401,0.0150192891119518,0.249376558603491
2015,39023,298,2075,318,1287,59,176,377,1463,0.0157125980023628,0.25768967874231
2015,39025,1103,4264,919,2085,99,164,1018,2249,0.0166717321848198,0.452645620275678
2015,39027,119,831,63,373,0,118,63,491,0.0177249918775495,0.128309572301426
2015,39029,146,1452,261,1537,12,206,273,1743,0.0230680660146376,0.156626506024096
2015,39031,59,653,75,151,0,24,75,175,0.00693783698065335,0.428571428571429
2015,39033,83,848,8,242,34,59,42,301,0.0100945737474009,0.13953488372093
2015,39035,5138,12835,5514,11085,1939,4175,7453,15260,0.0174818565594194,0.488401048492792
2015,39037,66,655,81,492,21,76,102,568,0.015970757767468,0.179577464788732
2015,39039,123,796,34,197,7,27,41,224,0.00865901271792493,0.183035714285714
2015,39041,2719,5407,1291,1986,269,381,1560,2367,0.0196766282887901,0.659062103929024
2015,39043,385,1753,173,687,5,87,178,774,0.0143474150555175,0.229974160206718
2015,39045,928,4517,509,1408,40,162,549,1570,0.0157861926116597,0.34968152866242
2015,39047,154,843,13,143,62,130,75,273,0.0138839444642221,0.274725274725275
2015,39049,6736,17721,9084,18032,2610,5279,11694,23311,0.0292423043101383,0.501651580798764
2015,39051,107,608,19,206,0,19,19,225,0.00788920056100982,0.0844444444444444
2015,39053,29,255,65,325,0,28,65,353,0.0170268184449161,0.18413597733711
2015,39055,588,1679,227,390,129,202,356,592,0.00930788339989309,0.601351351351351
2015,39057,1423,3396,1562,2889,334,620,1896,3509,0.0324672921408612,0.540324878882873
2015,39059,112,743,16,241,0,24,16,265,0.00970447138096459,0.060377358490566
2015,39061,3796,9352,4944,10471,1689,2493,6633,12964,0.0241475526481468,0.511647639617402
2015,39063,229,1099,284,835,44,79,328,914,0.0179521929566123,0.358862144420131
2015,39065,57,451,81,128,0,19,81,147,0.00760790808404927,0.551020408163265
2015,39067,27,200,10,194,0,15,10,209,0.0186291113289955,0.0478468899521531
2015,39069,96,486,68,194,0,0,68,194,0.0101885405178299,0.350515463917526
2015,39071,88,873,54,238,12,25,66,263,0.00899114560185977,0.250950570342205
2015,39073,136,780,0,71,0,5,0,76,0.00379639342624507,0
2015,39075,18,467,16,249,0,11,16,260,0.0105639525434747,0.0615384615384615
2015,39077,48,1371,102,460,2,18,104,478,0.0121446174953632,0.217573221757322
2015,39079,102,584,16,229,0,42,16,271,0.0122011615866012,0.0590405904059041
2015,39081,69,762,279,1278,0,33,279,1311,0.027328441590928,0.212814645308924
2015,39083,337,1394,87,400,10,53,97,453,0.0114761989207813,0.214128035320088
2015,39085,1172,3753,462,1281,93,369,555,1650,0.0101274835351669,0.336363636363636
2015,39087,77,342,94,1136,0,64,94,1200,0.0280183987485115,0.0783333333333333
2015,39089,1151,4132,379,1214,112,177,491,1391,0.0122913518719791,0.352983465132998
2015,39091,138,1008,41,226,21,58,62,284,0.00917431192660551,0.21830985915493
2015,39093,1507,6252,558,1636,143,630,701,2266,0.0109598846938874,0.309355692850838
2015,39095,1249,4851,1301,4196,325,662,1626,4858,0.0167767735964388,0.334705640181145
2015,39097,354,2606,39,211,6,27,45,238,0.00779790963598834,0.189075630252101
2015,39099,398,3535,661,2754,118,321,779,3075,0.0185909566331929,0.253333333333333
2015,39101,89,2347,68,494,0,61,68,555,0.0120231364138559,0.122522522522523
2015,39103,1141,3914,579,1102,137,283,716,1385,0.0115385897094108,0.516967509025271
2015,39105,106,432,25,75,0,1,25,76,0.00460020579868047,0.328947368421053
2015,39107,83,572,98,279,39,84,137,363,0.0133898930284028,0.377410468319559
2015,39109,646,2262,218,912,43,127,261,1039,0.0145379750377791,0.251203079884504
2015,39111,6,126,27,110,0,20,27,130,0.0124259223857771,0.207692307692308
2015,39113,2543,9451,2344,6243,660,1331,3004,7574,0.0208988088175645,0.396620015843676
2015,39115,7,232,13,67,7,7,20,74,0.00708269525267994,0.27027027027027
2015,39117,58,545,23,77,16,34,39,111,0.00468077928649743,0.351351351351351
2015,39119,282,1344,56,269,29,53,85,322,0.00555661012269409,0.263975155279503
2015,39121,35,1073,0,84,0,2,0,86,0.0076085994868619,0
2015,39123,356,963,82,325,2,7,84,332,0.0109617987915607,0.253012048192771
2015,39125,62,294,9,36,0,73,9,109,0.00828771289537713,0.0825688073394495
2015,39127,88,727,7,81,0,15,7,96,0.00398042955468944,0.0729166666666667
2015,39129,275,3393,64,306,2,38,66,344,0.00892694952640457,0.191860465116279
2015,39131,151,1004,24,198,0,24,24,222,0.0115818030050083,0.108108108108108
2015,39133,656,2689,569,1434,359,424,928,1858,0.0179878402974093,0.4994617868676
2015,39135,30,560,19,439,13,62,32,501,0.0174655743419906,0.063872255489022
2015,39137,117,583,39,95,25,39,64,134,0.0059265811587793,0.477611940298507
2015,39139,572,4069,124,855,69,144,193,999,0.0117330639857183,0.193193193193193
2015,39141,203,2318,28,386,0,4,28,390,0.00720354636128556,0.0717948717948718
2015,39143,231,817,77,408,0,5,77,413,0.0100089668710467,0.186440677966102
2015,39145,94,1107,75,538,0,75,75,613,0.0115080631535472,0.122349102773246
2015,39147,253,1112,40,259,33,51,73,310,0.00835985114071517,0.235483870967742
2015,39149,134,655,65,232,0,68,65,300,0.00929742461338209,0.216666666666667
2015,39151,953,4893,604,2274,230,521,834,2795,0.0108167727703709,0.298389982110912
2015,39153,2650,7362,2284,4197,480,1254,2764,5451,0.0145812212274333,0.507062924234085
2015,39155,377,2627,463,1746,40,188,503,1934,0.0132643823214727,0.260082730093071
2015,39157,262,1365,115,620,12,71,127,691,0.0107850788200406,0.183791606367583
2015,39159,778,2702,105,456,50,93,155,549,0.0155075984407661,0.282331511839709
2015,39161,139,688,45,359,0,5,45,364,0.0186379928315412,0.123626373626374
2015,39163,44,292,0,71,0,9,0,80,0.00887902330743618,0
2015,39165,2699,6930,1867,3251,450,802,2317,4053,0.0277519103831722,0.57167530224525
2015,39167,74,474,147,968,8,108,155,1076,0.0248343988736815,0.144052044609665
2015,39169,517,2288,122,416,60,70,182,486,0.00646809869839495,0.374485596707819
2015,39171,99,827,53,463,0,19,53,482,0.0186287392749478,0.109958506224066
2015,39173,913,3258,600,1033,264,490,864,1523,0.0192460793853386,0.567301378857518
2015,39175,118,622,0,166,0,0,0,166,0.0107457276022786,0
2015,40001,43,192,22,140,0,0,22,140,0.00980392156862745,0.157142857142857
2015,40003,37,353,10,157,1,1,11,158,0.0366844671465057,0.069620253164557
2015,40005,25,672,24,116,0,7,24,123,0.0128218492650891,0.195121951219512
2015,40007,20,97,10,121,5,7,15,128,0.0346039470127061,0.1171875
2015,40009,43,580,39,267,0,0,39,267,0.0175070487181168,0.146067415730337
2015,40011,39,443,14,270,0,41,14,311,0.0458228967143068,0.045016077170418
2015,40013,163,604,274,1080,11,59,285,1139,0.0392285173066988,0.250219490781387
2015,40015,117,941,10,254,0,97,10,351,0.0180268091007139,0.0284900284900285
2015,40017,1036,3969,457,2023,77,197,534,2220,0.0268505079825835,0.240540540540541
2015,40019,112,780,103,490,9,80,112,570,0.0177459526774595,0.196491228070175
2015,40021,142,568,235,489,29,45,264,534,0.0179568229201695,0.49438202247191
2015,40023,11,195,17,211,0,0,17,211,0.0206135209066041,0.0805687203791469
2015,40025,9,28,2,14,0,0,2,14,0.00845921450151057,0.142857142857143
2015,40027,1701,7704,1398,3450,400,702,1798,4152,0.0247100202941159,0.433044315992293
2015,40029,17,130,0,53,0,8,0,61,0.0156490507952796,0
2015,40031,291,2086,1740,5207,377,1209,2117,6416,0.0824424342105263,0.329956359102244
2015,40033,10,87,8,169,0,0,8,169,0.0403341288782816,0.0473372781065089
2015,40035,58,847,18,187,0,17,18,204,0.0198985563792431,0.0882352941176471
2015,40037,201,1582,70,281,9,73,79,354,0.0074016768770778,0.22316384180791
2015,40039,142,828,57,236,0,27,57,263,0.0154915473876421,0.216730038022814
2015,40041,155,842,152,987,34,37,186,1024,0.03468599688368,0.181640625
2015,40043,91,187,18,44,0,0,18,44,0.0135218192993239,0.409090909090909
2015,40045,16,81,9,75,0,0,9,75,0.0260960334029228,0.12
2015,40047,112,1185,603,1464,77,168,680,1632,0.0400697291855926,0.416666666666667
2015,40049,39,381,17,100,0,14,17,114,0.00620948853423389,0.149122807017544
2015,40051,429,1657,92,307,0,8,92,315,0.00879544312280114,0.292063492063492
2015,40053,16,119,16,48,0,0,16,48,0.0152332592827674,0.333333333333333
2015,40055,4,492,24,110,0,0,24,110,0.0244390135525439,0.218181818181818
2015,40057,7,84,9,35,0,0,9,35,0.0179487179487179,0.257142857142857
2015,40059,26,86,17,23,0,53,17,76,0.0298624754420432,0.223684210526316
2015,40061,15,96,3,58,0,7,3,65,0.00747384155455904,0.0461538461538462
2015,40063,74,719,35,140,3,17,38,157,0.0162424994827229,0.24203821656051
2015,40065,103,663,197,604,17,171,214,775,0.0468674407353653,0.276129032258065
2015,40067,23,225,5,66,0,0,5,66,0.0153096729297147,0.0757575757575758
2015,40069,36,293,65,288,7,14,72,302,0.0404229688127426,0.23841059602649
2015,40071,169,1004,134,771,24,67,158,838,0.0278887113951012,0.18854415274463
2015,40073,42,235,28,110,0,0,28,110,0.0109333068283471,0.254545454545455
2015,40075,62,305,20,178,0,2,20,180,0.0277777777777778,0.111111111111111
2015,40077,27,243,24,138,8,20,32,158,0.0219719093311083,0.20253164556962
2015,40079,28,808,94,602,9,25,103,627,0.0186952114019918,0.164274322169059
2015,40081,76,814,55,299,13,53,68,352,0.0151047030552695,0.193181818181818
2015,40083,638,2058,162,534,34,46,196,580,0.0195674909753382,0.337931034482759
2015,40085,15,99,22,189,0,21,22,210,0.0328125,0.104761904761905
2015,40087,409,1717,85,191,7,7,92,198,0.00823182139442065,0.464646464646465
2015,40089,30,418,41,338,3,26,44,364,0.0167548906789413,0.120879120879121
2015,40091,26,452,0,180,0,20,0,200,0.0136202669572324,0
2015,40093,27,224,0,90,0,11,0,101,0.0192784882611185,0
2015,40095,37,383,49,381,0,4,49,385,0.0351053159478435,0.127272727272727
2015,40097,74,740,60,488,2,19,62,507,0.0184820647419073,0.122287968441815
2015,40099,88,322,28,187,0,0,28,187,0.0200107009095773,0.149732620320856
2015,40101,233,2377,137,837,33,83,170,920,0.0197687910954489,0.184782608695652
2015,40103,74,267,57,146,0,10,57,156,0.0198903480810914,0.365384615384615
2015,40105,44,301,25,113,0,0,25,113,0.015633646928611,0.221238938053097
2015,40107,55,385,16,100,0,0,16,100,0.0120816721034191,0.16
2015,40109,3517,13705,4409,12932,1020,3090,5429,16022,0.0328328418584921,0.338846585944327
2015,40111,205,1046,139,388,0,12,139,400,0.0154035736290819,0.3475
2015,40113,220,1583,35,266,2,30,37,296,0.00892426435118186,0.125
2015,40115,78,445,78,640,1,13,79,653,0.0312634653133528,0.120980091883614
2015,40117,45,411,24,134,5,20,29,154,0.0136876722069149,0.188311688311688
2015,40119,569,2175,452,1256,275,361,727,1617,0.0380309515969707,0.449598021026592
2015,40121,193,1390,84,570,0,22,84,592,0.0188721349102617,0.141891891891892
2015,40123,110,780,63,428,10,56,73,484,0.0198759804525481,0.150826446280992
2015,40125,282,2289,32,586,0,55,32,641,0.0138081082245487,0.0499219968798752
2015,40127,22,259,20,202,6,14,26,216,0.0272383354350567,0.12037037037037
2015,40129,7,43,3,52,0,0,3,52,0.0202729044834308,0.0576923076923077
2015,40131,559,2380,450,1077,8,85,458,1162,0.0197046005663801,0.394148020654045
2015,40133,85,767,3,182,10,14,13,196,0.0117520086341288,0.0663265306122449
2015,40135,79,646,14,707,0,26,14,733,0.0261738975183003,0.0190995907230559
2015,40137,210,1152,71,558,16,53,87,611,0.0200295033601049,0.142389525368249
2015,40139,48,116,88,653,5,5,93,658,0.0504446488807114,0.141337386018237
2015,40141,10,196,33,114,0,0,33,114,0.0218098335565334,0.289473684210526
2015,40143,2243,10120,3388,10348,606,1573,3994,11921,0.0293895039951087,0.335039006794732
2015,40145,599,2877,198,740,0,61,198,801,0.015952679691701,0.247191011235955
2015,40147,213,1126,404,1010,65,155,469,1165,0.0330759184600534,0.402575107296137
2015,40149,17,288,21,100,10,19,31,119,0.0153508771929825,0.260504201680672
2015,40151,42,442,78,152,0,0,78,152,0.0265827212311997,0.513157894736842
2015,40153,144,651,23,202,0,68,23,270,0.0195666352634249,0.0851851851851852
2015,41001,159,575,95,366,0,11,95,377,0.0318869999154191,0.251989389920424
2015,41003,617,1401,1093,1565,369,476,1462,2041,0.0391491157402079,0.716315531602156
2015,41005,4014,11702,2914,6411,465,834,3379,7245,0.026788586472226,0.466390614216701
2015,41007,173,880,488,1559,0,11,488,1570,0.0583968755811791,0.310828025477707
2015,41009,228,1239,254,954,33,47,287,1001,0.0289825699229834,0.286713286713287
2015,41011,203,1179,301,1214,67,91,368,1305,0.0281353081948128,0.281992337164751
2015,41013,81,897,32,262,0,22,32,284,0.0182378628307218,0.112676056338028
2015,41015,18,377,266,1222,0,46,266,1268,0.0718535728452428,0.209779179810726
2015,41017,908,2795,1949,4004,127,192,2076,4196,0.0354493689066117,0.494756911344137
2015,41019,227,1879,296,1885,25,130,321,2015,0.0257090728147288,0.159305210918114
2015,41021,7,44,17,22,0,0,17,22,0.0162721893491124,0.772727272727273
2015,41023,25,182,52,153,0,3,52,156,0.0283481737234236,0.333333333333333
2015,41025,22,146,34,105,15,29,49,134,0.0259840992825286,0.365671641791045
2015,41027,74,183,176,303,27,27,203,330,0.0216336698570867,0.615151515151515
2015,41029,610,3290,1729,5610,103,378,1832,5988,0.0407280444009141,0.305945223780895
2015,41031,73,1033,90,375,2,15,92,390,0.0263709513827845,0.235897435897436
2015,41033,209,1183,530,2160,18,115,548,2275,0.0372535534158643,0.240879120879121
2015,41035,191,886,265,1257,0,41,265,1298,0.028406976998665,0.204160246533128
2015,41037,28,330,34,157,6,18,40,175,0.0298329355608592,0.228571428571429
2015,41039,1130,4054,2269,6601,530,1114,2799,7715,0.0319946585715826,0.362799740764744
2015,41041,367,879,256,1040,19,32,275,1072,0.0303768773023519,0.256529850746269
2015,41043,618,2985,365,1456,69,209,434,1665,0.0205695225152882,0.260660660660661
2015,41045,28,820,104,732,0,62,104,794,0.0399155439372612,0.130982367758186
2015,41047,1530,7346,1332,3955,143,693,1475,4648,0.0222279609384714,0.317340791738382
2015,41049,39,189,9,197,0,9,9,206,0.0290878282970912,0.0436893203883495
2015,41051,5830,15377,10977,19890,2264,4006,13241,23896,0.0436294056643735,0.554109474389019
2015,41053,468,2357,199,1006,117,204,316,1210,0.0246415770609319,0.261157024793388
2015,41055,2,48,15,46,0,4,15,50,0.0380517503805175,0.3
2015,41057,90,512,60,296,16,22,76,318,0.0168093878845544,0.238993710691824
2015,41059,189,1463,260,1263,48,83,308,1346,0.0272084091368506,0.228826151560178
2015,41061,106,364,98,321,0,89,98,410,0.023985023985024,0.239024390243902
2015,41063,50,225,42,145,0,5,42,150,0.0284198560060629,0.28
2015,41065,143,494,217,566,5,32,222,598,0.0339656935135749,0.37123745819398
2015,41067,4762,11906,6901,13591,1915,3069,8816,16660,0.0445941026574445,0.529171668667467
2015,41069,9,74,0,7,0,0,0,7,0.00635785649409628,0
2015,41071,980,3468,799,2122,61,208,860,2330,0.0350586819139332,0.369098712446352
2015,42001,233,1296,407,1311,32,180,439,1491,0.0211895118311661,0.294433266264252
2015,42003,5143,10524,8926,14997,2883,4263,11809,19260,0.0219512695492809,0.613136033229491
2015,42005,201,1045,55,341,4,62,59,403,0.00811649077579957,0.146401985111663
2015,42007,859,3055,395,1062,40,90,435,1152,0.00939135538780102,0.377604166666667
2015,42009,87,375,107,347,4,34,111,381,0.010782815418577,0.291338582677165
2015,42011,1243,5168,618,2984,140,759,758,3743,0.0135111720752265,0.202511354528453
2015,42013,274,1309,203,718,24,89,227,807,0.00908170155300473,0.281288723667906
2015,42015,51,281,123,630,8,32,131,662,0.0151055333713634,0.197885196374622
2015,42017,2707,8090,3423,7371,715,1525,4138,8896,0.0201737537105783,0.465152877697842
2015,42019,1864,3655,678,1336,118,232,796,1568,0.0121175588683066,0.50765306122449
2015,42021,312,1621,199,950,33,139,232,1089,0.0109666569319544,0.213039485766758
2015,42023,43,125,5,33,0,0,5,33,0.00897226753670473,0.151515151515152
2015,42025,274,1396,117,638,72,98,189,736,0.0156031375874497,0.25679347826087
2015,42027,1095,2938,1251,1975,908,1118,2159,3093,0.0338051259631674,0.698027804720336
2015,42029,3672,7012,3462,5882,1042,1758,4504,7640,0.0223159518162381,0.589528795811518
2015,42031,137,542,102,337,10,42,112,379,0.0145539725816981,0.295514511873351
2015,42033,212,2041,142,983,19,155,161,1138,0.0191970310391363,0.141476274165202
2015,42035,151,601,73,155,15,82,88,237,0.00945767987549383,0.371308016877637
2015,42037,186,790,170,421,32,47,202,468,0.0106937208664656,0.431623931623932
2015,42039,200,1255,172,604,44,120,216,724,0.0120718978223897,0.298342541436464
2015,42041,1386,6581,1684,2941,512,661,2196,3602,0.0215133398235691,0.609661299278179
2015,42043,1671,5398,1251,3580,458,986,1709,4566,0.024430176565008,0.374288217257994
2015,42045,3186,8301,2246,4642,720,1542,2966,6184,0.0164326047963861,0.479624838292367
2015,42047,0,175,51,81,0,27,51,108,0.00469912544054301,0.472222222222222
2015,42049,663,2320,1292,2814,215,469,1507,3283,0.0175462975334705,0.459031373743527
2015,42051,201,1589,207,753,27,99,234,852,0.00870880693433641,0.274647887323944
2015,42053,30,633,17,62,0,23,17,85,0.0135891286970424,0.2
2015,42055,334,1608,550,2000,123,300,673,2300,0.0219072655922582,0.292608695652174
2015,42057,36,233,22,69,3,9,25,78,0.00749063670411985,0.320512820512821
2015,42059,143,953,93,376,0,36,93,412,0.0153708401731085,0.225728155339806
2015,42061,101,1099,41,170,85,104,126,274,0.00838407637465194,0.45985401459854
2015,42063,373,1208,160,627,120,199,280,826,0.0146737489119042,0.338983050847458
2015,42065,92,743,42,253,0,10,42,263,0.00832199474733411,0.159695817490494
2015,42067,46,351,10,60,4,36,14,96,0.00554368539585379,0.145833333333333
2015,42069,737,2340,515,1616,214,487,729,2103,0.0140485654163466,0.346647646219686
2015,42071,1735,5205,1427,3692,326,958,1753,4650,0.0132469197350616,0.376989247311828
2015,42073,132,753,187,648,12,95,199,743,0.0117015245054807,0.267833109017497
2015,42075,621,2674,196,917,15,349,211,1266,0.0136083671034386,0.166666666666667
2015,42077,1851,6611,1469,3881,407,1660,1876,5541,0.0228611743737004,0.338567045659628
2015,42079,996,3786,710,2449,149,555,859,3004,0.0132344713040184,0.28595206391478
2015,42081,283,1896,317,1277,54,91,371,1368,0.0169739682854803,0.271198830409357
2015,42083,68,486,88,462,9,38,97,500,0.0165568396304513,0.194
2015,42085,303,1440,302,1065,3,74,305,1139,0.014204474596563,0.267778753292362
2015,42087,51,522,43,177,0,58,43,235,0.00719226296137602,0.182978723404255
2015,42089,448,1737,657,2520,47,269,704,2789,0.0247249581120735,0.2524202223019
2015,42091,7864,16920,4675,7945,2274,3172,6949,11117,0.019569254600984,0.625078708284609
2015,42093,275,649,95,200,9,46,104,246,0.0184283466926362,0.422764227642276
2015,42095,1262,4434,1325,3572,227,686,1552,4258,0.0205707439382008,0.364490371066228
2015,42097,435,2092,94,427,27,118,121,545,0.00799131952081409,0.222018348623853
2015,42099,146,760,67,234,2,38,69,272,0.00851836773041872,0.253676470588235
2015,42101,5942,13009,11025,18273,3990,8984,15015,27257,0.0266179301158486,0.550867667021316
2015,42103,267,759,406,1350,36,47,442,1397,0.034509164566968,0.316392269148175
2015,42105,53,227,47,251,0,11,47,262,0.0212455400583847,0.179389312977099
2015,42107,225,2189,138,872,20,171,158,1043,0.00977745280011999,0.151486097794823
2015,42109,49,476,28,181,13,88,41,269,0.0101647521160822,0.152416356877323
2015,42111,246,1383,53,392,10,61,63,453,0.00799153215136279,0.139072847682119
2015,42113,37,114,27,56,0,0,27,56,0.0113798008534851,0.482142857142857
2015,42115,79,588,89,520,3,30,92,550,0.0179036458333333,0.167272727272727
2015,42117,75,369,142,477,7,27,149,504,0.017182599209055,0.295634920634921
2015,42119,382,1250,161,1170,9,110,170,1280,0.0419975063980576,0.1328125
2015,42121,149,822,107,340,1,54,108,394,0.0101598762248582,0.274111675126904
2015,42123,127,585,72,351,11,15,83,366,0.012273230273968,0.226775956284153
2015,42125,1095,3379,831,2004,80,336,911,2340,0.0157890475290815,0.389316239316239
2015,42127,196,1496,270,1013,33,48,303,1061,0.0274806392291953,0.285579641847314
2015,42129,1438,5118,765,1944,63,326,828,2270,0.00860216683656262,0.364757709251101
2015,42131,64,421,23,213,7,7,30,220,0.0111612805032723,0.136363636363636
2015,42133,1189,5253,1450,4824,267,1075,1717,5899,0.0194788041288857,0.291066282420749
2015,44001,516,938,351,750,36,63,387,813,0.0239342910975035,0.476014760147601
2015,44003,1279,4241,1045,2026,203,307,1248,2333,0.0194269345746143,0.53493356193742
2015,44005,427,882,2530,3761,255,375,2785,4136,0.0699191939682862,0.673355899419729
2015,44007,1247,3915,4446,8741,1564,3207,6010,11948,0.0282858509192665,0.503013056578507
2015,44009,760,1555,915,1749,91,162,1006,1911,0.0224754780890551,0.526425954997384
2015,45001,110,605,20,144,0,12,20,156,0.00915707912655553,0.128205128205128
2015,45003,345,1419,864,3408,74,323,938,3731,0.0330630510877753,0.25140712945591
2015,45005,10,349,0,74,0,0,0,74,0.0107714701601164,0
2015,45007,614,2857,576,2428,232,611,808,3039,0.0233596728569672,0.265876933201711
2015,45009,25,147,30,100,0,28,30,128,0.0129607128392062,0.234375
2015,45011,0,240,34,143,0,2,34,145,0.0101207510295247,0.23448275862069
2015,45013,514,1712,3972,8642,348,848,4320,9490,0.0790056444496245,0.455216016859852
2015,45015,1510,4948,1438,4836,214,412,1652,5248,0.0416650126630517,0.314786585365854
2015,45017,30,413,10,106,0,0,10,106,0.009893597162591,0.0943396226415094
2015,45019,1938,6693,5950,10321,425,720,6375,11041,0.0427783245123945,0.577393352051445
2015,45021,198,741,54,517,0,8,54,525,0.0142272567139102,0.102857142857143
2015,45023,52,418,76,229,0,61,76,290,0.0131584917645991,0.262068965517241
2015,45025,282,754,125,379,0,103,125,482,0.0154412942495595,0.259336099585062
2015,45027,131,956,34,448,0,36,34,484,0.0205354491068777,0.0702479338842975
2015,45029,255,756,78,307,0,20,78,327,0.0126011560693642,0.238532110091743
2015,45031,238,1134,150,609,0,32,150,641,0.0139959387759558,0.234009360374415
2015,45033,12,534,7,164,20,20,27,184,0.00901607212857703,0.146739130434783
2015,45035,871,4261,1063,3567,164,289,1227,3856,0.0405093078959533,0.318205394190871
2015,45037,134,747,108,584,46,166,154,750,0.0395152792413066,0.205333333333333
2015,45039,49,258,34,144,25,50,59,194,0.0118603655927126,0.304123711340206
2015,45041,361,1639,367,1410,0,75,367,1485,0.0162183414698077,0.247138047138047
2015,45043,299,1459,486,1119,72,136,558,1255,0.028527914166212,0.444621513944223
2015,45045,1928,5824,4184,9269,970,1814,5154,11083,0.0348672226714025,0.465036542452405
2015,45047,339,1462,329,987,32,62,361,1049,0.0226835333549573,0.344137273593899
2015,45049,74,268,15,321,0,8,15,329,0.0236096160746322,0.0455927051671733
2015,45051,716,3061,2377,10314,256,1094,2633,11408,0.0546046333524794,0.230802945301543
2015,45053,59,663,209,669,0,38,209,707,0.0403677058353317,0.295615275813296
2015,45055,224,1153,265,736,0,72,265,808,0.0189054493553897,0.327970297029703
2015,45057,178,825,496,1481,16,139,512,1620,0.0285075756242631,0.316049382716049
2015,45059,172,1892,129,400,0,46,129,446,0.00996091568955891,0.289237668161435
2015,45061,28,639,10,97,0,14,10,111,0.008888532991672,0.0900900900900901
2015,45063,1789,5926,1158,3647,340,697,1498,4344,0.023398238668498,0.344843462246777
2015,45065,44,367,109,214,12,14,121,228,0.0284324728769173,0.530701754385965
2015,45067,16,251,0,434,102,190,102,624,0.0287372202265819,0.163461538461538
2015,45069,65,748,14,485,0,40,14,525,0.0264190821256039,0.0266666666666667
2015,45071,99,771,22,294,19,82,41,376,0.0147775506995755,0.109042553191489
2015,45073,327,907,547,1353,21,151,568,1504,0.0280874745550638,0.377659574468085
2015,45075,320,1033,240,613,12,69,252,682,0.0114664245603416,0.36950146627566
2015,45077,491,2073,567,1583,151,357,718,1940,0.0261282980242158,0.370103092783505
2015,45079,2481,8923,3647,8766,683,1299,4330,10065,0.041006481998297,0.430203676105315
2015,45081,46,319,91,200,0,34,91,234,0.0169835970387574,0.388888888888889
2015,45083,973,4303,1185,3315,320,730,1505,4045,0.0209390206025468,0.372064276885043
2015,45085,262,1303,588,1749,154,563,742,2312,0.0333925502260352,0.320934256055363
2015,45087,111,571,36,116,0,10,36,126,0.00637845499645641,0.285714285714286
2015,45089,50,514,16,234,5,83,21,317,0.0138246838203227,0.0662460567823344
2015,45091,722,1943,2836,6518,158,318,2994,6836,0.0431301538830388,0.437975424224693
2015,46003,4,51,2,2,0,5,2,7,0.00381056069678824,0.285714285714286
2015,46005,54,210,15,234,74,162,89,396,0.0325310112544155,0.224747474747475
2015,46007,2,72,21,32,0,0,21,32,0.0165889061689995,0.65625
2015,46009,59,442,13,77,0,1,13,78,0.0153513087974808,0.166666666666667
2015,46011,205,581,263,650,31,74,294,724,0.0418860283482789,0.406077348066298
2015,46013,284,827,161,668,23,36,184,704,0.0278933396727287,0.261363636363636
2015,46015,14,71,8,19,0,0,8,19,0.0053355798932884,0.421052631578947
2015,46017,0,9,8,8,0,0,8,8,0.00761179828734539,1
2015,46019,167,446,0,118,22,25,22,143,0.0204724409448819,0.153846153846154
2015,46021,17,26,7,26,0,0,7,26,0.0237659963436929,0.269230769230769
2015,46023,35,116,21,119,0,0,21,119,0.0207244862417276,0.176470588235294
2015,46025,4,98,15,23,0,0,15,23,0.00915969733174034,0.652173913043478
2015,46027,8,105,161,271,13,96,174,367,0.0520788988221938,0.474114441416894
2015,46029,76,551,45,243,0,10,45,253,0.0136786332179931,0.177865612648221
2015,46031,7,25,9,36,11,11,20,47,0.0201890034364261,0.425531914893617
2015,46033,35,214,31,159,18,18,49,177,0.0269981696156193,0.27683615819209
2015,46035,62,527,172,316,0,48,172,364,0.0278884462151394,0.472527472527473
2015,46037,17,162,14,90,8,8,22,98,0.0242394261686866,0.224489795918367
2015,46039,11,52,23,91,0,0,23,91,0.0297580117724003,0.252747252747253
2015,46041,24,74,0,13,0,3,0,16,0.00521342456826328,0
2015,46043,4,83,13,25,0,1,13,26,0.0123106060606061,0.5
2015,46045,14,84,7,15,5,5,12,20,0.00723589001447178,0.6
2015,46047,13,56,57,321,0,0,57,321,0.0604747550866616,0.177570093457944
2015,46049,19,82,3,31,0,4,3,35,0.0219160926737633,0.0857142857142857
2015,46051,6,62,13,53,0,2,13,55,0.0109387430389817,0.236363636363636
2015,46053,3,66,24,78,0,7,24,85,0.0281923714759536,0.282352941176471
2015,46055,5,20,18,26,0,0,18,26,0.0177595628415301,0.692307692307692
2015,46057,39,140,4,55,0,2,4,57,0.0155440414507772,0.0701754385964912
2015,46059,37,56,5,24,0,0,5,24,0.00978393803505911,0.208333333333333
2015,46061,18,65,0,39,0,0,0,39,0.018913676042677,0
2015,46063,2,2,8,19,0,0,8,19,0.022274325908558,0.421052631578947
2015,46065,111,605,80,282,0,7,80,289,0.02389022071588,0.27681660899654
2015,46067,44,149,20,45,0,0,20,45,0.00887749062931545,0.444444444444444
2015,46069,5,21,0,0,0,0,0,0,0,NA
2015,46071,0,45,13,52,0,0,13,52,0.0283687943262411,0.25
2015,46073,24,64,3,3,0,11,3,14,0.00966183574879227,0.214285714285714
2015,46075,0,5,0,7,0,0,0,7,0.0113636363636364,0
2015,46077,40,132,21,89,0,7,21,96,0.026193724420191,0.21875
2015,46079,75,268,73,210,4,10,77,220,0.0271940667490729,0.35
2015,46081,112,498,227,600,51,115,278,715,0.042458432304038,0.388811188811189
2015,46083,890,2740,273,750,0,18,273,768,0.0240195158566335,0.35546875
2015,46085,20,50,24,58,0,0,24,58,0.0239570425444031,0.413793103448276
2015,46087,23,146,7,102,0,4,7,106,0.028005284015852,0.0660377358490566
2015,46089,0,107,0,89,0,3,0,92,0.0533642691415313,0
2015,46091,47,151,0,42,7,19,7,61,0.0189030058878215,0.114754098360656
2015,46093,170,834,120,642,22,140,142,782,0.0455737513841133,0.181585677749361
2015,46095,0,15,0,15,0,5,0,20,0.0164338537387017,0
2015,46097,10,46,10,34,0,0,10,34,0.0212899185973701,0.294117647058824
2015,46099,809,2874,1001,2700,62,468,1063,3168,0.0271003173679843,0.335542929292929
2015,46101,27,168,6,30,11,40,17,70,0.0163513197850969,0.242857142857143
2015,46102,11,79,17,76,0,0,17,76,0.0106951871657754,0.223684210526316
2015,46103,437,1789,653,2824,190,262,843,3086,0.0434941932574135,0.273169151004537
2015,46105,24,45,16,124,3,3,19,127,0.0567978533094812,0.149606299212598
2015,46107,3,25,6,15,0,0,6,15,0.00857632933104631,0.4
2015,46109,12,124,40,153,0,0,40,153,0.0234375,0.261437908496732
2015,46111,0,34,6,45,0,0,6,45,0.0263929618768328,0.133333333333333
2015,46115,31,119,14,110,15,28,29,138,0.030639431616341,0.210144927536232
2015,46117,19,84,0,9,0,0,0,9,0.00442043222003929,0
2015,46119,7,7,2,16,0,10,2,26,0.0262096774193548,0.0769230769230769
2015,46121,0,93,21,65,0,11,21,76,0.0157122183171387,0.276315789473684
2015,46123,20,34,5,50,0,0,5,50,0.0129332643559234,0.1
2015,46125,25,191,23,74,2,4,25,78,0.0133630289532294,0.320512820512821
2015,46127,119,223,321,692,0,0,321,692,0.068931168443072,0.463872832369942
2015,46129,37,157,30,102,68,68,98,170,0.04341164453524,0.576470588235294
2015,46135,22,382,141,545,0,7,141,552,0.0348947468234402,0.255434782608696
2015,46137,3,46,3,3,0,0,3,3,0.00198281559814937,1
2015,47001,202,1913,282,862,252,412,534,1274,0.0238755622188906,0.419152276295133
2015,47003,128,891,33,530,14,37,47,567,0.0189271288847348,0.0828924162257496
2015,47005,27,224,59,124,10,16,69,140,0.0117716303708064,0.492857142857143
2015,47007,39,830,0,205,0,0,0,205,0.0207028883053928,0
2015,47009,475,2179,660,1610,67,116,727,1726,0.0195687172626471,0.421205098493627
2015,47011,296,1173,429,2032,20,137,449,2169,0.0317555597850753,0.207007837713232
2015,47013,14,345,47,543,0,11,47,554,0.0193321003594235,0.0848375451263538
2015,47015,84,673,33,194,0,11,33,205,0.0209890447425003,0.160975609756098
2015,47017,70,421,32,300,0,23,32,323,0.0165395053510164,0.0990712074303406
2015,47019,243,1246,34,552,30,69,64,621,0.0151301042783354,0.103059581320451
2015,47021,323,1270,164,396,0,7,164,403,0.0150406807494215,0.406947890818859
2015,47023,72,228,28,213,0,59,28,272,0.0249747497934074,0.102941176470588
2015,47025,201,410,223,804,11,53,234,857,0.0382982526701524,0.273045507584597
2015,47027,13,239,0,58,2,8,2,66,0.011656658424585,0.0303030303030303
2015,47029,84,462,56,628,0,20,56,648,0.0256400110790171,0.0864197530864197
2015,47031,197,1378,244,919,26,44,270,963,0.0266029448327302,0.280373831775701
2015,47033,58,308,10,72,0,0,10,72,0.00728818706346796,0.138888888888889
2015,47035,154,1212,312,1186,15,33,327,1219,0.0282104093864988,0.26825266611977
2015,47037,4268,11103,8396,15334,1476,3311,9872,18645,0.0417886295481135,0.52947170823277
2015,47039,10,239,13,104,0,0,13,104,0.0123339658444023,0.125
2015,47041,99,545,34,78,0,1,34,79,0.00599939246658566,0.430379746835443
2015,47043,158,852,192,565,0,0,192,565,0.0165470786352321,0.339823008849558
2015,47045,98,580,92,434,47,122,139,556,0.0218227490383861,0.25
2015,47047,229,799,95,377,28,72,123,449,0.0161267150348395,0.273942093541203
2015,47049,22,436,31,209,0,16,31,225,0.0178104963191641,0.137777777777778
2015,47051,207,742,121,634,0,109,121,743,0.0265736766809728,0.162853297442799
2015,47053,142,991,126,443,6,16,132,459,0.0136574625089264,0.287581699346405
2015,47055,93,349,126,309,34,60,160,369,0.0182186234817814,0.43360433604336
2015,47057,42,545,88,287,19,22,107,309,0.019057604539287,0.346278317152104
2015,47059,158,965,170,859,13,90,183,949,0.0193851496272087,0.192834562697576
2015,47061,3,107,8,24,0,3,8,27,0.00285231354320727,0.296296296296296
2015,47063,222,1252,104,852,34,117,138,969,0.0223030358827997,0.142414860681115
2015,47065,1188,3321,2442,7247,262,574,2704,7821,0.0325866853328667,0.345735839406725
2015,47067,0,137,3,54,0,19,3,73,0.0153554901135886,0.0410958904109589
2015,47069,16,502,4,100,7,9,11,109,0.00588013162863462,0.100917431192661
2015,47071,25,274,113,415,0,0,113,415,0.0223070307460761,0.272289156626506
2015,47073,300,1279,180,509,0,2,180,511,0.0126704686337714,0.352250489236791
2015,47075,36,393,9,75,0,80,9,155,0.0125791267651355,0.0580645161290323
2015,47077,62,421,64,216,0,47,64,263,0.0137761248755958,0.243346007604563
2015,47079,28,378,25,342,2,2,27,344,0.0148487072128459,0.0784883720930233
2015,47081,25,1081,43,196,0,10,43,206,0.0122016229343126,0.20873786407767
2015,47083,26,233,14,74,7,15,21,89,0.0155133344953809,0.235955056179775
2015,47085,32,504,21,157,0,85,21,242,0.0189388010643293,0.0867768595041322
2015,47087,34,291,18,100,11,11,29,111,0.0132902298850575,0.261261261261261
2015,47089,186,1575,153,799,25,68,178,867,0.0238056013179572,0.205305651672434
2015,47091,21,720,7,243,15,27,22,270,0.0200743494423792,0.0814814814814815
2015,47093,1759,7089,3537,7743,406,688,3943,8431,0.0286185628600233,0.467678804412288
2015,47095,12,697,1,58,0,16,1,74,0.0129574505340571,0.0135135135135135
2015,47097,34,1221,25,240,0,10,25,250,0.0135840034775049,0.1
2015,47099,100,543,43,418,7,47,50,465,0.0163951766448064,0.10752688172043
2015,47101,70,156,45,136,12,12,57,148,0.0176274416388757,0.385135135135135
2015,47103,36,443,121,752,8,45,129,797,0.0341605589130342,0.161856963613551
2015,47105,265,1421,274,769,0,94,274,863,0.0234517242316367,0.317497103128621
2015,47107,107,798,116,583,9,62,125,645,0.0176605881386562,0.193798449612403
2015,47109,17,257,4,259,3,17,7,276,0.0151042521753407,0.0253623188405797
2015,47111,19,454,9,177,0,163,9,340,0.0222062569394553,0.0264705882352941
2015,47113,393,1605,332,920,37,80,369,1000,0.0155462968720851,0.369
2015,47115,45,306,73,195,0,0,73,195,0.00969522199572416,0.374358974358974
2015,47117,102,766,40,235,6,6,46,241,0.0113294471605867,0.190871369294606
2015,47119,462,2244,278,1347,34,221,312,1568,0.0273385057972278,0.198979591836735
2015,47121,11,137,0,217,0,0,0,217,0.0257811571818938,0
2015,47123,109,910,65,615,0,11,65,626,0.0198534775300498,0.103833865814696
2015,47125,392,1579,2442,7962,543,1597,2985,9559,0.0846258720209639,0.312271158070928
2015,47127,40,330,0,1,0,0,0,1,0.000216637781629116,0
2015,47129,52,1406,0,198,0,2,0,200,0.0128328521013795,0
2015,47131,72,607,66,475,0,0,66,475,0.022020305039173,0.138947368421053
2015,47133,35,388,52,149,0,0,52,149,0.00968601703178834,0.348993288590604
2015,47135,9,146,3,29,2,4,5,33,0.00597501357957632,0.151515151515152
2015,47137,36,247,2,68,0,0,2,68,0.0176485855177784,0.0294117647058824
2015,47139,20,258,11,338,13,16,24,354,0.0296432758331938,0.0677966101694915
2015,47141,245,1036,220,653,203,303,423,956,0.0203642560443072,0.442468619246862
2015,47143,112,960,67,623,14,47,81,670,0.0306201727526164,0.12089552238806
2015,47145,221,818,45,466,45,132,90,598,0.0154569892473118,0.150501672240803
2015,47147,518,1896,157,647,0,16,157,663,0.0147153479081123,0.236802413273001
2015,47149,1504,5561,1520,4898,440,996,1960,5894,0.0338578018278847,0.332541567695962
2015,47151,29,251,36,201,0,15,36,216,0.0146569858180091,0.166666666666667
2015,47153,77,462,75,158,0,0,75,158,0.015540474082817,0.474683544303797
2015,47155,290,2313,440,2069,25,149,465,2218,0.0337523206622637,0.209648331830478
2015,47157,1573,5157,5684,15211,1110,2257,6794,17468,0.0290825542967027,0.38893977558965
2015,47159,62,522,0,57,0,0,0,57,0.00436013156888243,0
2015,47161,28,220,6,160,4,30,10,190,0.0204829667960328,0.0526315789473684
2015,47163,582,2523,480,2690,78,199,558,2889,0.0255561944358441,0.193146417445483
2015,47165,1116,4233,1034,3149,78,262,1112,3411,0.0297324860751549,0.32600410436822
2015,47167,183,1626,110,889,46,145,156,1034,0.0258448310337932,0.150870406189555
2015,47169,12,456,11,97,0,9,11,106,0.019906103286385,0.10377358490566
2015,47171,35,435,41,236,0,10,41,246,0.0185506372068471,0.166666666666667
2015,47173,15,381,18,96,0,5,18,101,0.00763705103969754,0.178217821782178
2015,47175,7,136,32,67,0,3,32,70,0.0170357751277683,0.457142857142857
2015,47177,8,641,26,252,0,82,26,334,0.0122487897902303,0.0778443113772455
2015,47179,495,2233,687,1692,66,161,753,1853,0.0217416811376543,0.406368051807879
2015,47181,14,384,4,42,0,2,4,44,0.00357723577235772,0.0909090909090909
2015,47183,124,508,49,283,6,31,55,314,0.0145054741996582,0.17515923566879
2015,47185,41,527,26,283,0,10,26,293,0.0159412404787813,0.0887372013651877
2015,47187,3459,5706,2987,4598,406,577,3393,5175,0.0401907409852362,0.655652173913043
2015,47189,1082,3194,678,2024,116,330,794,2354,0.028276955602537,0.337298215802889
2015,48001,154,4012,22,304,0,74,22,378,0.00906953308700034,0.0582010582010582
2015,48003,0,594,11,88,0,23,11,111,0.011122244488978,0.0990990990990991
2015,48005,436,2212,108,574,17,113,125,687,0.0121455342620748,0.181950509461426
2015,48007,241,1626,53,197,11,14,64,211,0.0117956171735241,0.303317535545024
2015,48009,39,158,10,43,0,0,10,43,0.00706655710764174,0.232558139534884
2015,48011,6,72,0,4,0,0,0,4,0.00290909090909091,0
2015,48013,151,1029,82,478,46,64,128,542,0.0182854829459195,0.236162361623616
2015,48015,205,878,68,139,0,54,68,193,0.00997570682793198,0.352331606217617
2015,48017,0,220,0,28,0,0,0,28,0.0065131425913003,0
2015,48019,140,850,39,163,0,20,39,183,0.0115530303030303,0.213114754098361
2015,48021,691,3441,109,491,191,234,300,725,0.0141909217248331,0.413793103448276
2015,48023,81,158,9,16,0,0,9,16,0.006053726825577,0.5625
2015,48025,311,3186,37,269,15,92,52,361,0.0163392776319363,0.14404432132964
2015,48027,1834,6553,3115,10062,681,2890,3796,12952,0.0665522521504106,0.293082149474985
2015,48029,8068,26894,9625,22837,3184,7249,12809,30086,0.0262649948187614,0.42574619424317
2015,48031,74,240,11,104,0,0,11,104,0.0131628907733198,0.105769230769231
2015,48033,10,64,2,2,0,3,2,5,0.0105485232067511,0.4
2015,48035,73,652,0,52,0,0,0,52,0.00408195305753984,0
2015,48037,218,1564,401,2054,26,110,427,2164,0.0345841590487758,0.19731977818854
2015,48039,2915,9665,1160,2582,298,619,1458,3201,0.0149640274317129,0.455482661668229
2015,48041,1611,5920,1550,2509,1194,1485,2744,3994,0.0385655246997026,0.687030545818728
2015,48043,181,385,55,156,0,8,55,164,0.0250956388676358,0.335365853658537
2015,48045,0,6,13,36,0,0,13,36,0.0320569902048085,0.361111111111111
2015,48047,6,234,9,17,0,104,9,121,0.0269247886070316,0.0743801652892562
2015,48049,176,842,20,88,0,32,20,120,0.00469483568075117,0.166666666666667
2015,48051,144,645,7,27,0,8,7,35,0.0029198298156336,0.2
2015,48053,310,1633,39,255,0,90,39,345,0.0112191473448018,0.11304347826087
2015,48055,176,1881,37,389,34,76,71,465,0.0185858747352012,0.152688172043011
2015,48057,91,411,27,115,58,124,85,239,0.0165937651878081,0.355648535564854
2015,48059,50,442,13,58,0,53,13,111,0.0117261778998521,0.117117117117117
2015,48061,645,2638,481,1653,281,1709,762,3362,0.0139879342625338,0.226650803093397
2015,48063,46,210,17,176,0,9,17,185,0.0227888642522789,0.0918918918918919
2015,48065,72,288,0,64,0,0,0,64,0.0157209530827806,0
2015,48067,99,472,30,279,0,43,30,322,0.0151386929948284,0.093167701863354
2015,48069,15,191,0,80,0,30,0,110,0.0230463021160696,0
2015,48071,328,1096,41,380,0,0,41,380,0.0159690704320054,0.107894736842105
2015,48073,204,1304,66,451,0,78,66,529,0.0159471843723622,0.12476370510397
2015,48075,41,290,56,130,0,0,56,130,0.0270495214315439,0.430769230769231
2015,48077,73,502,0,12,0,23,0,35,0.00469357650529704,0
2015,48079,10,36,0,22,0,6,0,28,0.0153761669412411,0
2015,48081,54,162,0,0,0,2,0,2,0.000824062628759786,0
2015,48083,16,145,0,46,0,10,0,56,0.00924550107313852,0
2015,48085,10111,22660,8397,14076,2837,4523,11234,18599,0.0333845496612901,0.604010968331631
2015,48087,13,119,0,33,0,0,0,33,0.0160818713450292,0
2015,48089,53,150,42,74,0,0,42,74,0.00516471245114461,0.567567567567568
2015,48091,2013,5203,524,1600,127,319,651,1919,0.0231724104619992,0.339239187076602
2015,48093,57,360,24,64,0,41,24,105,0.0112131567706108,0.228571428571429
2015,48095,0,273,0,186,20,143,20,329,0.107235984354628,0.060790273556231
2015,48097,196,1050,105,348,0,17,105,365,0.0141122796164553,0.287671232876712
2015,48099,320,2943,290,2139,56,642,346,2781,0.0595464959424448,0.124415677813736
2015,48101,2,17,0,8,0,0,0,8,0.00757575757575758,0
2015,48103,34,161,14,83,0,0,14,83,0.0286305622628493,0.168674698795181
2015,48105,0,94,0,4,0,0,0,4,0.00158227848101266,0
2015,48107,4,207,1,18,0,0,1,18,0.0046801872074883,0.0555555555555556
2015,48109,16,62,0,16,0,2,0,18,0.0124740124740125,0
2015,48111,13,257,23,81,5,13,28,94,0.0229772671718406,0.297872340425532
2015,48113,17498,44182,13319,27904,5465,12759,18784,40663,0.0259190017649882,0.461943289968768
2015,48115,96,693,10,191,0,46,10,237,0.0267705862419519,0.0421940928270042
2015,48117,50,384,11,62,0,40,11,102,0.00911365260900643,0.107843137254902
2015,48119,57,153,0,28,0,0,0,28,0.00769865273577124,0
2015,48121,11527,26326,5383,12807,1789,2970,7172,15777,0.0338208781809568,0.454585789440325
2015,48123,52,1118,26,74,4,7,30,81,0.00558967635083845,0.37037037037037
2015,48125,2,66,0,0,0,25,0,25,0.0152998776009792,0
2015,48127,8,336,0,62,0,0,0,62,0.00955315870570108,0
2015,48129,11,55,16,40,0,0,16,40,0.0166666666666667,0.4
2015,48131,32,479,0,13,0,0,0,13,0.0017423937809945,0
2015,48133,93,596,0,62,4,28,4,90,0.00735354195604216,0.0444444444444444
2015,48135,701,3599,394,2084,216,681,610,2765,0.0311756548015018,0.220614828209765
2015,48137,6,10,17,36,0,1,17,37,0.0270665691294806,0.459459459459459
2015,48139,979,3972,365,845,51,267,416,1112,0.0111915137730095,0.37410071942446
2015,48141,1011,3251,3407,11750,2234,6934,5641,18684,0.0377109433185388,0.301916077927639
2015,48143,336,1000,98,373,0,14,98,387,0.0170387003037908,0.253229974160207
2015,48145,69,734,0,25,0,14,0,39,0.00326551117809596,0
2015,48147,280,2306,63,389,22,45,85,434,0.0184445388865278,0.195852534562212
2015,48149,123,439,5,27,5,66,10,93,0.00520804166433331,0.10752688172043
2015,48151,25,92,0,3,0,0,0,3,0.00112359550561798,0
2015,48153,3,80,0,5,12,12,12,17,0.00428967953570527,0.705882352941177
2015,48155,8,46,0,5,0,0,0,5,0.00553097345132743,0
2015,48157,7411,18626,3698,7010,2598,4827,6296,11837,0.0284026423071478,0.531891526569232
2015,48159,35,227,10,54,0,0,10,54,0.00743904119024659,0.185185185185185
2015,48161,120,1019,53,148,0,21,53,169,0.0123900293255132,0.313609467455621
2015,48163,146,760,0,29,0,697,0,726,0.0662348325882675,0
2015,48165,150,521,14,343,0,190,14,533,0.0498830135704258,0.026266416510319
2015,48167,3700,10252,1330,3377,396,783,1726,4160,0.020403058496942,0.414903846153846
2015,48169,26,441,108,738,13,204,121,942,0.193151527578429,0.128450106157113
2015,48171,331,730,80,273,0,99,80,372,0.0198633062793678,0.21505376344086
2015,48173,3,9,0,6,0,0,0,6,0.00763358778625954,0
2015,48175,23,161,6,164,0,7,6,171,0.0328972681800693,0.0350877192982456
2015,48177,23,465,10,114,0,13,10,127,0.00983124322650565,0.078740157480315
2015,48179,139,1184,23,176,0,16,23,192,0.0124951190941039,0.119791666666667
2015,48181,583,3163,212,1712,60,114,272,1826,0.0221946713341112,0.148959474260679
2015,48183,760,3438,241,1096,92,347,333,1443,0.0182875826933313,0.230769230769231
2015,48185,121,1471,28,96,16,38,44,134,0.00717498393660313,0.328358208955224
2015,48187,1243,4231,470,1323,138,279,608,1602,0.0173262240295909,0.379525593008739
2015,48189,188,1862,13,357,0,19,13,376,0.017629407351838,0.0345744680851064
2015,48191,25,83,0,39,0,0,0,39,0.0186157517899761,0
2015,48193,62,230,0,29,0,0,0,29,0.00485030941629035,0
2015,48195,9,110,0,26,0,0,0,26,0.0075036075036075,0
2015,48197,1,85,0,6,0,0,0,6,0.00209716882209018,0
2015,48199,121,1340,93,243,10,47,103,290,0.00783254557731263,0.355172413793103
2015,48201,18153,50813,22343,48503,14675,29463,37018,77966,0.0285130401645993,0.474796706256573
2015,48203,129,1127,193,620,7,73,200,693,0.0159087256950024,0.288600288600289
2015,48205,41,426,64,156,4,5,68,161,0.035548686244204,0.422360248447205
2015,48207,32,496,0,85,5,88,5,173,0.0393808331436376,0.0289017341040462
2015,48209,2709,8508,803,1935,217,670,1020,2605,0.0251413901596309,0.391554702495202
2015,48211,33,123,5,43,0,0,5,43,0.0168826069886141,0.116279069767442
2015,48213,416,2148,70,838,35,144,105,982,0.0178613652485494,0.106924643584521
2015,48215,921,6524,844,4665,839,3878,1683,8543,0.0189217084688101,0.197003394592064
2015,48217,145,1015,75,283,2,60,77,343,0.014458542342874,0.224489795918367
2015,48219,194,1082,0,124,34,46,34,170,0.0119853355893965,0.2
2015,48221,498,1575,131,314,10,298,141,612,0.0159845378326847,0.230392156862745
2015,48223,200,1119,152,408,0,26,152,434,0.0183045128637706,0.350230414746544
2015,48225,61,921,27,138,0,4,27,142,0.00849994014126661,0.190140845070423
2015,48227,105,1371,55,614,17,159,72,773,0.0319091847265222,0.093143596377749
2015,48229,0,93,0,53,0,143,0,196,0.0875781948168007,0
2015,48231,405,3041,326,1040,170,395,496,1435,0.0247524752475248,0.345644599303136
2015,48233,140,495,54,227,0,3,54,230,0.0161267704389286,0.234782608695652
2015,48235,6,53,0,50,0,0,0,50,0.044404973357016,0
2015,48237,16,735,0,117,0,39,0,156,0.0254320182588849,0
2015,48239,13,329,52,182,0,13,52,195,0.0202681633925787,0.266666666666667
2015,48241,50,606,6,87,0,21,6,108,0.00451146664438782,0.0555555555555556
2015,48243,32,90,22,22,0,14,22,36,0.0202474690663667,0.611111111111111
2015,48245,1152,6820,669,2740,261,602,930,3342,0.0200555698914407,0.278276481149013
2015,48247,6,78,0,1,0,0,0,1,0.00029585798816568,0
2015,48249,165,801,27,270,6,83,33,353,0.01374771196012,0.0934844192634561
2015,48251,1019,4576,204,929,18,186,222,1115,0.0110787635503711,0.199103139013453
2015,48253,75,2314,1,362,0,32,1,394,0.027140593786595,0.00253807106598985
2015,48255,53,684,0,62,2,85,2,147,0.0144315727469075,0.0136054421768707
2015,48257,837,4456,90,935,109,288,199,1223,0.0174899179132226,0.162714636140638
2015,48259,506,1984,347,576,0,43,347,619,0.0242260576885445,0.560581583198708
2015,48261,0,1,0,0,0,0,0,0,0,NA
2015,48263,14,40,0,8,0,0,0,8,0.012987012987013,0
2015,48265,668,2274,210,465,75,106,285,571,0.0158049158547387,0.499124343257443
2015,48267,72,180,0,27,0,0,0,27,0.00778097982708934,0
2015,48269,0,0,0,0,0,0,0,0,0,NA
2015,48271,10,162,54,101,0,139,54,240,0.0918484500574053,0.225
2015,48273,342,639,123,204,6,23,129,227,0.0127764957505488,0.568281938325991
2015,48275,17,220,3,15,5,11,8,26,0.0101880877742947,0.307692307692308
2015,48277,132,903,88,629,26,61,114,690,0.0207656193571687,0.165217391304348
2015,48279,33,263,7,168,17,111,24,279,0.0324154757755315,0.0860215053763441
2015,48281,112,525,7,157,14,81,21,238,0.0172864613596746,0.0882352941176471
2015,48283,9,376,14,59,0,151,14,210,0.0471380471380471,0.0666666666666667
2015,48285,115,633,9,28,0,8,9,36,0.00265134776844896,0.25
2015,48287,91,425,10,96,0,15,10,111,0.00995069475571493,0.0900900900900901
2015,48289,79,417,0,35,0,22,0,57,0.00481296968673478,0
2015,48291,306,5455,83,465,16,53,99,518,0.0102153506350083,0.191119691119691
2015,48293,14,701,48,160,0,38,48,198,0.0123982467125861,0.242424242424242
2015,48295,23,124,4,72,0,1,4,73,0.0328680774425934,0.0547945205479452
2015,48297,98,480,12,95,15,123,27,218,0.0253990446230922,0.123853211009174
2015,48299,304,748,19,135,0,21,19,156,0.0102848101265823,0.121794871794872
2015,48301,0,0,0,7,0,0,0,7,0.0660377358490566,0
2015,48303,1638,6556,1269,3164,417,660,1686,3824,0.0225033837462485,0.440899581589958
2015,48305,32,199,0,35,2,4,2,39,0.0103420843277645,0.0512820512820513
2015,48307,33,339,3,9,0,0,3,9,0.00153035198095562,0.333333333333333
2015,48309,1187,4401,849,2048,131,385,980,2433,0.0167523909855198,0.402794903411426
2015,48311,8,12,0,3,0,0,0,3,0.00551470588235294,0
2015,48313,79,935,5,31,0,9,5,40,0.0041801651165221,0.125
2015,48315,124,401,10,178,0,6,10,184,0.0236991241628027,0.0543478260869565
2015,48317,42,141,18,19,0,2,18,21,0.00673724735322425,0.857142857142857
2015,48319,44,213,15,15,0,0,15,15,0.00491320013101867,1
2015,48321,70,579,40,166,12,13,52,179,0.00750240999203655,0.290502793296089
2015,48323,24,813,22,284,22,423,44,707,0.0222501966955153,0.0622347949080622
2015,48325,360,1682,45,244,0,17,45,261,0.00835467349551857,0.172413793103448
2015,48327,4,87,0,26,0,0,0,26,0.0167741935483871,0
2015,48329,1175,4183,750,2768,220,432,970,3200,0.0340266258347157,0.303125
2015,48331,158,1037,92,199,0,16,92,215,0.0131966609378836,0.427906976744186
2015,48333,18,112,0,5,19,19,19,24,0.00717060053779504,0.791666666666667
2015,48335,100,975,17,38,0,24,17,62,0.00976070528967254,0.274193548387097
2015,48337,106,648,41,69,0,56,41,125,0.00918847397824169,0.328
2015,48339,4881,13906,3476,8030,1234,2332,4710,10362,0.0318623908785373,0.454545454545455
2015,48341,108,670,18,206,0,3,18,209,0.0162153774536426,0.0861244019138756
2015,48343,34,519,0,27,5,25,5,52,0.00585190186810713,0.0961538461538462
2015,48345,8,35,0,4,0,0,0,4,0.00558659217877095,0
2015,48347,343,1223,101,419,37,98,138,517,0.0139218009478673,0.266924564796905
2015,48349,116,1177,100,309,19,37,119,346,0.0110514884374601,0.34393063583815
2015,48351,5,591,0,28,0,5,0,33,0.00342999688182102,0
2015,48353,26,418,5,175,0,16,5,191,0.0195656627740217,0.0261780104712042
2015,48355,2059,8208,1681,4517,192,501,1873,5018,0.0221768491019658,0.373256277401355
2015,48357,38,123,30,156,0,0,30,156,0.0248328557784145,0.192307692307692
2015,48359,19,69,0,7,0,0,0,7,0.00600343053173242,0
2015,48361,323,1595,211,817,65,149,276,966,0.0174434352371838,0.285714285714286
2015,48363,279,961,69,198,9,36,78,234,0.0124342419894787,0.333333333333333
2015,48365,56,536,0,47,0,20,0,67,0.00418357789572276,0
2015,48367,801,3949,376,1398,9,67,385,1465,0.0180516536054019,0.262798634812287
2015,48369,48,183,29,156,0,103,29,259,0.0428949983438225,0.111969111969112
2015,48371,51,1176,0,83,0,26,0,109,0.0102270594858322,0
2015,48373,186,1789,61,234,22,246,83,480,0.01458257382428,0.172916666666667
2015,48375,795,4657,269,1204,60,688,329,1892,0.024692647020438,0.173890063424947
2015,48377,119,151,39,122,37,37,76,159,0.0328920148944973,0.477987421383648
2015,48379,15,452,0,11,0,25,0,36,0.00446373217606944,0
2015,48381,896,3949,360,1151,77,189,437,1340,0.0162558229813665,0.326119402985075
2015,48383,26,149,20,58,0,41,20,99,0.0418427726120034,0.202020202020202
2015,48385,69,215,0,9,0,0,0,9,0.00362756952841596,0
2015,48387,105,405,21,138,0,24,21,162,0.0179940019993336,0.12962962962963
2015,48389,22,1055,16,278,0,258,16,536,0.0563557985490485,0.0298507462686567
2015,48391,14,302,0,10,0,0,0,10,0.0020259319286872,0
2015,48393,19,70,0,6,0,0,0,6,0.00974025974025974,0
2015,48395,178,506,0,49,0,11,0,60,0.00546746856205577,0
2015,48397,907,2661,532,1061,44,59,576,1120,0.020294634605976,0.514285714285714
2015,48399,19,135,0,9,0,8,0,17,0.00243065484701172,0
2015,48401,342,4773,0,236,13,17,13,253,0.00698008056061358,0.0513833992094862
2015,48403,22,185,23,73,0,7,23,80,0.0104849279161206,0.2875
2015,48405,13,229,23,31,0,0,23,31,0.00488419725854734,0.741935483870968
2015,48407,164,1158,0,317,0,62,0,379,0.0203162690967569,0
2015,48409,372,2309,129,631,37,118,166,749,0.0179405494742389,0.221628838451268
2015,48411,21,408,0,57,0,0,0,57,0.0135488471594961,0
2015,48413,0,27,0,5,0,0,0,5,0.00262743037309511,0
2015,48415,127,884,18,86,0,4,18,90,0.00805657506042431,0.2
2015,48417,9,79,1,8,15,20,16,28,0.0121317157712305,0.571428571428571
2015,48419,109,387,6,213,0,0,6,213,0.0129901811306946,0.028169014084507
2015,48421,0,118,0,3,0,0,0,3,0.00146699266503667,0
2015,48423,1573,5739,1163,2718,158,416,1321,3134,0.0223585646001284,0.421506062539885
2015,48425,3,316,7,7,0,0,7,7,0.00118744698897371,1
2015,48427,56,475,12,95,44,498,56,593,0.0171352616522669,0.0944350758853288
2015,48429,73,466,12,80,11,11,23,91,0.0141832917705736,0.252747252747253
2015,48431,17,20,0,21,0,0,0,21,0.023972602739726,0
2015,48433,0,27,0,3,0,0,0,3,0.00296442687747036,0
2015,48435,25,112,0,0,0,6,0,6,0.00237717908082409,0
2015,48437,14,402,3,25,0,4,3,29,0.00585149313962873,0.103448275862069
2015,48439,11108,35484,9183,23849,3726,8600,12909,32449,0.0268079836553007,0.397824278097938
2015,48441,661,3322,398,1521,20,387,418,1908,0.0234300169462387,0.219077568134172
2015,48443,10,33,0,0,0,4,0,4,0.0054127198917456,0
2015,48445,105,889,20,147,0,39,20,186,0.0231717951912296,0.10752688172043
2015,48447,8,46,3,11,0,3,3,14,0.0123131046613896,0.214285714285714
2015,48449,92,491,78,401,8,101,86,502,0.025676435987929,0.171314741035857
2015,48451,641,2680,1025,2563,165,341,1190,2904,0.0398797017261978,0.409779614325069
2015,48453,12208,26712,14168,22498,3796,6852,17964,29350,0.0395355948322196,0.61206132879046
2015,48455,60,760,26,236,0,19,26,255,0.0240702284311875,0.101960784313725
2015,48457,89,881,35,163,0,0,35,163,0.0107932724142498,0.214723926380368
2015,48459,336,1590,58,418,0,4,58,422,0.0156580460836333,0.137440758293839
2015,48461,26,96,0,24,0,5,0,29,0.0141119221411192,0
2015,48463,103,567,0,254,0,25,0,279,0.0168906647293861,0
2015,48465,224,739,63,379,85,405,148,784,0.026786934536012,0.188775510204082
2015,48467,332,1440,18,175,8,43,26,218,0.00598621522915122,0.119266055045872
2015,48469,345,1880,280,926,61,174,341,1100,0.0189406983952063,0.31
2015,48471,382,3994,90,405,116,121,206,526,0.0118162417162754,0.391634980988593
2015,48473,228,1197,41,163,3,21,44,184,0.0074373484236055,0.239130434782609
2015,48475,73,306,0,71,0,0,0,71,0.0101312785388128,0
2015,48477,220,728,10,93,0,66,10,159,0.00695964282587762,0.0628930817610063
2015,48479,362,1416,198,868,432,1969,630,2837,0.0198469330646967,0.222065562213606
2015,48481,42,380,21,110,28,79,49,189,0.00708024275118004,0.259259259259259
2015,48483,22,184,0,103,0,0,0,103,0.0271696122395146,0
2015,48485,513,3412,424,1993,214,406,638,2399,0.0286951425188091,0.26594414339308
2015,48487,31,382,87,199,5,28,92,227,0.0262064188409143,0.405286343612335
2015,48489,28,1230,24,187,0,198,24,385,0.0284321689683184,0.0623376623376623
2015,48491,8741,20466,4630,10469,594,1765,5224,12234,0.0399270256421972,0.427006702632009
2015,48493,193,1237,43,233,49,90,92,323,0.0106169674259606,0.284829721362229
2015,48495,69,260,28,136,13,37,41,173,0.037739965095986,0.236994219653179
2015,48497,642,2467,83,522,0,132,83,654,0.0160349139410582,0.126911314984709
2015,48499,255,1822,60,363,0,90,60,453,0.0146597197501699,0.132450331125828
2015,48501,0,138,0,28,0,53,0,81,0.0167632450331126,0
2015,48503,54,270,15,81,0,12,15,93,0.00744,0.161290322580645
2015,48505,0,179,0,39,0,0,0,39,0.00490072882633828,0
2015,48507,7,309,0,63,0,25,0,88,0.012777697110498,0
2015,49001,5,120,10,49,0,0,10,49,0.0130597014925373,0.204081632653061
2015,49003,272,1080,110,786,8,45,118,831,0.0278531925590749,0.141997593261131
2015,49005,456,1285,542,1354,255,342,797,1696,0.0288454996938567,0.469929245283019
2015,49007,48,365,0,139,3,6,3,145,0.0110308101939901,0.0206896551724138
2015,49009,11,38,0,0,0,0,0,0,0,NA
2015,49011,2416,6621,1524,4230,413,836,1937,5066,0.0274578457569336,0.382352941176471
2015,49013,22,337,32,139,5,12,37,151,0.0133427586816294,0.245033112582781
2015,49015,29,280,30,138,0,0,30,138,0.0210045662100457,0.217391304347826
2015,49017,44,148,32,100,3,3,35,103,0.0308938212357528,0.339805825242718
2015,49019,0,59,75,158,0,1,75,159,0.0243007794589638,0.471698113207547
2015,49021,169,821,204,881,0,62,204,943,0.03683018278394,0.216330858960764
2015,49023,10,146,0,86,0,3,0,89,0.0154998258446534,0
2015,49025,86,158,43,225,0,0,43,225,0.0437743190661479,0.191111111111111
2015,49027,95,222,40,208,2,17,42,225,0.0295702457615981,0.186666666666667
2015,49029,41,155,38,118,0,0,38,118,0.0204152249134948,0.322033898305085
2015,49031,12,23,5,25,0,0,5,25,0.018910741301059,0.2
2015,49033,0,54,0,40,0,0,0,40,0.0285714285714286,0
2015,49035,4426,10948,8001,16858,1652,3545,9653,20403,0.030734306342839,0.473116698524727
2015,49037,48,197,107,356,0,0,107,356,0.0417889423641272,0.300561797752809
2015,49039,156,1264,95,260,9,19,104,279,0.0176125244618395,0.372759856630824
2015,49041,52,472,43,178,0,25,43,203,0.0159541024834958,0.211822660098522
2015,49043,385,740,446,691,78,159,524,850,0.0335928546022211,0.616470588235294
2015,49045,279,1491,235,852,71,71,306,923,0.0265733863073645,0.331527627302275
2015,49047,161,742,96,774,16,74,112,848,0.0416359797711985,0.132075471698113
2015,49049,1976,5977,3399,7579,557,1520,3956,9099,0.0340242383902897,0.434773051983734
2015,49051,216,711,252,415,52,100,304,515,0.0327254241596238,0.590291262135922
2015,49053,848,2798,1316,3822,199,322,1515,4144,0.0450954360458789,0.365588803088803
2015,49055,3,22,8,22,0,36,8,58,0.0326392796848621,0.137931034482759
2015,49057,942,5423,753,2673,57,497,810,3170,0.0218450448960465,0.255520504731861
2015,50001,143,677,182,469,17,79,199,548,0.0217814698517429,0.363138686131387
2015,50003,78,187,259,792,2,10,261,802,0.0307373907711176,0.325436408977556
2015,50005,118,477,281,651,35,75,316,726,0.0335505337584916,0.435261707988981
2015,50007,541,1481,1615,2271,294,451,1909,2722,0.0262270441099956,0.701322556943424
2015,50009,12,93,22,106,0,2,22,108,0.0230326295585413,0.203703703703704
2015,50011,266,802,174,429,0,35,174,464,0.0138664754049369,0.375
2015,50013,56,182,58,84,0,4,58,88,0.0171239540766686,0.659090909090909
2015,50015,114,322,216,471,57,104,273,575,0.033420517291485,0.474782608695652
2015,50017,177,428,268,483,13,25,281,508,0.0244207287760792,0.553149606299213
2015,50019,75,323,175,417,17,21,192,438,0.0223640541230534,0.438356164383562
2015,50021,114,407,421,929,15,42,436,971,0.0224032116653592,0.449021627188465
2015,50023,296,731,630,962,32,85,662,1047,0.0249333206325014,0.632282712511939
2015,50025,124,371,368,897,40,75,408,972,0.0304826418289585,0.419753086419753
2015,50027,135,716,822,1438,114,117,936,1555,0.0371316681789961,0.601929260450161
2015,51001,64,127,136,411,144,199,280,610,0.0257928118393235,0.459016393442623
2015,51003,1323,2935,1516,1993,492,625,2008,2618,0.0378953463125136,0.766997708174179
2015,51005,37,337,60,145,0,0,60,145,0.0123110884700289,0.413793103448276
2015,51007,18,227,0,103,0,10,0,113,0.0125304945664227,0
2015,51009,47,666,118,338,0,67,118,405,0.0180521506574549,0.291358024691358
2015,51011,4,93,14,110,0,0,14,110,0.0102173509195616,0.127272727272727
2015,51013,4835,6750,10035,11828,2450,3160,12485,14988,0.0889712036756718,0.832999733119829
2015,51015,419,1963,233,483,83,83,316,566,0.0106149547082763,0.558303886925795
2015,51017,1,212,0,23,0,0,0,23,0.00672711319099152,0
2015,51019,753,2340,259,667,45,115,304,782,0.0143207706112881,0.388746803069054
2015,51021,38,469,23,75,0,0,23,75,0.0147695943284758,0.306666666666667
2015,51023,191,719,52,193,0,0,52,193,0.00809224318658281,0.269430051813472
2015,51025,43,517,3,116,0,4,3,120,0.00993377483443709,0.025
2015,51027,35,291,77,231,0,0,77,231,0.0131721503107715,0.333333333333333
2015,51029,60,756,10,94,0,11,10,105,0.00852895784257981,0.0952380952380952
2015,51031,289,1372,170,310,0,29,170,339,0.00877261082214114,0.501474926253687
2015,51033,95,1056,152,396,0,9,152,405,0.0203466465712133,0.375308641975309
2015,51035,26,350,25,167,0,4,25,171,0.00779824881430135,0.146198830409357
2015,51036,32,122,6,54,0,2,6,56,0.0103340099649382,0.107142857142857
2015,51037,12,184,1,51,0,1,1,52,0.00608258275821734,0.0192307692307692
2015,51041,2429,7003,2108,4168,311,802,2419,4970,0.0229307003783335,0.48672032193159
2015,51043,116,387,19,126,0,8,19,134,0.0131514378251055,0.141791044776119
2015,51045,0,102,0,0,0,0,0,0,0,NA
2015,51047,80,1221,323,634,10,39,333,673,0.0208630417260835,0.49479940564636
2015,51049,15,156,0,43,0,11,0,54,0.00794117647058823,0
2015,51051,56,352,0,39,0,0,0,39,0.00350845627923714,0
2015,51053,52,668,12,101,0,11,12,112,0.00572655690765927,0.107142857142857
2015,51057,41,234,18,65,0,11,18,76,0.00970625798212005,0.236842105263158
2015,51059,13070,20221,17907,24883,6811,11763,24718,36646,0.0478093990622334,0.674507449653441
2015,51061,718,2089,268,601,50,83,318,684,0.0149175608479456,0.464912280701754
2015,51063,100,201,90,206,0,30,90,236,0.0209238407660254,0.38135593220339
2015,51065,371,1286,76,276,15,32,91,308,0.0167010085674005,0.295454545454545
2015,51067,276,1348,208,503,0,31,208,534,0.0132063806108569,0.389513108614232
2015,51069,655,2146,465,1085,150,242,615,1327,0.0238578953992197,0.46345139412208
2015,51071,26,167,28,227,0,17,28,244,0.0202003477109032,0.114754098360656
2015,51073,237,822,171,452,43,220,214,672,0.025488336810165,0.318452380952381
2015,51075,155,819,37,166,24,24,61,190,0.0117858693629427,0.321052631578947
2015,51077,18,255,3,59,0,2,3,61,0.0052243919150394,0.0491803278688525
2015,51079,118,613,35,153,0,22,35,175,0.013449123885644,0.2
2015,51081,41,919,2,108,0,0,2,108,0.0122629726354037,0.0185185185185185
2015,51083,118,442,23,249,8,29,31,278,0.0109790292642471,0.111510791366906
2015,51085,1145,2524,438,946,73,130,511,1076,0.0156618439055632,0.474907063197026
2015,51087,3666,10449,2465,4398,982,1776,3447,6174,0.0283962598253175,0.558309037900875
2015,51089,91,896,13,436,0,8,13,444,0.0116312576952296,0.0292792792792793
2015,51091,12,52,4,24,0,0,4,24,0.0133185349611543,0.166666666666667
2015,51093,271,1195,141,362,62,208,203,570,0.0224232887490165,0.356140350877193
2015,51095,856,2187,992,1950,213,294,1205,2244,0.0440397221022883,0.53698752228164
2015,51097,20,164,13,87,0,0,13,87,0.0167018621616433,0.149425287356322
2015,51099,167,835,198,562,5,35,203,597,0.0369865559754662,0.340033500837521
2015,51101,94,384,46,134,0,37,46,171,0.0153102336825141,0.269005847953216
2015,51103,97,251,19,141,8,27,27,168,0.0190757352106279,0.160714285714286
2015,51105,16,239,57,589,0,45,57,634,0.0342721228174496,0.0899053627760252
2015,51107,5544,8402,3588,5932,1097,2686,4685,8618,0.0386176858067234,0.543629612439081
2015,51109,188,1077,139,273,0,49,139,322,0.0132379542838349,0.43167701863354
2015,51111,29,396,0,70,0,14,0,84,0.00920043811610077,0
2015,51113,55,624,80,124,0,0,80,124,0.0133707138235928,0.645161290322581
2015,51115,27,147,11,61,0,0,11,61,0.00896399706098457,0.180327868852459
2015,51117,64,460,161,385,22,42,183,427,0.0184712549206212,0.428571428571429
2015,51119,35,306,51,101,0,0,51,101,0.0122039632672789,0.504950495049505
2015,51121,814,1803,1099,1705,759,909,1858,2614,0.0494991384044386,0.710788064269319
2015,51125,155,309,62,88,17,25,79,113,0.0103803049788719,0.699115044247788
2015,51127,246,995,8,116,12,12,20,128,0.00925457306051623,0.15625
2015,51131,112,257,17,66,0,2,17,68,0.00761222433672898,0.25
2015,51133,135,377,8,67,0,0,8,67,0.00692792885947679,0.119402985074627
2015,51135,266,881,8,103,0,23,8,126,0.011302475780409,0.0634920634920635
2015,51137,428,1501,149,326,10,48,159,374,0.0153461080792745,0.425133689839572
2015,51139,60,381,33,129,24,24,57,153,0.00892752946668223,0.372549019607843
2015,51141,92,628,34,180,0,0,34,180,0.0131023438637356,0.188888888888889
2015,51143,186,1691,66,481,0,20,66,501,0.011004217185029,0.131736526946108
2015,51145,476,1366,60,268,0,26,60,294,0.0145558966234281,0.204081632653061
2015,51147,79,499,158,302,18,52,176,354,0.0274248528044624,0.497175141242938
2015,51149,260,1666,365,1382,120,241,485,1623,0.0636945174836152,0.29882932840419
2015,51153,3991,11769,3593,8216,979,2151,4572,10367,0.0376117431938236,0.441014758367898
2015,51155,147,1022,43,229,32,42,75,271,0.0105942142298671,0.276752767527675
2015,51157,18,90,16,124,0,0,16,124,0.0220326936744847,0.129032258064516
2015,51159,77,387,26,65,0,17,26,82,0.0119013062409289,0.317073170731707
2015,51161,800,3224,605,1512,112,201,717,1713,0.0256141872392601,0.418563922942207
2015,51163,308,569,87,312,36,37,123,349,0.0207639219419324,0.35243553008596
2015,51165,448,1431,290,576,34,87,324,663,0.0125523012552301,0.48868778280543
2015,51167,77,498,34,205,0,63,34,268,0.0131038529239194,0.126865671641791
2015,51169,40,463,38,259,0,12,38,271,0.0162694362730384,0.140221402214022
2015,51171,408,1136,167,833,28,56,195,889,0.0289869249078874,0.219347581552306
2015,51173,58,262,60,307,6,57,66,364,0.015947426067908,0.181318681318681
2015,51175,54,566,22,132,2,32,24,164,0.0122415466149138,0.146341463414634
2015,51177,787,3301,794,1911,90,358,884,2269,0.0271853733346113,0.389598942265315
2015,51179,1282,4088,1685,3577,248,496,1933,4073,0.0474736289993589,0.474588755217285
2015,51181,68,196,24,38,0,0,24,38,0.00768608414239482,0.631578947368421
2015,51183,95,1248,14,61,0,1,14,62,0.00683496858119281,0.225806451612903
2015,51185,121,687,38,670,0,40,38,710,0.0224548530946583,0.0535211267605634
2015,51187,282,1007,124,445,28,40,152,485,0.0183935072815534,0.31340206185567
2015,51191,359,1071,459,1314,41,64,500,1378,0.0346806261639905,0.362844702467344
2015,51193,97,538,70,252,15,44,85,296,0.0232832533626996,0.287162162162162
2015,51195,16,757,60,505,9,43,69,548,0.0194990037005408,0.125912408759124
2015,51197,116,466,0,190,0,30,0,220,0.0103896103896104,0
2015,51199,844,2290,734,1838,247,466,981,2304,0.0524088985942405,0.42578125
2015,51510,4365,7101,6159,8234,1633,2625,7792,10859,0.0954083784353694,0.717561469748596
2015,51520,91,485,123,658,0,5,123,663,0.0535757575757576,0.18552036199095
2015,51530,56,150,29,43,0,0,29,43,0.0104724792985874,0.674418604651163
2015,51540,965,2177,1001,1244,219,489,1220,1733,0.0623314030859979,0.70398153491056
2015,51550,2044,8611,1484,4106,296,659,1780,4765,0.0313235429457935,0.373557187827912
2015,51570,53,622,49,243,21,26,70,269,0.0223069906294054,0.260223048327138
2015,51580,36,310,9,144,0,8,9,152,0.0382293762575453,0.0592105263157895
2015,51590,193,956,183,783,0,18,183,801,0.0274230545379849,0.228464419475655
2015,51595,52,204,0,87,0,39,0,126,0.0320610687022901,0
2015,51600,862,1378,269,345,297,367,566,712,0.0431698296246893,0.794943820224719
2015,51610,294,409,532,668,227,315,759,983,0.108295692409386,0.772126144455748
2015,51620,102,461,0,72,0,16,0,88,0.0154358884406245,0
2015,51630,674,1752,309,905,24,61,333,966,0.060138205814605,0.34472049689441
2015,51640,24,286,1,61,8,8,9,69,0.013775204631663,0.130434782608696
2015,51650,727,4411,666,2217,126,408,792,2625,0.0291883958057665,0.301714285714286
2015,51660,828,2404,349,806,147,318,496,1124,0.0460146559135383,0.441281138790036
2015,51670,159,707,122,286,0,12,122,298,0.0201093191173493,0.409395973154362
2015,51678,69,121,5,49,19,19,24,68,0.0302356602934638,0.352941176470588
2015,51680,815,2770,559,940,149,279,708,1219,0.027936289675719,0.580803937653815
2015,51683,462,1602,75,344,13,129,88,473,0.0183290707587383,0.186046511627907
2015,51685,205,780,41,250,42,186,83,436,0.0440315087861038,0.190366972477064
2015,51690,97,603,18,186,0,7,18,193,0.0202880269105435,0.0932642487046632
2015,51700,1106,5649,1354,4107,311,955,1665,5062,0.0440242820615401,0.328921374950612
2015,51710,1980,7216,2198,6087,416,904,2614,6991,0.0468968015455619,0.373909311972536
2015,51720,16,218,37,107,0,0,37,107,0.0401350337584396,0.345794392523364
2015,51730,216,1272,125,470,126,202,251,672,0.0305177111716621,0.373511904761905
2015,51735,93,310,90,142,0,19,90,161,0.0191279553285018,0.559006211180124
2015,51740,784,3783,337,1407,41,98,378,1505,0.0237396681178623,0.251162790697674
2015,51750,85,642,41,131,0,0,41,131,0.0186503416856492,0.312977099236641
2015,51760,3331,8759,2309,4086,303,663,2612,4749,0.0331541468863446,0.550010528532323
2015,51770,709,3674,681,1765,60,267,741,2032,0.0296114948558771,0.364665354330709
2015,51775,310,1252,92,299,126,171,218,470,0.0278304121269541,0.463829787234043
2015,51790,295,1442,118,296,9,9,127,305,0.0177583697234352,0.416393442622951
2015,51800,677,2337,613,1373,126,233,739,1606,0.0281403865360691,0.460149439601494
2015,51810,2446,9566,3994,10121,877,2157,4871,12278,0.041176056314411,0.396725851115817
2015,51820,174,922,112,167,0,0,112,167,0.0114737203710065,0.67065868263473
2015,51830,343,918,174,288,62,100,236,388,0.0537172919839402,0.608247422680412
2015,51840,494,1556,227,689,11,41,238,730,0.040743428029246,0.326027397260274
2015,53001,44,229,26,121,0,7,26,128,0.0122347543490728,0.203125
2015,53003,49,181,141,790,0,5,141,795,0.0509974982359356,0.177358490566038
2015,53005,1144,3750,983,2663,439,720,1422,3383,0.0285670857857004,0.420336979012711
2015,53007,425,1625,178,458,33,159,211,617,0.0124570967090652,0.341977309562399
2015,53009,301,1004,463,1629,13,117,476,1746,0.0321861116743783,0.27262313860252
2015,53011,723,3746,3585,12097,355,1245,3940,13342,0.0453743160014012,0.295308049767651
2015,53013,29,107,4,43,5,5,9,48,0.016271186440678,0.1875
2015,53015,248,1392,329,1320,39,98,368,1418,0.0202141156680779,0.259520451339915
2015,53017,214,1010,155,492,20,50,175,542,0.0210191576824634,0.322878228782288
2015,53019,33,224,11,127,0,6,11,133,0.0237967436035069,0.0827067669172932
2015,53021,582,2747,215,700,0,97,215,797,0.0162609919817191,0.269761606022585
2015,53023,8,9,9,71,0,0,9,71,0.0429262394195889,0.126760563380282
2015,53025,296,1541,101,818,12,426,113,1244,0.0225939446775277,0.0908360128617363
2015,53027,222,2165,148,725,3,110,151,835,0.0164850351417516,0.180838323353293
2015,53029,549,1874,644,2735,185,435,829,3170,0.0559132198606579,0.261514195583596
2015,53031,352,1099,456,1085,56,94,512,1179,0.0486868186323092,0.434266327396098
2015,53033,7784,23077,27508,44564,12074,17972,39582,62536,0.0435649165045243,0.632947422284764
2015,53035,1412,3952,2756,6627,620,1202,3376,7829,0.0450131376956999,0.431217269127602
2015,53037,356,1452,331,753,64,105,395,858,0.0342200773740677,0.46037296037296
2015,53039,107,205,97,242,2,21,99,263,0.0175731658425765,0.376425855513308
2015,53041,403,2374,123,970,2,158,125,1128,0.0215029166190095,0.110815602836879
2015,53043,30,259,22,99,3,16,25,115,0.0154134834472591,0.217391304347826
2015,53045,351,2420,121,865,8,138,129,1003,0.0226610334154222,0.128614157527418
2015,53047,184,637,124,280,21,73,145,353,0.0123647062944411,0.410764872521246
2015,53049,72,443,108,381,0,25,108,406,0.0258401221995927,0.266009852216749
2015,53051,14,313,60,284,0,18,60,302,0.0313278008298755,0.198675496688742
2015,53053,3160,15513,5350,13986,1268,3848,6618,17834,0.0329211877766661,0.371088931254906
2015,53055,140,309,225,389,20,41,245,430,0.0335308796007486,0.569767441860465
2015,53057,850,3097,647,1890,160,397,807,2287,0.0278332197449129,0.352864013992129
2015,53059,28,216,37,210,11,30,48,240,0.0298804780876494,0.2
2015,53061,5671,17259,3540,10536,932,2399,4472,12935,0.0255269685960069,0.34572864321608
2015,53063,1441,6264,2707,8104,346,1010,3053,9114,0.0284306966674881,0.334979152951503
2015,53065,86,867,113,579,50,156,163,735,0.0238620868774755,0.221768707482993
2015,53067,1830,7333,2170,5151,677,1820,2847,6971,0.0386551919173996,0.408406254482858
2015,53069,10,82,8,22,0,0,8,22,0.00718015665796345,0.363636363636364
2015,53071,316,1863,275,807,53,81,328,888,0.0229510738931534,0.369369369369369
2015,53073,543,2316,1000,2455,467,849,1467,3304,0.0245809557111291,0.444007263922518
2015,53075,380,952,686,1215,236,317,922,1532,0.0682374949890873,0.601827676240209
2015,53077,392,1939,632,2116,185,559,817,2675,0.0180648036845446,0.305420560747664
2015,54001,14,207,17,202,0,0,17,202,0.0177224074399017,0.0841584158415842
2015,54003,262,1405,540,3113,0,50,540,3163,0.043053929708981,0.170723996206133
2015,54005,39,341,8,247,10,22,18,269,0.0160080933111164,0.0669144981412639
2015,54007,63,471,7,121,7,21,14,142,0.0136250239877183,0.0985915492957746
2015,54009,71,245,62,466,0,0,62,466,0.027533234859675,0.133047210300429
2015,54011,419,1711,595,1942,25,129,620,2071,0.0319653027520104,0.299372283920811
2015,54013,72,190,17,55,0,0,17,55,0.010064043915828,0.309090909090909
2015,54015,0,88,0,10,0,12,0,22,0.00342252644679527,0
2015,54017,29,408,55,187,0,0,55,187,0.0316949152542373,0.294117647058824
2015,54019,44,458,39,195,6,14,45,209,0.00638051044083527,0.215311004784689
2015,54021,52,346,81,347,8,34,89,381,0.0625307730182176,0.233595800524934
2015,54023,0,178,3,116,0,39,3,155,0.0180379378563947,0.0193548387096774
2015,54025,88,428,200,649,59,59,259,708,0.0272318166083311,0.365819209039548
2015,54027,63,368,13,315,0,0,13,315,0.0185556079170594,0.0412698412698413
2015,54029,102,382,151,723,7,41,158,764,0.0344314750552075,0.206806282722513
2015,54031,0,144,53,244,0,44,53,288,0.0284444444444444,0.184027777777778
2015,54033,79,774,215,830,11,27,226,857,0.0175373974256656,0.263710618436406
2015,54035,117,612,50,222,11,18,61,240,0.0116267803507412,0.254166666666667
2015,54037,98,425,456,1782,48,85,504,1867,0.0501881720430108,0.269951794322442
2015,54039,563,2517,702,1943,105,206,807,2149,0.0157267684381541,0.375523499302001
2015,54041,48,368,43,179,8,8,51,187,0.0158179665031298,0.272727272727273
2015,54043,3,348,34,162,0,3,34,165,0.0109170305676856,0.206060606060606
2015,54045,63,433,7,282,43,43,50,325,0.0126439464674759,0.153846153846154
2015,54047,0,268,15,267,0,42,15,309,0.0201683963187781,0.0485436893203883
2015,54049,177,759,185,631,0,41,185,672,0.0172462466315925,0.275297619047619
2015,54051,28,406,46,198,9,28,55,226,0.00964698851752252,0.243362831858407
2015,54053,60,379,66,448,0,0,66,448,0.0229778940349797,0.147321428571429
2015,54055,21,419,172,957,51,75,223,1032,0.0236941797727012,0.216085271317829
2015,54057,2,155,17,121,2,2,19,123,0.00633530775173835,0.154471544715447
2015,54059,26,182,28,274,0,53,28,327,0.0178698289524018,0.0856269113149847
2015,54061,361,1011,1344,2163,258,308,1602,2471,0.040808574590015,0.648320518008903
2015,54063,75,286,23,206,38,45,61,251,0.0253356212778843,0.243027888446215
2015,54065,48,121,55,582,4,4,59,586,0.0455534825870647,0.100682593856655
2015,54067,53,285,14,327,0,0,14,327,0.0175919948353777,0.0428134556574924
2015,54069,91,359,392,855,28,72,420,927,0.0303546285078097,0.453074433656958
2015,54071,20,75,7,50,0,0,7,50,0.00905797101449275,0.14
2015,54073,5,506,4,76,0,0,4,76,0.0137308039747064,0.0526315789473684
2015,54075,21,271,24,100,4,4,28,104,0.0157814871016692,0.269230769230769
2015,54077,81,533,107,419,13,70,120,489,0.0197527872031023,0.245398773006135
2015,54079,262,824,79,274,11,42,90,316,0.00795769327625283,0.284810126582278
2015,54081,228,1769,149,967,6,148,155,1115,0.0199541859050073,0.139013452914798
2015,54083,112,783,62,149,0,12,62,161,0.00760043431053203,0.385093167701863
2015,54085,34,87,24,97,0,0,24,97,0.013285851253253,0.247422680412371
2015,54087,63,321,2,75,8,14,10,89,0.00851185921958684,0.112359550561798
2015,54089,29,363,61,457,0,25,61,482,0.0467643349180169,0.12655601659751
2015,54091,29,410,24,109,9,28,33,137,0.0112028784037943,0.240875912408759
2015,54093,15,108,3,69,0,0,3,69,0.0132488479262673,0.0434782608695652
2015,54095,34,99,0,117,0,42,0,159,0.0243230839834787,0
2015,54097,27,266,58,297,0,10,58,307,0.0184251590445325,0.188925081433225
2015,54099,102,555,126,469,11,16,137,485,0.0166460735859418,0.282474226804124
2015,54101,54,197,17,77,0,0,17,77,0.0118516238263814,0.220779220779221
2015,54103,16,136,7,82,0,10,7,92,0.00790106492614222,0.0760869565217391
2015,54105,0,9,0,7,0,0,0,7,0.00169573643410853,0
2015,54107,171,677,196,1232,0,63,196,1295,0.0211128682524414,0.151351351351351
2015,54109,5,130,15,43,0,0,15,43,0.00264566541561558,0.348837209302326
2015,55001,91,603,46,352,4,54,50,406,0.025119099177133,0.123152709359606
2015,55003,48,336,77,148,0,23,77,171,0.0158186864014801,0.450292397660819
2015,55005,160,1058,67,324,24,38,91,362,0.0111669802881204,0.251381215469613
2015,55007,82,271,84,173,2,4,86,177,0.0154625666113392,0.485875706214689
2015,55009,804,3647,1167,2289,167,341,1334,2630,0.0156490797984065,0.50722433460076
2015,55011,58,203,10,127,0,5,10,132,0.0138495435945861,0.0757575757575758
2015,55013,19,219,93,318,5,8,98,326,0.0280237256081836,0.300613496932515
2015,55015,419,1116,60,167,37,55,97,222,0.00670229145910697,0.436936936936937
2015,55017,236,2173,73,288,95,95,168,383,0.00870078829596311,0.438642297650131
2015,55019,62,523,22,111,10,48,32,159,0.00730597803611634,0.20125786163522
2015,55021,247,1592,144,406,18,51,162,457,0.0115017743437445,0.354485776805252
2015,55023,28,480,79,275,2,27,81,302,0.0254873829015107,0.268211920529801
2015,55025,2685,6980,5161,8333,1266,1961,6427,10294,0.0309422755527768,0.624344278220323
2015,55027,457,3108,181,764,5,45,186,809,0.0128349542288715,0.22991347342398
2015,55029,204,383,200,507,9,18,209,525,0.0245407376244566,0.398095238095238
2015,55031,80,262,258,1001,23,90,281,1091,0.0357236411263916,0.25756186984418
2015,55033,236,967,112,373,0,63,112,436,0.0162371517950246,0.256880733944954
2015,55035,456,1651,453,910,44,142,497,1052,0.0166994729824116,0.472433460076046
2015,55037,14,113,4,51,2,17,6,68,0.0195458465076171,0.0882352941176471
2015,55039,331,1824,240,574,171,222,411,796,0.0113145326358881,0.516331658291457
2015,55041,15,152,20,55,2,7,22,62,0.00959306823456599,0.354838709677419
2015,55043,163,873,125,291,29,95,154,386,0.0121448573136582,0.398963730569948
2015,55045,252,872,145,348,7,16,152,364,0.0141052468418197,0.417582417582418
2015,55047,90,463,19,103,0,19,19,122,0.00908752327746741,0.155737704918033
2015,55049,107,479,61,142,20,59,81,201,0.0121106224016389,0.402985074626866
2015,55051,25,109,41,125,0,6,41,131,0.0280814576634512,0.312977099236641
2015,55053,125,932,14,128,0,8,14,136,0.00941111341775656,0.102941176470588
2015,55055,464,1838,169,517,89,144,258,661,0.0116697856714099,0.390317700453858
2015,55057,106,820,47,308,0,11,47,319,0.016640584246218,0.147335423197492
2015,55059,510,2058,797,3142,59,156,856,3298,0.0300293191047657,0.259551243177683
2015,55061,44,266,50,92,30,89,80,181,0.0125598501144959,0.441988950276243
2015,55063,483,1576,664,1368,104,198,768,1566,0.0211965349214943,0.490421455938697
2015,55065,71,352,17,152,4,26,21,178,0.0156593648280109,0.117977528089888
2015,55067,89,590,43,95,30,43,73,138,0.00963619858948397,0.528985507246377
2015,55069,91,595,46,154,0,2,46,156,0.00756070372703921,0.294871794871795
2015,55071,288,791,137,406,4,35,141,441,0.00771761576423646,0.319727891156463
2015,55073,421,1970,598,1189,70,205,668,1394,0.0150864168136708,0.479196556671449
2015,55075,68,461,45,412,5,38,50,450,0.0149640861931365,0.111111111111111
2015,55077,73,465,13,106,0,13,13,119,0.0106079515065074,0.109243697478992
2015,55078,16,99,5,29,0,0,5,29,0.0114760585674713,0.172413793103448
2015,55079,4594,10898,4347,9354,1150,2426,5497,11780,0.0189924336594937,0.466638370118846
2015,55081,125,798,174,627,22,53,196,680,0.0223390275952694,0.288235294117647
2015,55083,106,722,50,162,0,24,50,186,0.00685865998008776,0.268817204301075
2015,55085,140,561,120,393,13,17,133,410,0.0151459179903953,0.324390243902439
2015,55087,1193,4359,717,1300,131,293,848,1593,0.013203043413397,0.5323289391086
2015,55089,991,2056,507,882,64,134,571,1016,0.0168256491785904,0.562007874015748
2015,55091,43,161,17,58,0,2,17,60,0.0115163147792706,0.283333333333333
2015,55093,120,529,151,426,16,35,167,461,0.0181481773088733,0.362255965292842
2015,55095,158,610,137,563,12,76,149,639,0.0207044033308492,0.233176838810642
2015,55097,267,1273,154,460,38,60,192,520,0.0116869690295321,0.369230769230769
2015,55099,41,274,38,141,0,10,38,151,0.0142372242127098,0.251655629139073
2015,55101,844,3556,433,1436,69,164,502,1600,0.0121489153296532,0.31375
2015,55103,57,362,26,78,8,14,34,92,0.00742774099790086,0.369565217391304
2015,55105,384,1861,775,1875,60,109,835,1984,0.0183693498509342,0.420866935483871
2015,55107,79,325,20,110,0,33,20,143,0.0138351393188854,0.13986013986014
2015,55109,159,977,593,1808,52,90,645,1898,0.0331054210563036,0.339831401475237
2015,55111,272,1252,187,543,11,37,198,580,0.0132735261808861,0.341379310344828
2015,55113,88,295,76,210,2,4,78,214,0.0176611372451927,0.364485981308411
2015,55115,161,1043,62,209,0,12,62,221,0.00750449930388129,0.280542986425339
2015,55117,387,1950,280,878,41,147,321,1025,0.0128856259271365,0.313170731707317
2015,55119,97,325,35,136,0,23,35,159,0.0111516341702904,0.220125786163522
2015,55121,95,439,48,171,0,24,48,195,0.00967213927880562,0.246153846153846
2015,55123,100,454,46,163,7,15,53,178,0.00875165937361719,0.297752808988764
2015,55125,115,442,129,294,6,27,135,321,0.0194309927360775,0.420560747663551
2015,55127,355,1543,636,1745,27,112,663,1857,0.0276298169915191,0.35702746365105
2015,55129,75,311,49,187,15,41,64,228,0.0194655510970716,0.280701754385965
2015,55131,817,2559,218,913,79,172,297,1085,0.0117345504098981,0.273732718894009
2015,55133,3299,8503,2135,3764,306,610,2441,4374,0.0159272314145887,0.558070416095107
2015,55135,348,1325,58,353,51,105,109,458,0.0123254124169111,0.237991266375546
2015,55137,94,825,63,146,7,29,70,175,0.00964453017360154,0.4
2015,55139,1034,4886,515,1221,74,183,589,1404,0.0124638247252455,0.41951566951567
2015,55141,327,1353,187,451,7,61,194,512,0.00981783317353787,0.37890625
2015,56001,165,330,403,1202,121,146,524,1348,0.0666073722699872,0.388724035608309
2015,56003,32,212,18,210,2,7,20,217,0.0272853011442223,0.0921658986175115
2015,56005,196,639,120,1603,60,62,180,1665,0.0551726423222215,0.108108108108108
2015,56007,83,312,114,377,0,36,114,413,0.0386486992326408,0.276029055690073
2015,56009,81,322,61,185,0,0,61,185,0.0194962588260091,0.32972972972973
2015,56011,12,121,27,165,0,0,27,165,0.0325893738889986,0.163636363636364
2015,56013,95,720,186,806,0,27,186,833,0.0308301565564973,0.223289315726291
2015,56015,69,313,140,372,0,0,140,372,0.0393151553582752,0.376344086021505
2015,56017,29,115,64,240,3,16,67,256,0.0728307254623044,0.26171875
2015,56019,9,178,62,66,0,23,62,89,0.0147034528333058,0.696629213483146
2015,56021,239,760,1023,3037,42,165,1065,3202,0.0505422000536675,0.332604622111181
2015,56023,30,380,158,653,0,10,158,663,0.0547571853320119,0.238310708898944
2015,56025,202,1216,801,1826,45,193,846,2019,0.0377785678199203,0.419019316493314
2015,56027,3,83,13,71,0,5,13,76,0.0408163265306122,0.171052631578947
2015,56029,57,247,223,619,1,9,224,628,0.0308417640703271,0.356687898089172
2015,56031,45,224,68,242,0,30,68,272,0.0427471318560427,0.25
2015,56033,110,508,316,711,5,5,321,716,0.0343092625425272,0.448324022346369
2015,56035,51,179,117,585,40,40,157,625,0.0897343862167983,0.2512
2015,56037,111,362,348,1391,16,56,364,1447,0.0507683671321311,0.251554941257775
2015,56039,91,293,387,747,1,10,388,757,0.0449979195149498,0.512549537648613
2015,56041,87,431,150,521,35,36,185,557,0.0427573501189836,0.33213644524237
2015,56043,8,108,64,107,7,7,71,114,0.0196011004126547,0.62280701754386
2015,56045,4,263,8,108,0,0,8,108,0.0210813976185829,0.0740740740740741
2015,72001,NA,NA,NA,NA,NA,NA,NA,NA,NA,NA
2015,72003,NA,NA,NA,NA,NA,NA,NA,NA,NA,NA
2015,72005,NA,NA,NA,NA,NA,NA,NA,NA,NA,NA
2015,72007,NA,NA,NA,NA,NA,NA,NA,NA,NA,NA
2015,72009,NA,NA,NA,NA,NA,NA,NA,NA,NA,NA
2015,72011,NA,NA,NA,NA,NA,NA,NA,NA,NA,NA
2015,72013,NA,NA,NA,NA,NA,NA,NA,NA,NA,NA
2015,72015,NA,NA,NA,NA,NA,NA,NA,NA,NA,NA
2015,72017,NA,NA,NA,NA,NA,NA,NA,NA,NA,NA
2015,72019,NA,NA,NA,NA,NA,NA,NA,NA,NA,NA
2015,72021,NA,NA,NA,NA,NA,NA,NA,NA,NA,NA
2015,72023,NA,NA,NA,NA,NA,NA,NA,NA,NA,NA
2015,72025,NA,NA,NA,NA,NA,NA,NA,NA,NA,NA
2015,72027,NA,NA,NA,NA,NA,NA,NA,NA,NA,NA
2015,72029,NA,NA,NA,NA,NA,NA,NA,NA,NA,NA
2015,72031,NA,NA,NA,NA,NA,NA,NA,NA,NA,NA
2015,72033,NA,NA,NA,NA,NA,NA,NA,NA,NA,NA
2015,72035,NA,NA,NA,NA,NA,NA,NA,NA,NA,NA
2015,72037,NA,NA,NA,NA,NA,NA,NA,NA,NA,NA
2015,72039,NA,NA,NA,NA,NA,NA,NA,NA,NA,NA
2015,72041,NA,NA,NA,NA,NA,NA,NA,NA,NA,NA
2015,72043,NA,NA,NA,NA,NA,NA,NA,NA,NA,NA
2015,72045,NA,NA,NA,NA,NA,NA,NA,NA,NA,NA
2015,72047,NA,NA,NA,NA,NA,NA,NA,NA,NA,NA
2015,72049,NA,NA,NA,NA,NA,NA,NA,NA,NA,NA
2015,72051,NA,NA,NA,NA,NA,NA,NA,NA,NA,NA
2015,72053,NA,NA,NA,NA,NA,NA,NA,NA,NA,NA
2015,72054,NA,NA,NA,NA,NA,NA,NA,NA,NA,NA
2015,72055,NA,NA,NA,NA,NA,NA,NA,NA,NA,NA
2015,72057,NA,NA,NA,NA,NA,NA,NA,NA,NA,NA
2015,72059,NA,NA,NA,NA,NA,NA,NA,NA,NA,NA
2015,72061,NA,NA,NA,NA,NA,NA,NA,NA,NA,NA
2015,72063,NA,NA,NA,NA,NA,NA,NA,NA,NA,NA
2015,72065,NA,NA,NA,NA,NA,NA,NA,NA,NA,NA
2015,72067,NA,NA,NA,NA,NA,NA,NA,NA,NA,NA
2015,72069,NA,NA,NA,NA,NA,NA,NA,NA,NA,NA
2015,72071,NA,NA,NA,NA,NA,NA,NA,NA,NA,NA
2015,72073,NA,NA,NA,NA,NA,NA,NA,NA,NA,NA
2015,72075,NA,NA,NA,NA,NA,NA,NA,NA,NA,NA
2015,72077,NA,NA,NA,NA,NA,NA,NA,NA,NA,NA
2015,72079,NA,NA,NA,NA,NA,NA,NA,NA,NA,NA
2015,72081,NA,NA,NA,NA,NA,NA,NA,NA,NA,NA
2015,72083,NA,NA,NA,NA,NA,NA,NA,NA,NA,NA
2015,72085,NA,NA,NA,NA,NA,NA,NA,NA,NA,NA
2015,72087,NA,NA,NA,NA,NA,NA,NA,NA,NA,NA
2015,72089,NA,NA,NA,NA,NA,NA,NA,NA,NA,NA
2015,72091,NA,NA,NA,NA,NA,NA,NA,NA,NA,NA
2015,72093,NA,NA,NA,NA,NA,NA,NA,NA,NA,NA
2015,72095,NA,NA,NA,NA,NA,NA,NA,NA,NA,NA
2015,72097,NA,NA,NA,NA,NA,NA,NA,NA,NA,NA
2015,72099,NA,NA,NA,NA,NA,NA,NA,NA,NA,NA
2015,72101,NA,NA,NA,NA,NA,NA,NA,NA,NA,NA
2015,72103,NA,NA,NA,NA,NA,NA,NA,NA,NA,NA
2015,72105,NA,NA,NA,NA,NA,NA,NA,NA,NA,NA
2015,72107,NA,NA,NA,NA,NA,NA,NA,NA,NA,NA
2015,72109,NA,NA,NA,NA,NA,NA,NA,NA,NA,NA
2015,72111,NA,NA,NA,NA,NA,NA,NA,NA,NA,NA
2015,72113,NA,NA,NA,NA,NA,NA,NA,NA,NA,NA
2015,72115,NA,NA,NA,NA,NA,NA,NA,NA,NA,NA
2015,72117,NA,NA,NA,NA,NA,NA,NA,NA,NA,NA
2015,72119,NA,NA,NA,NA,NA,NA,NA,NA,NA,NA
2015,72121,NA,NA,NA,NA,NA,NA,NA,NA,NA,NA
2015,72123,NA,NA,NA,NA,NA,NA,NA,NA,NA,NA
2015,72125,NA,NA,NA,NA,NA,NA,NA,NA,NA,NA
2015,72127,NA,NA,NA,NA,NA,NA,NA,NA,NA,NA
2015,72129,NA,NA,NA,NA,NA,NA,NA,NA,NA,NA
2015,72131,NA,NA,NA,NA,NA,NA,NA,NA,NA,NA
2015,72133,NA,NA,NA,NA,NA,NA,NA,NA,NA,NA
2015,72135,NA,NA,NA,NA,NA,NA,NA,NA,NA,NA
2015,72137,NA,NA,NA,NA,NA,NA,NA,NA,NA,NA
2015,72139,NA,NA,NA,NA,NA,NA,NA,NA,NA,NA
2015,72141,NA,NA,NA,NA,NA,NA,NA,NA,NA,NA
2015,72143,NA,NA,NA,NA,NA,NA,NA,NA,NA,NA
2015,72145,NA,NA,NA,NA,NA,NA,NA,NA,NA,NA
2015,72147,NA,NA,NA,NA,NA,NA,NA,NA,NA,NA
2015,72149,NA,NA,NA,NA,NA,NA,NA,NA,NA,NA
2015,72151,NA,NA,NA,NA,NA,NA,NA,NA,NA,NA
2015,72153,NA,NA,NA,NA,NA,NA,NA,NA,NA,NA
2016,01001,619,1785,533,945,20,63,553,1008,0.0276421872429112,0.548611111111111
2016,01003,1033,2893,1569,4122,105,319,1674,4441,0.0317336687007846,0.376942130150867
2016,01005,31,725,26,158,0,57,26,215,0.0116930439984772,0.12093023255814
2016,01007,65,1266,0,107,22,36,22,143,0.00907936507936508,0.153846153846154
2016,01009,150,1127,123,446,7,72,130,518,0.0131232265910012,0.250965250965251
2016,01011,0,177,0,105,0,30,0,135,0.0184099277239875,0
2016,01013,43,255,23,77,9,70,32,147,0.0105383898487347,0.217687074829932
2016,01015,381,2380,327,1068,35,158,362,1226,0.0155858684735765,0.295269168026101
2016,01017,116,678,118,326,20,29,138,355,0.014882200050306,0.388732394366197
2016,01019,97,309,13,232,3,28,16,260,0.0139082058414465,0.0615384615384615
2016,01021,138,727,84,431,25,49,109,480,0.0161425929039852,0.227083333333333
2016,01023,45,151,35,162,4,11,39,173,0.0183107535986452,0.225433526011561
2016,01025,11,133,19,152,0,20,19,172,0.0101045705557514,0.11046511627907
2016,01027,3,179,0,60,12,25,12,85,0.00899851789117087,0.141176470588235
2016,01029,27,303,0,228,0,16,0,244,0.0235384912213004,0
2016,01031,218,1135,450,1405,144,251,594,1656,0.0478419136765471,0.358695652173913
2016,01033,306,1156,102,475,17,68,119,543,0.0141882887826291,0.219152854511971
2016,01035,0,59,0,29,0,5,0,34,0.00386012715712988,0
2016,01037,16,434,0,0,0,44,0,44,0.00556468951561907,0
2016,01039,73,712,19,276,0,8,19,284,0.010720217424128,0.0669014084507042
2016,01041,28,262,0,120,0,18,0,138,0.0144487488221129,0
2016,01043,131,1034,135,415,0,81,135,496,0.00880634909362072,0.272177419354839
2016,01045,86,1110,586,2145,21,155,607,2300,0.0689386446063004,0.263913043478261
2016,01047,28,647,11,319,39,83,50,402,0.0148679636067756,0.124378109452736
2016,01049,187,1192,69,724,23,61,92,785,0.0165472175379427,0.117197452229299
2016,01051,414,3516,356,804,163,211,519,1015,0.0184713375796178,0.511330049261084
2016,01053,15,476,55,311,0,0,55,311,0.0120720440959553,0.176848874598071
2016,01055,335,2025,202,830,30,217,232,1047,0.014603325150636,0.221585482330468
2016,01057,76,311,0,87,0,27,0,114,0.00965610706420464,0
2016,01059,53,883,14,312,2,143,16,455,0.0217412079510703,0.0351648351648352
2016,01061,46,383,110,346,0,9,110,355,0.0188779579898963,0.309859154929577
2016,01063,32,123,35,59,0,0,35,59,0.00989103101424979,0.593220338983051
2016,01065,35,217,0,59,0,21,0,80,0.00782090135888161,0
2016,01067,57,408,33,214,3,27,36,241,0.0197201538335652,0.149377593360996
2016,01069,275,1333,454,1750,32,106,486,1856,0.0262246902067172,0.261853448275862
2016,01071,61,477,71,391,1,12,72,403,0.0108569735176055,0.178660049627792
2016,01073,3509,9965,3910,7913,570,1215,4480,9128,0.0204619174753473,0.49079754601227
2016,01075,35,302,3,131,0,0,3,131,0.0131026205241048,0.0229007633587786
2016,01077,295,1467,168,1236,74,195,242,1431,0.0226610502312029,0.16911250873515
2016,01079,89,572,33,83,5,22,38,105,0.00448200793955692,0.361904761904762
2016,01081,1154,2976,1812,3559,340,559,2152,4118,0.0457052797478329,0.522583778533269
2016,01083,520,2867,309,1148,58,82,367,1230,0.0198271971113547,0.298373983739837
2016,01085,7,210,0,27,0,7,0,34,0.00474528960223308,0
2016,01087,53,315,50,123,30,45,80,168,0.013533107781537,0.476190476190476
2016,01089,1510,3856,3258,6723,514,969,3772,7692,0.0324733715820003,0.490379615184607
2016,01091,29,265,14,86,2,54,16,140,0.0102346662767746,0.114285714285714
2016,01093,114,800,112,326,0,57,112,383,0.0177825239112267,0.29242819843342
2016,01095,319,1923,135,963,3,45,138,1008,0.0159075845090427,0.136904761904762
2016,01097,583,2279,1449,4552,309,792,1758,5344,0.0194402913133474,0.328967065868263
2016,01099,0,255,7,106,0,4,7,110,0.00738602027798294,0.0636363636363636
2016,01101,1269,4991,1701,3580,563,951,2264,4531,0.0301921744229437,0.499668947252262
2016,01103,497,2259,340,1033,9,44,349,1077,0.013128862774737,0.324048282265552
2016,01105,3,121,63,94,0,7,63,101,0.017000504965494,0.623762376237624
2016,01107,12,348,28,304,7,36,35,340,0.0241408690712866,0.102941176470588
2016,01109,117,401,98,240,38,61,136,301,0.0153430522989092,0.451827242524917
2016,01111,3,116,44,391,0,0,44,391,0.0250657093403423,0.112531969309463
2016,01113,9,836,466,2611,109,251,575,2862,0.0742065961418793,0.200908455625437
2016,01115,518,2864,79,608,9,33,88,641,0.0106737269790522,0.137285491419657
2016,01117,2329,5978,1577,2854,154,309,1731,3163,0.0227526129897782,0.547265254505217
2016,01119,10,114,36,87,0,0,36,87,0.0105097849722155,0.413793103448276
2016,01121,213,2077,93,737,0,100,93,837,0.0149482971085671,0.111111111111111
2016,01123,69,547,111,322,0,3,111,325,0.011241784849533,0.341538461538462
2016,01125,928,3207,1013,2199,174,423,1187,2622,0.0212902440014616,0.452707856598017
2016,01127,181,1129,66,557,0,55,66,612,0.0134113470514759,0.107843137254902
2016,01129,22,229,20,78,1,2,21,80,0.00694203401596668,0.2625
2016,01131,39,213,1,11,0,20,1,31,0.00416610670608789,0.032258064516129
2016,01133,43,361,0,117,0,0,0,117,0.00677318513372699,0
2016,02013,7,46,14,193,3,31,17,224,0.0880157170923379,0.0758928571428571
2016,02016,33,93,57,379,16,128,73,507,0.122080423790031,0.143984220907298
2016,02020,873,3522,3123,7266,526,1291,3649,8557,0.0447001791768313,0.426434498071754
2016,02050,28,266,18,83,2,3,20,86,0.00904977375565611,0.232558139534884
2016,02060,1,37,13,28,0,0,13,28,0.0431432973805855,0.464285714285714
2016,02068,54,94,39,129,11,11,50,140,0.0931470392548237,0.357142857142857
2016,02070,44,113,33,47,4,4,37,51,0.0180594900849858,0.725490196078431
2016,02090,184,1180,1264,3793,306,937,1570,4730,0.0772610705476879,0.331923890063425
2016,02100,30,67,5,33,0,18,5,51,0.0276123443421765,0.0980392156862745
2016,02105,13,50,10,35,11,13,21,48,0.0303989867004433,0.4375
2016,02110,114,330,345,964,28,111,373,1075,0.0482322325915291,0.346976744186047
2016,02122,226,1093,348,1213,7,58,355,1271,0.0321462896454044,0.279307631785995
2016,02130,42,164,78,404,33,71,111,475,0.0503818413237166,0.233684210526316
2016,02150,83,169,124,384,165,190,289,574,0.0637919537675039,0.503484320557491
2016,02158,15,105,27,59,0,0,27,59,0.0156374238006891,0.457627118644068
2016,02164,0,32,5,7,4,4,9,11,0.0131736526946108,0.818181818181818
2016,02170,405,2477,450,1760,37,225,487,1985,0.0316304417107528,0.245340050377834
2016,02180,36,137,91,182,15,17,106,199,0.0368109507954125,0.532663316582915
2016,02185,39,336,42,258,0,25,42,283,0.044792655903767,0.148409893992933
2016,02188,14,71,69,119,0,0,69,119,0.0294408708560119,0.579831932773109
2016,02195,17,36,6,52,2,12,8,64,0.0302600472813239,0.125
2016,02198,7,95,41,150,0,0,41,150,0.0346820809248555,0.273333333333333
2016,02220,50,351,152,355,4,33,156,388,0.0616264294790343,0.402061855670103
2016,02230,2,58,20,53,5,6,25,59,0.0731102850061958,0.423728813559322
2016,02240,49,234,46,149,17,33,63,182,0.0404894327030033,0.346153846153846
2016,02261,40,160,176,405,0,84,176,489,0.0780526735833998,0.359918200408998
2016,02275,29,43,17,38,6,8,23,46,0.0260328239954726,0.5
2016,02282,5,15,18,29,0,0,18,29,0.0643015521064302,0.620689655172414
2016,02290,16,74,37,81,7,29,44,110,0.0310646709968935,0.4
2016,04001,96,1076,157,432,46,108,203,540,0.0123691504226126,0.375925925925926
2016,04003,323,3699,1375,3839,261,845,1636,4684,0.0531240430527044,0.349274124679761
2016,04005,728,2307,1088,2303,235,299,1323,2602,0.032394611687956,0.508455034588778
2016,04007,348,1902,244,927,121,173,365,1100,0.0285291905490572,0.331818181818182
2016,04009,91,1254,154,675,52,165,206,840,0.0365280918420595,0.245238095238095
2016,04011,49,291,21,152,0,18,21,170,0.0294525294525295,0.123529411764706
2016,04012,34,185,99,486,0,58,99,544,0.0353959268657688,0.181985294117647
2016,04013,6394,21787,37358,92762,7169,17528,44527,110290,0.0412698650281955,0.403726539124127
2016,04015,320,3233,1825,10795,183,674,2008,11469,0.0754991475159471,0.175080652192868
2016,04017,388,3254,304,1090,29,165,333,1255,0.0184382575479321,0.265338645418327
2016,04019,2090,8532,8947,20951,2038,4719,10985,25670,0.0387247825030963,0.427931437475652
2016,04021,2572,14248,2901,12663,713,3482,3614,16145,0.0598370741542384,0.223846392071849
2016,04023,120,492,108,532,77,365,185,897,0.0311653116531165,0.206243032329989
2016,04025,1372,5128,1996,6926,148,458,2144,7384,0.0445745676254867,0.29035752979415
2016,04027,334,1870,1213,4875,284,1982,1497,6857,0.0543038385694261,0.218317048271839
2016,05001,21,225,8,154,0,15,8,169,0.0132601020007846,0.0473372781065089
2016,05003,39,116,2,154,0,28,2,182,0.0126944270070447,0.010989010989011
2016,05005,69,828,172,784,0,53,172,837,0.0266263718784794,0.205495818399044
2016,05007,1108,3402,2153,5424,940,1438,3093,6862,0.0432178464135234,0.450743223549985
2016,05009,65,768,85,802,0,34,85,836,0.031986531986532,0.101674641148325
2016,05011,86,168,4,53,0,8,4,61,0.00804537061461356,0.0655737704918033
2016,05013,0,158,0,23,0,0,0,23,0.00620950323974082,0
2016,05015,47,404,156,586,23,94,179,680,0.0349111818461854,0.263235294117647
2016,05017,43,376,14,169,7,7,21,176,0.0227743271221532,0.119318181818182
2016,05019,65,499,65,212,0,44,65,256,0.01948101362149,0.25390625
2016,05021,18,357,12,166,0,0,12,166,0.0153533111357751,0.072289156626506
2016,05023,56,433,33,418,0,15,33,433,0.0230062164603369,0.0762124711316397
2016,05025,26,121,3,36,0,0,3,36,0.00625,0.0833333333333333
2016,05027,41,300,18,144,21,21,39,165,0.0109707446808511,0.236363636363636
2016,05029,140,345,61,197,0,6,61,203,0.0139845687517222,0.300492610837438
2016,05031,388,2810,262,1147,110,183,372,1330,0.0203217870949012,0.279699248120301
2016,05033,199,929,78,912,34,52,112,964,0.0232749046308368,0.116182572614108
2016,05035,77,528,140,779,37,97,177,876,0.0282071097372488,0.202054794520548
2016,05037,88,336,0,64,0,0,0,64,0.00551343900758098,0
2016,05039,60,268,0,137,0,0,0,137,0.0253750694573069,0
2016,05041,20,134,4,78,9,9,13,87,0.0108614232209738,0.149425287356322
2016,05043,55,441,102,186,0,11,102,197,0.0170194384449244,0.517766497461929
2016,05045,588,2356,480,1327,8,28,488,1355,0.0185636782113108,0.360147601476015
2016,05047,95,583,73,318,0,7,73,325,0.0269911136948758,0.224615384615385
2016,05049,50,348,3,280,0,0,3,280,0.0314288921315524,0.0107142857142857
2016,05051,490,2034,559,2249,19,79,578,2328,0.0334521209334406,0.248281786941581
2016,05053,37,378,65,285,0,0,65,285,0.0230284421460892,0.228070175438596
2016,05055,101,706,104,716,31,32,135,748,0.0257851011754973,0.18048128342246
2016,05057,6,309,31,333,0,0,31,333,0.0225380710659898,0.0930930930930931
2016,05059,50,1112,20,186,11,11,31,197,0.0083894046503705,0.157360406091371
2016,05061,19,255,16,75,0,43,16,118,0.0130199713119276,0.135593220338983
2016,05063,58,675,85,382,0,18,85,400,0.0159955212540489,0.2125
2016,05065,12,513,67,224,18,24,85,248,0.0247381546134663,0.342741935483871
2016,05067,17,1744,4,175,0,4,4,179,0.0142504577661014,0.0223463687150838
2016,05069,89,1159,87,446,11,91,98,537,0.0111749282057685,0.182495344506518
2016,05071,49,470,23,155,0,8,23,163,0.00956011730205279,0.141104294478528
2016,05073,56,129,13,80,0,11,13,91,0.0179345683878597,0.142857142857143
2016,05075,18,439,42,167,0,8,42,175,0.0152998776009792,0.24
2016,05077,36,297,1,59,0,0,1,59,0.00850266609021473,0.0169491525423729
2016,05079,11,493,0,209,0,3,0,212,0.0210463615606076,0
2016,05081,29,229,11,318,7,42,18,360,0.0403542203788813,0.05
2016,05083,57,520,50,218,0,45,50,263,0.0172142950647991,0.190114068441065
2016,05085,244,1727,199,949,77,352,276,1301,0.027995352039938,0.212144504227517
2016,05087,17,87,0,106,0,15,0,121,0.0111829944547135,0
2016,05089,50,558,74,584,0,5,74,589,0.0471086939134608,0.125636672325976
2016,05091,15,888,71,1287,0,0,71,1287,0.043684871525067,0.0551670551670552
2016,05093,92,710,108,922,0,41,108,963,0.034270462633452,0.11214953271028
2016,05095,11,153,2,111,0,3,2,114,0.021726700971984,0.0175438596491228
2016,05097,23,292,41,195,0,3,41,198,0.0293507263563593,0.207070707070707
2016,05099,18,135,1,109,24,50,25,159,0.0264251288017284,0.157232704402516
2016,05101,80,231,21,84,4,4,25,88,0.0149329713219073,0.284090909090909
2016,05103,70,321,46,151,0,2,46,153,0.00890466767547433,0.300653594771242
2016,05105,43,207,0,39,0,0,0,39,0.00543857202621671,0
2016,05107,7,140,17,207,0,0,17,207,0.0163701067615658,0.0821256038647343
2016,05109,65,373,23,98,0,26,23,124,0.016120644825793,0.185483870967742
2016,05111,53,755,9,149,0,42,9,191,0.0117019973042519,0.0471204188481675
2016,05113,10,178,36,350,11,36,47,386,0.0273875407975025,0.121761658031088
2016,05115,145,1336,249,546,0,159,249,705,0.017780580075662,0.353191489361702
2016,05117,52,213,0,36,0,0,0,36,0.00600300150075038,0
2016,05119,1619,6448,2258,5096,412,1087,2670,6183,0.0234942299873466,0.431829209121786
2016,05121,15,271,87,280,0,0,87,280,0.0228087324861518,0.310714285714286
2016,05123,20,420,36,930,26,116,62,1046,0.0563729452977634,0.0592734225621415
2016,05125,601,2554,477,956,0,141,477,1097,0.0137497963225248,0.43482224247949
2016,05127,10,108,17,105,0,0,17,105,0.0146976483762598,0.161904761904762
2016,05129,0,65,0,49,0,23,0,72,0.0122636688809402,0
2016,05131,361,2134,817,2391,98,197,915,2588,0.0308488193293839,0.35355486862442
2016,05133,42,182,0,196,5,25,5,221,0.0207745816882873,0.0226244343891403
2016,05135,63,563,29,271,0,0,29,271,0.0220504475183076,0.107011070110701
2016,05137,177,380,24,199,50,88,74,287,0.0313867016622922,0.257839721254355
2016,05139,133,479,60,481,17,30,77,511,0.0186272008165348,0.150684931506849
2016,05141,76,359,32,217,6,33,38,250,0.0201336876862366,0.152
2016,05143,967,3639,1537,3791,361,615,1898,4406,0.0334028277927296,0.430776214253291
2016,05145,297,1481,320,878,6,84,326,962,0.0190544100461505,0.338877338877339
2016,05147,0,63,4,21,0,0,4,21,0.0043343653250774,0.19047619047619
2016,05149,81,454,15,159,0,15,15,174,0.0119645190125834,0.0862068965517241
2016,06001,22651,38289,10970,15857,7403,12453,18373,28310,0.0254293847274583,0.648993288590604
2016,06003,19,30,5,100,0,3,5,103,0.130379746835443,0.0485436893203883
2016,06005,419,2098,137,336,11,50,148,386,0.0134279551937661,0.383419689119171
2016,06007,958,4491,671,1970,149,291,820,2261,0.0156584369264864,0.362671384343211
2016,06009,318,1524,37,315,20,28,57,343,0.0101320414734292,0.166180758017493
2016,06011,33,316,5,91,0,17,5,108,0.00806451612903226,0.0462962962962963
2016,06013,13573,28012,4959,8572,3020,5429,7979,14001,0.0185965890978642,0.569887865152489
2016,06015,170,1304,88,285,0,26,88,311,0.0160358873878519,0.282958199356913
2016,06017,1997,5882,558,1623,152,382,710,2005,0.0153875671527245,0.354114713216958
2016,06019,2461,13076,1028,3979,793,2649,1821,6628,0.0114446347662725,0.274743512371756
2016,06021,120,618,34,69,3,4,37,73,0.00408849061887426,0.506849315068493
2016,06023,840,2713,541,1532,39,135,580,1667,0.0183382286613203,0.347930413917217
2016,06025,305,2464,132,860,244,790,376,1650,0.0153233220962305,0.227878787878788
2016,06027,156,480,72,255,1,31,73,286,0.0216126350789692,0.255244755244755
2016,06029,2374,19537,1894,5506,688,2319,2582,7825,0.015082767287839,0.329968051118211
2016,06031,609,7311,523,1424,170,545,693,1969,0.0214434292061902,0.35195530726257
2016,06033,697,2917,158,698,46,85,204,783,0.0169399852883908,0.260536398467433
2016,06035,86,3559,80,386,0,99,80,485,0.0212551494434219,0.164948453608247
2016,06037,30273,67158,36595,63047,24122,46846,60717,109893,0.0163724235069343,0.552510168982556
2016,06039,387,4563,93,351,70,277,163,628,0.00659857941411339,0.259554140127389
2016,06041,4533,9045,1751,2540,986,1308,2737,3848,0.0202828423388521,0.711278586278586
2016,06043,113,533,54,227,0,18,54,245,0.0180945347119645,0.220408163265306
2016,06045,401,1962,407,1191,32,103,439,1294,0.0209860525462212,0.339258114374034
2016,06047,760,4285,257,1117,116,456,373,1573,0.0102137551296037,0.237126509853783
2016,06049,39,179,55,224,0,0,55,224,0.0335178811910819,0.245535714285714
2016,06051,67,231,3,57,5,30,8,87,0.00936793367072252,0.0919540229885057
2016,06053,2324,7789,2671,4597,915,1786,3586,6383,0.0235973914586537,0.56180479398402
2016,06055,1697,3315,674,1199,132,373,806,1572,0.0161656880186749,0.512722646310433
2016,06057,1017,2485,627,1193,34,143,661,1336,0.0179746256407497,0.494760479041916
2016,06059,22799,47216,12526,22458,7983,15484,20509,37942,0.0180635590476807,0.540535554267039
2016,06061,4086,11899,1585,3222,462,1092,2047,4314,0.0168122900412318,0.474501622624015
2016,06063,96,418,94,285,8,49,102,334,0.0230360714532037,0.305389221556886
2016,06065,12151,54300,5898,17658,2599,7645,8497,25303,0.0172258621440864,0.335809983005968
2016,06067,9737,32568,5617,13031,2550,5999,8167,19030,0.0194452732556476,0.429164477141356
2016,06069,312,1274,26,160,28,157,54,317,0.00864679086767955,0.170347003154574
2016,06071,9920,52931,4182,14414,2097,6592,6279,21006,0.016236157798202,0.298914595829763
2016,06073,12245,26762,22346,40279,9936,20812,32282,61091,0.0282598438309526,0.528424808891653
2016,06075,13426,19729,12491,14973,6479,8871,18970,23844,0.0356415219844692,0.795587988592518
2016,06077,3512,16566,1016,3482,455,1858,1471,5340,0.0120783873769543,0.275468164794007
2016,06079,3001,7175,1018,2314,251,682,1269,2996,0.0162521359407632,0.423564753004005
2016,06081,12274,20718,5300,6761,3366,5555,8666,12316,0.0229989803959649,0.703637544657356
2016,06083,2314,6538,2007,4445,917,2012,2924,6457,0.0238827058436251,0.452841877032678
2016,06085,16869,28160,16363,20281,17092,23521,33455,43802,0.0340933945118368,0.763777909684489
2016,06087,2598,6017,1036,1739,360,623,1396,2362,0.0134673607507968,0.591024555461473
2016,06089,1019,3952,495,1894,239,416,734,2310,0.0184453227931489,0.317748917748918
2016,06091,20,84,1,19,0,0,1,19,0.00797984040319194,0.0526315789473684
2016,06093,214,1016,83,456,0,33,83,489,0.0154137115839243,0.169734151329243
2016,06095,3333,12551,1286,4096,825,2062,2111,6158,0.0212884379375313,0.342806105878532
2016,06097,4382,10934,1937,4553,487,1064,2424,5617,0.0160203298756193,0.43154708919352
2016,06099,1704,9764,447,2079,126,1252,573,3331,0.0100528445838074,0.172020414290003
2016,06101,459,2526,119,572,103,530,222,1102,0.0179862573242586,0.201451905626134
2016,06103,240,2084,40,362,0,84,40,446,0.0104152071365186,0.0896860986547085
2016,06105,54,340,6,122,0,0,6,122,0.0119760479041916,0.0491803278688525
2016,06107,1072,5586,598,2397,100,847,698,3244,0.0123299594449238,0.215166461159063
2016,06109,301,2618,66,498,4,4,70,502,0.0123359709048017,0.139442231075697
2016,06111,5418,12920,3119,6366,1186,2860,4305,9226,0.0166139639412515,0.466616084977238
2016,06113,2191,5897,1030,1681,1066,1605,2096,3286,0.0268819843256598,0.637857577601948
2016,06115,257,2596,188,982,81,407,269,1389,0.0303785840824093,0.193664506839453
2016,08001,4735,16382,2114,6196,373,1359,2487,7555,0.0248921778266872,0.329185969556585
2016,08003,232,756,79,168,2,21,81,189,0.0202528932704672,0.428571428571429
2016,08005,8982,24107,6449,12921,1247,2660,7696,15581,0.0377056678290625,0.493934920736795
2016,08007,128,213,205,411,0,21,205,432,0.0473944048272079,0.474537037037037
2016,08009,39,86,21,45,0,0,21,45,0.0171821305841924,0.466666666666667
2016,08011,40,436,3,45,0,15,3,60,0.0127986348122867,0.05
2016,08013,3436,7258,5644,8512,1426,1984,7070,10496,0.0518489976980152,0.67358993902439
2016,08014,1685,4005,1358,2268,114,212,1472,2480,0.0584878071789067,0.593548387096774
2016,08015,319,483,95,352,27,72,122,424,0.0295059151009047,0.287735849056604
2016,08017,24,79,8,23,0,6,8,29,0.0219198790627362,0.275862068965517
2016,08019,165,313,132,192,0,0,132,192,0.0267707752370329,0.6875
2016,08021,23,158,11,25,0,4,11,29,0.00548307808659482,0.379310344827586
2016,08023,11,41,4,52,8,8,12,60,0.0229797012638836,0.2
2016,08025,17,224,0,52,0,0,0,52,0.0139149050040139,0
2016,08027,39,118,12,31,0,0,12,31,0.00925373134328358,0.387096774193548
2016,08029,111,627,115,391,0,22,115,413,0.0189858870040914,0.278450363196126
2016,08031,12165,28299,13882,20119,1835,3076,15717,23195,0.0495341293247598,0.677602931666307
2016,08033,30,55,2,42,0,3,2,45,0.0336826347305389,0.0444444444444444
2016,08035,4910,9472,4977,7964,768,1004,5745,8968,0.0441167065953689,0.640611061552186
2016,08037,580,1295,574,967,51,289,625,1256,0.034322566540963,0.497611464968153
2016,08039,282,1044,243,465,0,23,243,488,0.0288075560802834,0.497950819672131
2016,08041,2366,7384,8663,22825,1531,5003,10194,27828,0.0657925223304001,0.366321690383786
2016,08043,189,1008,96,1139,17,45,113,1184,0.0325910429684274,0.0954391891891892
2016,08045,593,1231,173,992,196,242,369,1234,0.0326066851631655,0.29902755267423
2016,08047,84,319,127,243,0,0,127,243,0.0553026854802003,0.522633744855967
2016,08049,223,333,185,332,20,37,205,369,0.0343671416596815,0.555555555555556
2016,08051,96,237,150,206,3,3,153,209,0.0207238472979673,0.732057416267943
2016,08053,5,11,10,30,0,0,10,30,0.0427960057061341,0.333333333333333
2016,08055,40,155,119,214,0,4,119,218,0.0423465423465423,0.545871559633027
2016,08057,6,29,0,1,0,11,0,12,0.012108980827447,0
2016,08059,8116,18373,5396,10792,1047,1636,6443,12428,0.0314449814032336,0.518426134534921
2016,08061,2,6,7,12,0,0,7,12,0.0127118644067797,0.583333333333333
2016,08063,30,160,21,96,0,11,21,107,0.0184070187510752,0.196261682242991
2016,08065,161,274,247,325,0,0,247,325,0.0637504903883876,0.76
2016,08067,292,816,1266,2007,30,99,1296,2106,0.0556259904912837,0.615384615384615
2016,08069,2449,5750,4247,8074,346,703,4593,8777,0.0417201418399262,0.523299532870001
2016,08071,89,351,52,241,16,16,68,257,0.0248069498069498,0.264591439688716
2016,08073,7,194,16,30,0,0,16,30,0.00735474380975729,0.533333333333333
2016,08075,23,790,52,282,0,100,52,382,0.02603066439523,0.136125654450262
2016,08077,656,2558,885,3134,87,276,972,3410,0.0341071625041259,0.285043988269795
2016,08079,3,19,2,11,0,0,2,11,0.0154277699859748,0.181818181818182
2016,08081,171,415,31,203,10,32,41,235,0.0270862148455509,0.174468085106383
2016,08083,130,472,258,984,0,16,258,1000,0.0549269471602768,0.258
2016,08085,383,1243,348,947,6,47,354,994,0.0343350604490501,0.356136820925553
2016,08087,90,799,38,259,4,63,42,322,0.017709822901771,0.130434782608696
2016,08089,75,431,21,230,0,18,21,248,0.0200842241658568,0.0846774193548387
2016,08091,86,123,94,158,0,0,94,158,0.0419989367357788,0.594936708860759
2016,08093,351,914,186,295,11,45,197,340,0.0265438363650558,0.579411764705882
2016,08095,39,228,41,104,0,4,41,108,0.0355848434925865,0.37962962962963
2016,08097,345,627,361,444,61,134,422,578,0.0428656185108276,0.730103806228374
2016,08099,51,210,0,162,2,6,2,168,0.0214806290755658,0.0119047619047619
2016,08101,585,2558,662,2388,62,297,724,2685,0.0246814847498759,0.269646182495344
2016,08103,55,112,5,142,9,9,14,151,0.0354376906829383,0.0927152317880795
2016,08105,109,407,21,289,3,3,24,292,0.0373975409836066,0.0821917808219178
2016,08107,464,807,247,520,26,30,273,550,0.031641928431711,0.496363636363636
2016,08109,44,108,39,98,0,0,39,98,0.0221268909460375,0.397959183673469
2016,08111,4,15,0,0,0,0,0,0,0,NA
2016,08113,15,129,306,439,12,12,318,451,0.0782171349288935,0.70509977827051
2016,08115,13,79,14,104,0,3,14,107,0.0629041740152851,0.130841121495327
2016,08117,248,764,557,775,37,101,594,876,0.039974445559916,0.678082191780822
2016,08119,286,1032,228,643,0,5,228,648,0.0368768495333485,0.351851851851852
2016,08121,49,286,24,129,6,9,30,138,0.0407921962754951,0.217391304347826
2016,08123,2246,8188,1441,4635,217,568,1658,5203,0.0296841036290714,0.318662310205651
2016,08125,110,317,36,137,38,49,74,186,0.0278818767800929,0.397849462365591
2016,09001,2098,4857,9995,16045,2936,5392,12931,21437,0.0336852128876542,0.603209404300975
2016,09003,3430,9961,5146,9573,2297,4356,7443,13929,0.0224905058385863,0.534352789144949
2016,09005,1196,3150,1007,1918,116,375,1123,2293,0.0169410130622377,0.489751417357174
2016,09007,1684,4098,663,1508,174,316,837,1824,0.015389937478379,0.458881578947368
2016,09009,3323,9176,5261,9261,1747,3761,7008,13022,0.0219997803738712,0.538166180310244
2016,09011,1165,4196,1850,4473,334,659,2184,5132,0.0271943025498633,0.425565081839439
2016,09013,1268,4041,802,1577,211,320,1013,1897,0.019899297178223,0.534001054296257
2016,09015,460,2099,471,1546,40,284,511,1830,0.0227111955024387,0.279234972677596
2016,10001,493,1976,961,3223,158,406,1119,3629,0.0322910734624146,0.308349407550289
2016,10003,403,2316,5980,12280,1331,2457,7311,14737,0.039475939954355,0.496098256090113
2016,10005,338,1523,2218,6154,70,372,2288,6526,0.0420449054537255,0.350597609561753
2016,11001,0,0,22423,30034,5607,6611,28030,36645,0.0791473810845427,0.764906535680175
2016,12001,1702,4641,2690,4066,1026,1511,3716,5577,0.0362989045892698,0.666308050923436
2016,12003,58,1274,52,305,12,56,64,361,0.0201924152589775,0.177285318559557
2016,12005,687,2893,1298,4938,174,706,1472,5644,0.0454640653445248,0.260807937632884
2016,12007,99,1981,45,267,0,0,45,267,0.0137699845281073,0.168539325842697
2016,12009,2075,7135,3889,13777,746,1930,4635,15707,0.0381129630663137,0.295091360539887
2016,12011,10052,31039,9831,25927,7362,19629,17193,45556,0.0349261816796246,0.377403635086487
2016,12013,29,701,0,119,0,0,0,119,0.0114687740940632,0
2016,12015,836,5259,1636,6716,189,797,1825,7513,0.0545012694958288,0.242912285372022
2016,12017,392,3091,778,3568,44,207,822,3775,0.0339484523102934,0.217748344370861
2016,12019,1536,7074,1323,4667,195,697,1518,5364,0.039819461353446,0.282997762863535
2016,12021,1677,5696,5260,11817,1013,2837,6273,14654,0.0561910203267776,0.428074245939675
2016,12023,347,2948,285,1155,15,172,300,1327,0.0282803742301217,0.226073850791258
2016,12027,56,1346,176,621,16,352,192,973,0.0397889915760203,0.197327852004111
2016,12029,9,841,18,317,0,0,18,317,0.0263705182597122,0.056782334384858
2016,12031,4693,13597,6105,17458,1602,3917,7707,21375,0.0352090635953931,0.360561403508772
2016,12033,1214,4285,2663,7752,343,779,3006,8531,0.0416270207232396,0.352361973977259
2016,12035,567,1805,888,2868,49,371,937,3239,0.0418718893413483,0.289286816918802
2016,12037,50,1008,86,233,0,17,86,250,0.0279267202859696,0.344
2016,12039,171,2561,35,157,79,134,114,291,0.00915123117079153,0.391752577319588
2016,12041,49,470,15,151,9,15,24,166,0.0145652364657366,0.144578313253012
2016,12043,17,557,57,234,26,34,83,268,0.0269238497086598,0.309701492537313
2016,12045,61,1065,96,427,0,0,96,427,0.0352717660664134,0.224824355971897
2016,12047,21,1337,8,62,0,1,8,63,0.00640113798008535,0.126984126984127
2016,12049,21,475,25,321,0,20,25,341,0.0198683213890346,0.0733137829912024
2016,12051,135,1179,87,505,40,684,127,1189,0.0497739450770261,0.106812447434819
2016,12053,737,4709,663,3839,183,562,846,4401,0.0335143203088709,0.192229038854806
2016,12055,334,2263,511,2688,69,983,580,3671,0.0490120160213618,0.157995096703895
2016,12057,7566,21490,8945,22649,3728,8395,12673,31044,0.0349228848165772,0.408227032598892
2016,12059,60,1014,71,415,0,5,71,420,0.0301941049604601,0.169047619047619
2016,12061,806,3998,1275,4118,114,582,1389,4700,0.0427202821356505,0.295531914893617
2016,12063,162,2341,128,791,28,48,156,839,0.0236718110769404,0.185935637663886
2016,12065,45,1114,58,181,7,22,65,203,0.0188015189404464,0.320197044334975
2016,12067,40,693,0,34,0,22,0,56,0.00915032679738562,0
2016,12069,2631,9895,1648,7916,172,734,1820,8650,0.0372363323288851,0.210404624277457
2016,12071,1961,9426,7073,22372,1056,4280,8129,26652,0.0527848086223902,0.305005252889089
2016,12073,1812,5884,2385,4580,715,1000,3100,5580,0.033641208671956,0.555555555555556
2016,12075,170,1341,34,661,2,34,36,695,0.0241915834174527,0.0517985611510791
2016,12077,16,662,11,52,8,8,19,60,0.0106515178412924,0.316666666666667
2016,12079,77,1164,0,157,0,37,0,194,0.0146891799803135,0
2016,12081,2626,8782,4467,11763,610,1836,5077,13599,0.0523495513390537,0.373336274726083
2016,12083,1335,8658,1396,7703,464,952,1860,8655,0.0343261680019037,0.214904679376083
2016,12085,1444,5696,1742,4507,104,529,1846,5036,0.0427693039372219,0.366560762509929
2016,12086,5208,16506,8870,18139,12863,32346,21733,50485,0.027002914506906,0.430484302268
2016,12087,658,2138,1071,2694,182,803,1253,3497,0.0583796597719571,0.358307120388905
2016,12089,369,2087,786,2250,186,236,972,2486,0.0445743383776806,0.390989541432019
2016,12091,736,3152,1951,6086,264,954,2215,7040,0.0529036912348202,0.314630681818182
2016,12093,39,719,25,496,16,41,41,537,0.0199065836298932,0.0763500931098696
2016,12095,8134,25583,8620,21643,4444,11368,13064,33011,0.0400012602257016,0.395746872254703
2016,12097,1368,6970,1442,4934,1366,4171,2808,9105,0.0447829465752481,0.30840197693575
2016,12099,8144,21137,11948,27030,4172,11309,16120,38339,0.0378327598405733,0.420459584235374
2016,12101,2755,11341,2772,9316,405,1559,3177,10875,0.030789397688601,0.292137931034483
2016,12103,4914,15096,8435,22263,1578,4758,10013,27021,0.0379354447422324,0.370563635690759
2016,12105,2399,10863,2076,11168,766,2808,2842,13976,0.0319650890727242,0.203348597595879
2016,12107,186,1419,130,867,0,99,130,966,0.0189631141909268,0.134575569358178
2016,12109,3359,7657,2695,5153,486,834,3181,5987,0.0389509843467399,0.531317855353265
2016,12111,2315,8941,1267,5640,276,1671,1543,7311,0.0348782291343654,0.211051839693612
2016,12113,928,4965,1767,5228,158,428,1925,5656,0.050152070014276,0.340346534653465
2016,12115,2447,7553,4855,12112,913,2256,5768,14368,0.0456757744822215,0.401447661469933
2016,12117,4761,15037,3430,7191,999,2374,4429,9565,0.0311328247057598,0.463042341871406
2016,12119,597,3036,2560,6374,87,600,2647,6974,0.0689082770954578,0.379552624032119
2016,12121,217,1994,177,553,0,39,177,592,0.0192095528587189,0.298986486486487
2016,12123,74,1765,56,199,8,57,64,256,0.0156862745098039,0.25
2016,12125,50,1702,9,62,0,4,9,66,0.0059793440840732,0.136363636363636
2016,12127,2234,10122,3128,12695,419,1788,3547,14483,0.0386532867170194,0.244907822964855
2016,12129,236,2137,36,188,0,65,36,253,0.0113386814861292,0.142292490118577
2016,12131,416,2083,649,1461,59,78,708,1539,0.0343710916562444,0.460038986354776
2016,12133,118,1609,54,148,0,7,54,155,0.00879831980473406,0.348387096774194
2016,13001,85,337,5,92,0,0,5,92,0.00746389745253935,0.0543478260869565
2016,13003,13,120,12,46,0,8,12,54,0.0103626943005181,0.222222222222222
2016,13005,20,470,15,39,0,0,15,39,0.00533369803063457,0.384615384615385
2016,13007,3,69,0,14,0,0,0,14,0.00585529067335843,0
2016,13009,208,1237,91,302,23,33,114,335,0.0120179372197309,0.340298507462687
2016,13011,69,491,0,91,0,80,0,171,0.0136526946107784,0
2016,13013,345,2284,88,377,4,4,92,381,0.00801396659795549,0.241469816272966
2016,13015,345,2414,103,1045,15,62,118,1107,0.016441163802706,0.106594399277326
2016,13017,156,374,0,125,0,32,0,157,0.0137719298245614,0
2016,13019,8,303,0,162,19,34,19,196,0.0153136963825299,0.0969387755102041
2016,13021,987,3975,339,1190,34,264,373,1454,0.0146249710819863,0.256533700137552
2016,13023,91,314,11,40,0,0,11,40,0.00503905265810028,0.275
2016,13025,14,470,13,379,0,0,13,379,0.0311242506364458,0.0343007915567282
2016,13027,48,493,0,150,0,14,0,164,0.0151992585727525,0
2016,13029,491,1230,526,887,159,207,685,1094,0.0508789880011162,0.626142595978062
2016,13031,150,1090,176,760,38,43,214,803,0.0202312866896778,0.266500622665006
2016,13033,28,389,0,114,0,0,0,114,0.00775193798449612,0
2016,13035,127,1826,37,223,0,20,37,243,0.0149024898810254,0.152263374485597
2016,13037,77,752,24,37,11,12,35,49,0.0103136181856451,0.714285714285714
2016,13039,156,786,450,1685,41,118,491,1803,0.0564389907969699,0.272323904603439
2016,13043,49,361,20,134,0,0,20,134,0.0185134014921249,0.149253731343284
2016,13045,712,3017,306,1109,59,395,365,1504,0.021216866280136,0.242686170212766
2016,13047,93,1244,285,1451,1,1,286,1452,0.0325043092834277,0.196969696969697
2016,13049,0,142,11,498,2,36,13,534,0.0585333771785597,0.0243445692883895
2016,13051,1475,5332,3566,8507,469,1407,4035,9914,0.0532403926707194,0.40700020173492
2016,13053,52,232,630,1280,124,210,754,1490,0.292730844793713,0.506040268456376
2016,13055,17,316,7,190,0,32,7,222,0.0128546612623046,0.0315315315315315
2016,13057,1999,6504,1350,3600,191,329,1541,3929,0.0258401841499507,0.392211758717231
2016,13059,992,2929,1187,1831,392,547,1579,2378,0.0358824239497827,0.664003364171573
2016,13061,1,45,0,110,0,0,0,110,0.0527831094049904,0
2016,13063,1501,10942,972,4267,74,615,1046,4882,0.0295140043406504,0.214256452273658
2016,13065,53,275,0,79,0,12,0,91,0.0205789235639982,0
2016,13067,9147,20119,7450,14733,1899,3449,9349,18182,0.0377640649437236,0.514189858101419
2016,13069,68,823,137,376,0,48,137,424,0.0153589799318989,0.32311320754717
2016,13071,123,783,74,612,3,66,77,678,0.0231020853209759,0.113569321533923
2016,13073,834,2618,1736,3404,162,935,1898,4339,0.0474197285305239,0.437427978796958
2016,13075,89,398,5,109,0,81,5,190,0.0170955551556595,0.0263157894736842
2016,13077,753,3490,749,2046,230,315,979,2361,0.0264093959731544,0.414654807285049
2016,13079,26,411,0,76,0,7,0,83,0.00927996422182469,0
2016,13081,46,489,13,100,14,31,27,131,0.00862863917797392,0.206106870229008
2016,13083,2,213,22,419,43,55,65,474,0.0424693127855927,0.137130801687764
2016,13085,305,998,89,272,13,13,102,285,0.0175244419848736,0.357894736842105
2016,13087,107,600,17,310,0,7,17,317,0.0176287398509621,0.0536277602523659
2016,13089,10148,23200,7318,13121,2598,5124,9916,18245,0.0375716115533993,0.543491367497945
2016,13091,17,462,0,43,0,1,0,44,0.00303239145416954,0
2016,13093,18,654,17,44,0,29,17,73,0.00733447201848689,0.232876712328767
2016,13095,574,2647,403,1113,14,82,417,1195,0.0205481807552101,0.348953974895397
2016,13097,1317,4066,425,2028,89,371,514,2399,0.0271257349615559,0.21425593997499
2016,13099,13,90,0,57,0,0,0,57,0.00815100815100815,0
2016,13101,5,157,0,19,0,63,0,82,0.0320939334637965,0
2016,13103,229,1242,134,747,0,31,134,778,0.0216688948306595,0.172236503856041
2016,13105,0,93,36,223,0,14,36,237,0.017602495543672,0.151898734177215
2016,13107,95,765,20,225,0,21,20,246,0.0165801711936375,0.0813008130081301
2016,13109,93,416,17,146,0,0,17,146,0.0204653770675638,0.116438356164384
2016,13111,202,675,28,436,20,47,48,483,0.0265413781734256,0.0993788819875776
2016,13113,1118,2844,1086,2039,296,570,1382,2609,0.0354478879363052,0.529704867765427
2016,13115,383,1892,296,916,57,86,353,1002,0.0157713314340579,0.352295409181637
2016,13117,2747,5484,1754,3419,356,688,2110,4107,0.0313169593497175,0.513757000243487
2016,13119,142,739,23,174,0,29,23,203,0.0133940353655318,0.113300492610837
2016,13121,13771,28899,13287,21931,3168,5729,16455,27660,0.0416902172684316,0.594902386117137
2016,13123,100,678,131,604,20,160,151,764,0.036716647443291,0.197643979057592
2016,13125,10,52,0,34,0,0,0,34,0.0164410058027079,0
2016,13127,644,1923,410,1456,89,237,499,1693,0.0298499568030749,0.294743059657413
2016,13129,249,1280,76,470,0,83,76,553,0.0148743880789714,0.137432188065099
2016,13131,11,292,41,512,0,12,41,524,0.0312686478100012,0.0782442748091603
2016,13133,85,432,126,274,0,69,126,343,0.0279954293176624,0.36734693877551
2016,13135,6133,16896,5927,15067,1837,4190,7764,19257,0.0349338403097006,0.403178065119177
2016,13137,195,1187,25,372,36,56,61,428,0.0145905774868753,0.142523364485981
2016,13139,1117,4589,526,1973,139,289,665,2262,0.0184902113050231,0.293987621573828
2016,13141,29,680,0,46,0,41,0,87,0.013325164650023,0
2016,13143,63,927,37,361,0,17,37,378,0.0195956454121306,0.0978835978835979
2016,13145,328,1452,123,316,15,17,138,333,0.0145262606874891,0.414414414414414
2016,13147,43,615,61,255,0,35,61,290,0.0161658955348682,0.210344827586207
2016,13149,44,457,5,74,3,3,8,77,0.00981391791995921,0.103896103896104
2016,13151,1634,6802,649,2927,269,531,918,3458,0.0254059216809933,0.265471370734529
2016,13153,810,3114,712,2246,380,599,1092,2845,0.0295320544760007,0.383831282952548
2016,13155,8,255,10,81,0,20,10,101,0.0158158471656749,0.099009900990099
2016,13157,313,1315,108,484,5,100,113,584,0.0141370128298233,0.193493150684932
2016,13159,76,526,37,153,0,50,37,203,0.0220508364110363,0.182266009852217
2016,13161,77,216,0,9,0,12,0,21,0.00220426157237326,0
2016,13163,21,336,4,107,0,3,4,110,0.0102478106949879,0.0363636363636364
2016,13165,59,305,0,99,0,8,0,107,0.0173785934708462,0
2016,13167,14,306,0,97,0,0,0,97,0.0150527622594662,0
2016,13169,125,970,16,100,0,36,16,136,0.00699085021075357,0.117647058823529
2016,13171,42,459,0,54,0,0,0,54,0.00463957384655039,0
2016,13173,67,641,48,171,87,87,135,258,0.037521815008726,0.523255813953488
2016,13175,118,712,100,518,0,39,100,557,0.0175063645221108,0.179533213644524
2016,13177,221,1052,75,368,57,57,132,425,0.0224321756571308,0.310588235294118
2016,13179,264,1402,391,2568,113,816,504,3384,0.094372246081767,0.148936170212766
2016,13181,22,136,49,100,0,0,49,100,0.0177746178457163,0.49
2016,13183,283,962,71,460,0,30,71,490,0.0476190476190476,0.144897959183673
2016,13185,375,1738,573,2401,158,469,731,2870,0.0434947336515875,0.254703832752613
2016,13187,297,1013,192,392,14,140,206,532,0.0275919298791556,0.387218045112782
2016,13189,68,429,93,267,0,0,93,267,0.0187763713080169,0.348314606741573
2016,13191,49,534,0,115,0,0,0,115,0.0111726416010881,0
2016,13193,4,550,0,54,0,0,0,54,0.00563792023386928,0
2016,13195,141,948,30,144,5,41,35,185,0.0095311695002576,0.189189189189189
2016,13197,24,391,15,128,0,23,15,151,0.025,0.0993377483443709
2016,13199,140,741,29,44,0,3,29,47,0.00319619177150629,0.617021276595745
2016,13201,0,94,9,28,0,0,9,28,0.0068661108386464,0.321428571428571
2016,13205,29,902,0,228,0,17,0,245,0.0159702757316994,0
2016,13207,240,1109,89,412,6,6,95,418,0.0220371151412906,0.227272727272727
2016,13209,63,436,11,66,0,0,11,66,0.0110018336389398,0.166666666666667
2016,13211,83,412,25,169,0,37,25,206,0.0167793434878228,0.121359223300971
2016,13213,62,619,17,175,0,0,17,175,0.00678084314941104,0.0971428571428571
2016,13215,827,3574,2371,6347,588,1218,2959,7565,0.0589734794742668,0.391143423661599
2016,13217,275,3165,296,1358,147,224,443,1582,0.0240546170571867,0.280025284450063
2016,13219,360,969,167,344,18,36,185,380,0.0165779600383911,0.486842105263158
2016,13221,195,723,75,194,0,4,75,198,0.0189509954058193,0.378787878787879
2016,13223,1128,4718,344,1470,34,253,378,1723,0.0181660990858962,0.219384793964016
2016,13225,195,923,0,162,0,24,0,186,0.0111217412102368,0
2016,13227,166,1067,129,390,0,13,129,403,0.018565439719906,0.320099255583127
2016,13229,0,323,52,74,11,11,63,85,0.00662613033988151,0.741176470588235
2016,13231,35,775,35,81,2,7,37,88,0.00735662932619963,0.420454545454545
2016,13233,119,1121,40,191,0,43,40,234,0.0086586493987049,0.170940170940171
2016,13235,5,393,6,68,0,31,6,99,0.0118124328839041,0.0606060606060606
2016,13237,230,784,66,287,33,148,99,435,0.0281973163933364,0.227586206896552
2016,13239,0,4,9,82,0,0,9,82,0.051997463538364,0.109756097560976
2016,13241,60,206,98,260,21,21,119,281,0.0230611407468199,0.423487544483986
2016,13243,5,268,0,45,0,0,0,45,0.009375,0
2016,13245,968,3639,1565,4444,245,761,1810,5205,0.0401221006868164,0.347742555235351
2016,13247,560,2944,392,1609,19,186,411,1795,0.0315954375836091,0.228969359331476
2016,13249,28,234,7,19,0,0,7,19,0.00574018126888218,0.368421052631579
2016,13251,37,326,0,33,0,40,0,73,0.00760099958350687,0
2016,13253,47,134,16,48,0,0,16,48,0.00791165320586781,0.333333333333333
2016,13255,300,2038,134,463,0,25,134,488,0.0113968098274131,0.274590163934426
2016,13257,107,584,13,148,56,64,69,212,0.0123998362285781,0.325471698113208
2016,13259,59,562,28,378,31,231,59,609,0.144862036156042,0.09688013136289
2016,13261,79,712,24,163,0,30,24,193,0.0099849966371773,0.124352331606218
2016,13263,24,135,0,11,0,0,0,11,0.00235798499464094,0
2016,13265,10,47,1,3,0,5,1,8,0.00556715379262352,0.125
2016,13267,65,2298,46,217,0,39,46,256,0.0145636591193537,0.1796875
2016,13269,53,428,3,92,0,31,3,123,0.0214884696016771,0.024390243902439
2016,13271,31,211,19,53,0,72,19,125,0.0101659076122316,0.152
2016,13273,17,263,0,29,0,0,0,29,0.00473237597911227,0
2016,13275,129,723,107,620,0,78,107,698,0.0229183083793013,0.153295128939828
2016,13277,97,705,39,243,0,74,39,317,0.01236687083057,0.123028391167192
2016,13279,93,444,7,145,0,36,7,181,0.0103963239517519,0.0386740331491713
2016,13281,30,108,104,238,0,36,104,274,0.0338899196042053,0.37956204379562
2016,13283,7,336,0,0,0,16,0,16,0.0034767492394611,0
2016,13285,350,1709,177,923,11,134,188,1057,0.0237757833412061,0.177861873226112
2016,13287,11,219,0,16,0,50,0,66,0.0120043652237177,0
2016,13289,23,187,7,7,0,0,7,7,0.00118966689326988,1
2016,13291,66,460,154,435,0,0,154,435,0.025431160479392,0.354022988505747
2016,13293,27,378,22,226,0,0,22,226,0.012610903409408,0.0973451327433628
2016,13295,137,1466,314,1386,0,22,314,1408,0.0297586338081752,0.223011363636364
2016,13297,485,1854,189,948,0,110,189,1058,0.0184019202003687,0.178638941398866
2016,13299,178,1155,132,407,0,10,132,417,0.0175173282923756,0.316546762589928
2016,13301,25,73,8,10,0,0,8,10,0.00256673511293634,0.8
2016,13303,37,868,8,56,0,24,8,80,0.00565530892124982,0.1
2016,13305,80,481,224,658,0,70,224,728,0.0362062963147163,0.307692307692308
2016,13307,0,33,0,65,0,0,0,65,0.0360310421286031,0
2016,13309,0,97,0,3,0,0,0,3,0.000527148128624143,0
2016,13311,253,673,30,186,0,0,30,186,0.00942344715776674,0.161290322580645
2016,13313,112,1620,226,1469,30,173,256,1642,0.0250396486519458,0.155907429963459
2016,13315,14,587,2,39,0,2,2,41,0.00644755464695707,0.0487804878048781
2016,13317,23,236,41,96,0,0,41,96,0.0139453805926787,0.427083333333333
2016,13319,6,173,0,19,0,12,0,31,0.00482640510664798,0
2016,13321,27,458,5,142,0,0,5,142,0.009933543196922,0.0352112676056338
2016,15001,315,934,1668,4339,356,711,2024,5050,0.0373021325001293,0.400792079207921
2016,15003,478,1928,9499,22688,3260,8028,12759,30716,0.045580680297144,0.415386117984113
2016,15005,0,4,2,2,0,0,2,2,0.0238095238095238,1
2016,15007,249,696,576,1188,129,390,705,1578,0.0318260659110161,0.446768060836502
2016,15009,243,1092,1141,2989,420,1304,1561,4293,0.0376526101599775,0.363615187514559
2016,16001,1510,5789,4558,10187,617,1183,5175,11370,0.0403451873194757,0.455145118733509
2016,16003,43,172,25,75,0,0,25,75,0.0254668930390492,0.333333333333333
2016,16005,288,1582,528,1619,64,216,592,1835,0.0351108815031667,0.322615803814714
2016,16007,36,111,30,103,0,4,30,107,0.0272750446087178,0.280373831775701
2016,16009,12,114,31,132,0,6,31,138,0.021633484872237,0.22463768115942
2016,16011,90,782,86,422,0,25,86,447,0.0165139648293188,0.192393736017897
2016,16013,34,199,185,414,25,28,210,442,0.02937072230713,0.475113122171946
2016,16015,42,307,47,139,6,9,53,148,0.0282065942443301,0.358108108108108
2016,16017,210,795,211,1119,0,33,211,1152,0.0378561335480267,0.183159722222222
2016,16019,430,1708,702,1651,159,355,861,2006,0.0304580859689346,0.429212362911266
2016,16021,40,140,128,382,0,26,128,408,0.0528771384136858,0.313725490196078
2016,16023,8,33,19,53,0,1,19,54,0.0295728368017525,0.351851851851852
2016,16025,0,0,10,22,0,0,10,22,0.0342146189735614,0.454545454545455
2016,16027,816,4852,1072,4202,20,269,1092,4471,0.0364043480030941,0.244240662044285
2016,16029,27,72,13,71,0,39,13,110,0.0249376558603491,0.118181818181818
2016,16031,153,581,60,314,1,39,61,353,0.0257570229843123,0.172804532577904
2016,16033,0,13,9,29,0,0,9,29,0.0532110091743119,0.310344827586207
2016,16035,97,559,51,201,0,0,51,201,0.0299062639488171,0.253731343283582
2016,16037,33,100,10,32,3,3,13,35,0.0108158220024722,0.371428571428571
2016,16039,121,453,116,670,43,411,159,1081,0.0684697238408918,0.147086031452359
2016,16041,32,137,119,483,2,26,121,509,0.0673726009265387,0.237721021611002
2016,16043,48,254,49,170,0,48,49,218,0.0266862529073326,0.224770642201835
2016,16045,106,373,105,543,0,18,105,561,0.0473098330241187,0.18716577540107
2016,16047,53,362,7,139,7,27,14,166,0.0173640167364017,0.0843373493975904
2016,16049,135,572,72,350,0,5,72,355,0.0298670705031129,0.202816901408451
2016,16051,215,647,151,518,7,34,158,552,0.035737407743105,0.286231884057971
2016,16053,91,628,24,219,0,210,24,429,0.031502423263328,0.0559440559440559
2016,16055,198,1447,1382,4668,79,163,1461,4831,0.0480218687872763,0.3024218588284
2016,16057,136,475,566,1215,106,144,672,1359,0.0637489445538981,0.494481236203091
2016,16059,33,72,98,267,0,0,98,267,0.0447086403215003,0.367041198501873
2016,16061,12,96,10,42,0,0,10,42,0.0154981549815498,0.238095238095238
2016,16063,47,149,11,52,0,31,11,83,0.0258970358814353,0.132530120481928
2016,16065,107,458,405,992,36,131,441,1123,0.071084947461704,0.392698130008905
2016,16067,32,544,41,198,0,158,41,356,0.0281045235651693,0.115168539325843
2016,16069,66,609,174,778,4,9,178,787,0.0284105266957872,0.226175349428208
2016,16071,0,8,9,104,0,0,9,104,0.0389951256092988,0.0865384615384615
2016,16073,34,476,32,353,0,14,32,367,0.0499116007071943,0.0871934604904632
2016,16075,27,351,69,840,26,33,95,873,0.0589466576637407,0.108820160366552
2016,16077,19,214,4,75,4,19,8,94,0.0205150589262331,0.0851063829787234
2016,16079,35,202,63,220,2,7,65,227,0.0247924858016601,0.286343612334802
2016,16081,18,76,178,453,132,153,310,606,0.0891701000588582,0.511551155115512
2016,16083,372,2171,384,1344,0,122,384,1466,0.0285380572318474,0.26193724420191
2016,16085,35,686,183,475,0,0,183,475,0.0638012088650101,0.385263157894737
2016,16087,6,250,13,164,2,9,15,173,0.0248064238600516,0.0867052023121387
2016,17001,90,376,138,567,14,59,152,626,0.0135709330558446,0.242811501597444
2016,17003,10,89,39,121,0,0,39,121,0.0251663893510815,0.322314049586777
2016,17005,137,656,62,171,0,0,62,171,0.0143000501756147,0.362573099415205
2016,17007,143,1388,229,518,0,85,229,603,0.0174076212471132,0.379767827529022
2016,17009,43,645,0,33,0,7,0,40,0.00803374171520386,0
2016,17011,140,560,24,148,3,10,27,158,0.00664256285209787,0.170886075949367
2016,17013,0,25,7,35,0,0,7,35,0.00980392156862745,0.2
2016,17015,27,233,23,123,4,27,27,150,0.0138478581979321,0.18
2016,17017,69,319,10,113,4,53,14,166,0.0187889077532541,0.0843373493975904
2016,17019,1081,2421,1945,3231,1029,1614,2974,4845,0.0408705554852588,0.613828689370485
2016,17021,101,975,74,244,14,66,88,310,0.012930674897806,0.283870967741935
2016,17023,39,193,31,227,8,28,39,255,0.0228187919463087,0.152941176470588
2016,17025,33,173,0,49,0,2,0,51,0.00544522741832159,0
2016,17027,100,1060,42,162,0,16,42,178,0.00666916448107906,0.235955056179775
2016,17029,258,988,196,636,35,50,231,686,0.0210377821393523,0.336734693877551
2016,17031,15129,30466,33801,51653,14665,23875,48466,75528,0.0212953606294097,0.641695794936977
2016,17033,46,662,39,191,0,3,39,194,0.0138998352081393,0.201030927835052
2016,17035,46,341,36,137,10,21,46,158,0.0208553326293559,0.291139240506329
2016,17037,895,2746,471,907,178,185,649,1092,0.017964662915803,0.594322344322344
2016,17039,36,389,15,66,0,0,15,66,0.00569407298766284,0.227272727272727
2016,17041,31,207,70,127,0,24,70,151,0.0114960030452988,0.463576158940397
2016,17043,10786,21850,5324,8428,2537,4129,7861,12557,0.0199513490238822,0.626025324520188
2016,17045,84,363,63,279,0,0,63,279,0.0219460394871391,0.225806451612903
2016,17047,21,171,13,40,0,0,13,40,0.00868998479252661,0.325
2016,17049,156,557,88,275,47,64,135,339,0.0146045149060831,0.398230088495575
2016,17051,77,937,38,204,0,0,38,204,0.0133963750985028,0.186274509803922
2016,17053,53,392,53,87,0,13,53,100,0.0104144969797959,0.53
2016,17055,159,684,86,303,8,47,94,350,0.0126308191988452,0.268571428571429
2016,17057,53,1152,37,278,0,27,37,305,0.0117915410190984,0.121311475409836
2016,17059,17,57,0,34,0,10,0,44,0.011539470233412,0
2016,17061,53,334,0,97,0,3,0,100,0.0105988341282459,0
2016,17063,162,1015,64,227,0,2,64,229,0.0069155040164281,0.279475982532751
2016,17065,14,135,0,9,0,7,0,16,0.00275957226629872,0
2016,17067,43,150,125,286,0,8,125,294,0.0219010727056019,0.425170068027211
2016,17069,12,86,9,35,0,0,9,35,0.0112251443232842,0.257142857142857
2016,17071,56,124,30,114,0,2,30,116,0.0226032735775526,0.258620689655172
2016,17073,146,678,132,344,27,55,159,399,0.0115958034235229,0.398496240601504
2016,17075,85,570,19,279,3,8,22,287,0.0141546656145196,0.0766550522648084
2016,17077,303,1279,359,925,154,242,513,1167,0.0332630258807434,0.439588688946015
2016,17079,24,129,2,23,0,1,2,24,0.003584229390681,0.0833333333333333
2016,17081,143,1113,45,285,16,43,61,328,0.0122365230367469,0.185975609756098
2016,17083,79,469,99,165,0,10,99,175,0.0113378684807256,0.565714285714286
2016,17085,110,445,44,188,3,20,47,208,0.0127756280326761,0.225961538461538
2016,17087,23,897,31,64,8,11,39,75,0.0080239649085268,0.52
2016,17089,4640,12224,1334,3855,422,1363,1756,5218,0.0154851039709884,0.336527405136067
2016,17091,283,1650,184,729,31,227,215,956,0.0131160136099221,0.22489539748954
2016,17093,1098,3362,137,1272,171,239,308,1511,0.0198606729758149,0.203838517538054
2016,17095,148,1094,88,266,7,39,95,305,0.00845812534664448,0.311475409836066
2016,17097,5237,10110,4322,9310,1647,2829,5969,12139,0.0268071471003275,0.491720899579867
2016,17099,402,2566,228,660,0,92,228,752,0.00965526096167426,0.303191489361702
2016,17101,8,1155,33,212,0,37,33,249,0.0206108765830643,0.132530120481928
2016,17103,198,1591,99,220,12,89,111,309,0.0124326064215016,0.359223300970874
2016,17105,122,1316,51,190,7,13,58,203,0.00778642936596218,0.285714285714286
2016,17107,148,2198,96,216,1,26,97,242,0.0115469033304705,0.400826446280992
2016,17109,115,467,178,265,5,58,183,323,0.0176252319109462,0.56656346749226
2016,17111,2405,5566,884,2536,33,255,917,2791,0.0136916412799796,0.328556073092082
2016,17113,1485,2851,1378,2229,636,781,2014,3010,0.0288787189745656,0.669102990033223
2016,17115,363,1839,363,909,49,145,412,1054,0.0142311275535693,0.390891840607211
2016,17117,80,1045,29,302,0,44,29,346,0.0105794221067115,0.0838150289017341
2016,17119,978,3923,715,2844,86,157,801,3001,0.0163300176305422,0.266911029656781
2016,17121,26,410,75,287,2,54,77,341,0.0128446587313545,0.225806451612903
2016,17123,40,256,11,42,2,16,13,58,0.00669823305231551,0.224137931034483
2016,17125,26,301,25,79,0,2,25,81,0.00811460629132438,0.308641975308642
2016,17127,32,104,18,311,0,12,18,323,0.0306248222243292,0.0557275541795666
2016,17129,40,247,10,110,0,0,10,110,0.0124773139745917,0.0909090909090909
2016,17131,44,226,84,171,0,8,84,179,0.0158057395143488,0.46927374301676
2016,17133,111,599,201,454,12,35,213,489,0.0207625679347826,0.43558282208589
2016,17135,38,1992,5,201,16,25,21,226,0.0107829572021566,0.0929203539823009
2016,17137,152,1142,55,334,40,52,95,386,0.0160799833368048,0.246113989637306
2016,17139,82,405,34,51,6,44,40,95,0.0093559188497144,0.421052631578947
2016,17141,197,1218,135,338,6,113,141,451,0.0125658243013569,0.312638580931264
2016,17143,1162,3298,935,2068,168,353,1103,2421,0.0194930675212161,0.455596860801322
2016,17145,33,845,42,88,0,14,42,102,0.00668720907362486,0.411764705882353
2016,17147,159,486,72,103,0,1,72,104,0.00898410504492052,0.692307692307692
2016,17149,59,386,28,117,0,25,28,142,0.0126921701823382,0.197183098591549
2016,17151,18,97,14,84,0,0,14,84,0.0257668711656442,0.166666666666667
2016,17153,0,48,0,46,0,11,0,57,0.0140671273445212,0
2016,17155,6,110,0,42,3,4,3,46,0.0109837631327603,0.0652173913043478
2016,17157,67,1122,62,253,0,7,62,260,0.0108428208015347,0.238461538461538
2016,17159,109,254,30,116,14,54,44,170,0.0152220630372493,0.258823529411765
2016,17161,239,1743,627,1999,71,319,698,2318,0.0230557296173624,0.301121656600518
2016,17163,998,3249,1425,4112,441,989,1866,5101,0.0287360854477444,0.365810625367575
2016,17165,51,323,0,192,4,12,4,204,0.0118680551515504,0.0196078431372549
2016,17167,1138,3004,894,2027,171,328,1065,2355,0.0172930343217165,0.452229299363057
2016,17169,13,154,0,11,4,6,4,17,0.00315809028422813,0.235294117647059
2016,17171,16,196,0,18,0,0,0,18,0.00494777350192413,0
2016,17173,81,417,13,102,0,5,13,107,0.00685019206145967,0.121495327102804
2016,17175,16,64,34,50,0,0,34,50,0.0119617224880383,0.68
2016,17177,177,804,124,355,0,28,124,383,0.0117571218074656,0.323759791122715
2016,17179,752,2940,412,994,39,118,451,1112,0.011820984373339,0.405575539568345
2016,17181,34,273,32,110,0,0,32,110,0.00878313637815394,0.290909090909091
2016,17183,144,1064,71,691,10,130,81,821,0.0152039852589863,0.0986601705237515
2016,17185,12,62,22,70,0,23,22,93,0.0115758028379388,0.236559139784946
2016,17187,64,303,53,135,0,2,53,137,0.0118553132571824,0.386861313868613
2016,17189,18,237,15,81,8,10,23,91,0.00887198986058302,0.252747252747253
2016,17191,51,240,8,182,0,48,8,230,0.0198807157057654,0.0347826086956522
2016,17193,16,284,9,111,0,1,9,112,0.0109097993376193,0.0803571428571429
2016,17195,78,736,96,389,41,131,137,520,0.0130837359098229,0.263461538461538
2016,17197,4859,13519,1596,3919,652,1289,2248,5208,0.0118295347685654,0.431643625192012
2016,17199,252,1353,150,652,0,58,150,710,0.015018508725542,0.211267605633803
2016,17201,1167,4275,740,2571,202,645,942,3216,0.0164983147710192,0.292910447761194
2016,17203,347,991,79,249,6,37,85,286,0.0110152518872285,0.297202797202797
2016,18001,35,369,35,181,7,59,42,240,0.0114602234743577,0.175
2016,18003,976,3429,1464,4556,193,511,1657,5067,0.0215435505403958,0.32701795934478
2016,18005,390,1422,501,1007,587,881,1088,1888,0.0348628935463023,0.576271186440678
2016,18007,40,432,33,110,0,5,33,115,0.019718792866941,0.28695652173913
2016,18009,10,262,7,60,0,14,7,74,0.00850574712643678,0.0945945945945946
2016,18011,636,1562,483,1064,22,65,505,1129,0.0277157235792316,0.447298494242693
2016,18013,100,432,15,83,0,0,15,83,0.00752834467120181,0.180722891566265
2016,18015,134,626,16,90,0,7,16,97,0.00700816414998916,0.164948453608247
2016,18017,166,775,18,146,6,86,24,232,0.00896756986587299,0.103448275862069
2016,18019,430,1968,384,1910,10,77,394,1987,0.0253279116900996,0.198288877705083
2016,18021,101,488,66,174,0,2,66,176,0.00964489259096887,0.375
2016,18023,108,637,45,175,0,22,45,197,0.0091922915402921,0.228426395939086
2016,18025,7,185,24,129,0,18,24,147,0.0198300283286119,0.163265306122449
2016,18027,72,503,61,145,9,17,70,162,0.00806572068707991,0.432098765432099
2016,18029,75,521,257,998,6,31,263,1029,0.0302593659942363,0.255587949465501
2016,18031,63,353,131,294,6,6,137,300,0.0169577751399016,0.456666666666667
2016,18033,99,742,36,348,28,53,64,401,0.0141826412958902,0.159600997506234
2016,18035,570,1903,216,837,19,143,235,980,0.013795045045045,0.239795918367347
2016,18037,126,507,96,345,1,3,97,348,0.0121840207268399,0.278735632183908
2016,18039,463,2515,421,1585,70,137,491,1722,0.0135402906208719,0.28513356562137
2016,18041,64,386,16,91,0,26,16,117,0.00711895345299665,0.136752136752137
2016,18043,356,1387,347,1069,26,92,373,1161,0.0223962653600571,0.321274763135228
2016,18045,114,379,13,115,0,32,13,147,0.0127063704728153,0.0884353741496599
2016,18047,140,531,123,290,0,23,123,313,0.0201714248888316,0.39297124600639
2016,18049,39,465,45,141,0,9,45,150,0.0107074023841816,0.3
2016,18051,128,508,74,279,2,25,76,304,0.0133070693806084,0.25
2016,18053,181,1001,18,650,19,110,37,760,0.0170026175082217,0.0486842105263158
2016,18055,22,757,38,287,0,4,38,291,0.0127794124105222,0.130584192439863
2016,18057,4690,8220,4198,5986,458,1132,4656,7118,0.0364778713896234,0.65411632481034
2016,18059,535,1798,155,529,15,61,170,590,0.0121271916301823,0.288135593220339
2016,18061,202,659,56,491,0,32,56,523,0.0190479659103325,0.107074569789675
2016,18063,1156,5552,1083,2086,30,173,1113,2259,0.0220089633671083,0.49269588313413
2016,18065,213,1665,29,236,0,46,29,282,0.00815099575107668,0.102836879432624
2016,18067,238,1542,213,914,51,196,264,1110,0.0193967776884633,0.237837837837838
2016,18069,135,856,36,345,8,85,44,430,0.0172857372567937,0.102325581395349
2016,18071,161,719,28,278,57,142,85,420,0.0142069478740317,0.202380952380952
2016,18073,115,607,19,265,0,14,19,279,0.0125686998828723,0.0681003584229391
2016,18075,80,330,10,85,0,0,10,85,0.00610193826274228,0.117647058823529
2016,18077,135,959,61,416,26,75,87,491,0.0223456059709644,0.177189409368635
2016,18079,49,649,0,194,8,33,8,227,0.0121131270010672,0.0352422907488987
2016,18081,1146,5026,732,2026,261,391,993,2417,0.0247912692063101,0.41083988415391
2016,18083,154,627,83,418,29,44,112,462,0.018651594670973,0.242424242424242
2016,18085,390,1960,369,823,20,49,389,872,0.016876003948056,0.446100917431193
2016,18087,56,620,93,390,0,15,93,405,0.0184476632959825,0.22962962962963
2016,18089,598,2719,1810,9017,415,971,2225,9988,0.0306914172809764,0.222767320784942
2016,18091,331,3825,323,1542,14,97,337,1639,0.0212705210563883,0.205613178767541
2016,18093,87,735,28,191,10,35,38,226,0.00707156043680966,0.168141592920354
2016,18095,638,2892,173,901,54,122,227,1023,0.0114040465971796,0.221896383186706
2016,18097,5337,14687,4279,10087,1048,2631,5327,12718,0.0209157335061236,0.418855165906589
2016,18099,213,830,53,316,15,36,68,352,0.0113937981485078,0.193181818181818
2016,18101,39,239,13,85,0,9,13,94,0.013185580025249,0.138297872340426
2016,18103,140,1648,37,180,0,9,37,189,0.00763636363636364,0.195767195767196
2016,18105,939,2469,1566,2520,806,1032,2372,3552,0.0440115976507323,0.667792792792793
2016,18107,182,707,111,456,19,27,130,483,0.0188937568455641,0.269151138716356
2016,18109,346,2686,102,412,13,31,115,443,0.00934895008969083,0.259593679458239
2016,18111,39,449,48,169,20,20,68,189,0.0192170818505338,0.35978835978836
2016,18113,157,1423,110,207,0,89,110,296,0.00943486437382463,0.371621621621622
2016,18115,15,114,5,157,0,17,5,174,0.0396897810218978,0.028735632183908
2016,18117,39,394,13,95,0,38,13,133,0.00995956267784933,0.0977443609022556
2016,18119,57,751,31,162,0,14,31,176,0.01178834561286,0.176136363636364
2016,18121,125,945,16,247,0,34,16,281,0.0233699268130406,0.0569395017793594
2016,18123,77,806,58,305,0,14,58,319,0.0234679614507467,0.181818181818182
2016,18125,8,226,17,57,0,0,17,57,0.00646992054483541,0.298245614035088
2016,18127,726,3143,1045,2524,68,204,1113,2728,0.0241281409479671,0.407991202346041
2016,18129,67,550,37,259,0,0,37,259,0.0146468359441271,0.142857142857143
2016,18131,16,385,16,51,11,21,27,72,0.00806090461262875,0.375
2016,18133,121,1917,37,285,19,33,56,318,0.0127900896915095,0.176100628930818
2016,18135,40,319,39,246,8,32,47,278,0.0159504274485054,0.169064748201439
2016,18137,94,454,78,225,0,42,78,267,0.0137366877604569,0.292134831460674
2016,18139,50,333,23,102,21,35,44,137,0.0118052563550194,0.321167883211679
2016,18141,631,2983,1885,3842,509,847,2394,4689,0.0270407427698163,0.510556621880998
2016,18143,49,359,31,138,8,23,39,161,0.00986821942997242,0.242236024844721
2016,18145,182,1160,64,273,24,61,88,334,0.0109257441936539,0.263473053892216
2016,18147,56,309,65,138,9,9,74,147,0.0101568437780695,0.503401360544218
2016,18149,61,532,2,39,1,11,3,50,0.00315497223624432,0.06
2016,18151,183,855,96,579,0,0,96,579,0.0248561861423543,0.16580310880829
2016,18153,94,766,13,75,0,20,13,95,0.00636345368075558,0.136842105263158
2016,18155,55,304,2,108,2,14,4,122,0.0172560113154173,0.0327868852459016
2016,18157,678,2938,1112,2420,828,1233,1940,3653,0.0362782290901146,0.53107035313441
2016,18159,99,444,0,33,0,17,0,50,0.00457624016108365,0
2016,18161,5,115,40,376,0,0,40,376,0.0755930840369924,0.106382978723404
2016,18163,707,2324,1022,2360,33,226,1055,2586,0.0211119275042861,0.407965970610982
2016,18165,59,251,14,125,0,7,14,132,0.0119673617407072,0.106060606060606
2016,18167,373,1815,711,1693,30,251,741,1944,0.0281062950004337,0.381172839506173
2016,18169,139,691,98,237,0,46,98,283,0.0128806153566064,0.346289752650177
2016,18171,21,197,16,41,0,0,16,41,0.00693387451378319,0.390243902439024
2016,18173,512,1680,288,563,40,99,328,662,0.0158195330609124,0.495468277945619
2016,18175,47,499,23,134,0,22,23,156,0.00822524517557735,0.147435897435897
2016,18177,190,837,336,1346,15,37,351,1383,0.0299324733789282,0.253796095444685
2016,18179,129,586,22,186,0,30,22,216,0.011529223378703,0.101851851851852
2016,18181,103,580,13,101,8,75,21,176,0.010508090035226,0.119318181818182
2016,18183,164,1039,69,267,0,3,69,270,0.0117739403453689,0.255555555555556
2016,19001,65,294,16,45,0,1,16,46,0.00872037914691943,0.347826086956522
2016,19003,0,53,8,15,1,10,9,25,0.00909752547307132,0.36
2016,19005,7,136,21,150,0,15,21,165,0.0167444692510656,0.127272727272727
2016,19007,28,269,24,128,0,1,24,129,0.014413407821229,0.186046511627907
2016,19009,22,135,0,50,0,6,0,56,0.0133079847908745,0
2016,19011,130,619,38,107,0,14,38,121,0.00694125745754933,0.31404958677686
2016,19013,451,1731,443,1227,53,159,496,1386,0.0166406531396326,0.357864357864358
2016,19015,237,644,152,404,0,18,152,422,0.0229597388465724,0.360189573459716
2016,19017,155,523,97,200,27,70,124,270,0.0166934586373192,0.459259259259259
2016,19019,55,405,39,186,7,17,46,203,0.014550928248871,0.226600985221675
2016,19021,90,263,139,391,1,44,140,435,0.0338626809901915,0.32183908045977
2016,19023,67,249,0,39,0,6,0,45,0.00428408225437928,0
2016,19025,83,608,4,77,2,4,6,81,0.0114844746916206,0.0740740740740741
2016,19027,87,464,49,126,0,26,49,152,0.010845522654299,0.322368421052632
2016,19029,96,360,25,109,0,7,25,116,0.0122492080253432,0.21551724137931
2016,19031,67,377,2,43,0,6,2,49,0.0038025764395468,0.0408163265306122
2016,19033,265,785,185,389,2,17,187,406,0.0131694184047488,0.460591133004926
2016,19035,33,229,38,115,0,22,38,137,0.0162862577270566,0.277372262773723
2016,19037,44,146,3,61,0,37,3,98,0.0117280995691719,0.0306122448979592
2016,19039,0,235,23,115,0,0,23,115,0.0185185185185185,0.2
2016,19041,84,405,88,197,0,20,88,217,0.0188892757660167,0.405529953917051
2016,19043,26,231,68,206,2,2,70,208,0.0165158011751628,0.336538461538462
2016,19045,90,311,84,666,15,71,99,737,0.0222624981120677,0.134328358208955
2016,19047,18,123,12,101,6,8,18,109,0.0098848281490886,0.165137614678899
2016,19049,1559,3199,753,1155,64,172,817,1327,0.0260625343703355,0.615674453654861
2016,19051,33,140,28,128,0,11,28,139,0.0251265365148228,0.201438848920863
2016,19053,27,172,44,104,0,0,44,104,0.0208919244676577,0.423076923076923
2016,19055,42,317,16,78,0,0,16,78,0.00654637012169534,0.205128205128205
2016,19057,48,648,168,573,43,80,211,653,0.0235044273270463,0.32312404287902
2016,19059,25,193,84,184,3,27,87,211,0.0166824794433903,0.412322274881517
2016,19061,253,840,582,1650,167,278,749,1928,0.0300864517337162,0.388485477178423
2016,19063,41,112,46,207,3,33,49,240,0.0357621814930711,0.204166666666667
2016,19065,31,434,35,145,0,19,35,164,0.0117782246480896,0.213414634146341
2016,19067,47,202,106,297,0,18,106,315,0.0283604933825515,0.336507936507937
2016,19069,71,173,33,110,0,0,33,110,0.015184980673661,0.3
2016,19071,6,67,23,109,7,14,30,123,0.0246246246246246,0.24390243902439
2016,19073,34,275,8,100,0,0,8,100,0.0157778479015462,0.08
2016,19075,51,158,36,67,0,24,36,91,0.0105507246376812,0.395604395604396
2016,19077,62,265,30,67,2,15,32,82,0.0108265117507262,0.390243902439024
2016,19079,81,265,49,83,11,13,60,96,0.00901662440123979,0.625
2016,19081,33,121,19,41,0,11,19,52,0.00669154548964097,0.365384615384615
2016,19083,83,385,39,159,1,8,40,167,0.0138085000826856,0.239520958083832
2016,19085,31,216,39,144,0,18,39,162,0.0161531558480407,0.240740740740741
2016,19087,53,453,48,272,8,13,56,285,0.0209112920977328,0.196491228070175
2016,19089,27,117,29,123,0,0,29,123,0.0191738113795791,0.235772357723577
2016,19091,48,230,4,53,0,11,4,64,0.00955651784381066,0.0625
2016,19093,40,101,14,70,0,0,14,70,0.0141901479829718,0.2
2016,19095,71,405,25,162,0,3,25,165,0.0145566828407587,0.151515151515152
2016,19097,81,410,34,144,0,16,34,160,0.0116127159239367,0.2125
2016,19099,126,1290,62,284,2,25,64,309,0.011983246723028,0.207119741100324
2016,19101,48,214,203,360,232,259,435,619,0.0497868575565029,0.702746365105008
2016,19103,808,2756,1699,2773,564,812,2263,3585,0.0430925678843172,0.631241283124128
2016,19105,147,487,10,112,0,97,10,209,0.0143219351743987,0.0478468899521531
2016,19107,96,270,7,16,0,0,7,16,0.00223713646532438,0.4375
2016,19109,47,310,15,86,1,10,16,96,0.00894687791239515,0.166666666666667
2016,19111,38,367,84,499,0,37,84,536,0.0216714510977237,0.156716417910448
2016,19113,873,2749,1029,2518,406,519,1435,3037,0.020927364061714,0.472505762265393
2016,19115,44,252,7,47,0,6,7,53,0.00691996344170257,0.132075471698113
2016,19117,9,223,72,173,9,13,81,186,0.0305268340718858,0.435483870967742
2016,19119,36,151,36,120,0,2,36,122,0.0160568570676494,0.295081967213115
2016,19121,93,556,0,144,0,13,0,157,0.0148071300575309,0
2016,19123,106,358,9,300,8,18,17,318,0.0211211477151966,0.0534591194968553
2016,19125,272,717,151,248,0,22,151,270,0.0124895920066611,0.559259259259259
2016,19127,129,803,110,530,0,68,110,598,0.0221473278767453,0.183946488294314
2016,19129,61,317,139,302,0,10,139,312,0.0306664045606448,0.445512820512821
2016,19131,27,75,19,104,3,7,22,111,0.0151722252597048,0.198198198198198
2016,19133,13,251,20,63,0,9,20,72,0.0109555690809495,0.277777777777778
2016,19135,36,231,11,66,0,8,11,74,0.0136506179671647,0.148648648648649
2016,19137,49,174,39,172,0,0,39,172,0.0234013605442177,0.226744186046512
2016,19139,69,379,79,200,50,117,129,317,0.0111737751145576,0.406940063091483
2016,19141,81,371,7,173,34,39,41,212,0.0217035217035217,0.193396226415094
2016,19143,17,119,29,89,0,3,29,92,0.0213110956682882,0.315217391304348
2016,19145,63,522,129,268,0,2,129,270,0.0243330930064888,0.477777777777778
2016,19147,85,278,26,68,3,3,29,71,0.0112913486005089,0.408450704225352
2016,19149,96,368,55,226,10,26,65,252,0.0149475057832612,0.257936507936508
2016,19151,23,151,8,53,0,5,8,58,0.011616262767875,0.137931034482759
2016,19153,3091,8616,2956,7580,290,912,3246,8492,0.0281135267379768,0.382242110221385
2016,19155,221,965,521,1982,40,233,561,2215,0.035317378063364,0.253273137697517
2016,19157,91,436,60,182,9,29,69,211,0.017533654645172,0.327014218009479
2016,19159,22,71,7,36,3,24,10,60,0.0170212765957447,0.166666666666667
2016,19161,29,199,27,56,2,17,29,73,0.0102614562833849,0.397260273972603
2016,19163,340,1155,1529,3629,260,436,1789,4065,0.0352919727040683,0.44009840098401
2016,19165,88,168,41,110,0,22,41,132,0.015647226173542,0.310606060606061
2016,19167,40,252,94,424,0,107,94,531,0.0258822382530708,0.177024482109228
2016,19169,584,1732,882,1315,758,833,1640,2148,0.0441711735795513,0.763500931098696
2016,19171,43,257,12,65,5,5,17,70,0.00589821368385575,0.242857142857143
2016,19173,14,138,4,81,1,37,5,118,0.0270580142169227,0.0423728813559322
2016,19175,14,294,21,99,11,18,32,117,0.0137034434293746,0.273504273504274
2016,19177,9,156,24,104,0,0,24,104,0.0201160541586074,0.230769230769231
2016,19179,177,534,96,381,27,89,123,470,0.0194810577799884,0.261702127659574
2016,19181,393,1538,97,436,10,13,107,449,0.0142888966680457,0.238307349665924
2016,19183,121,507,86,266,4,15,90,281,0.0187608492455602,0.320284697508897
2016,19185,1,72,15,98,0,8,15,106,0.0241898676403469,0.141509433962264
2016,19187,172,1136,94,438,112,132,206,570,0.0229496315980191,0.36140350877193
2016,19189,60,243,42,122,0,0,42,122,0.0165491047205643,0.344262295081967
2016,19191,55,313,110,187,25,28,135,215,0.0158426055559649,0.627906976744186
2016,19193,152,781,423,1625,7,150,430,1775,0.0272795733628414,0.242253521126761
2016,19195,21,219,9,65,0,1,9,66,0.0124153498871332,0.136363636363636
2016,19197,24,255,23,152,19,51,42,203,0.022636039250669,0.206896551724138
2016,20001,13,241,29,51,0,0,29,51,0.00580733318150763,0.568627450980392
2016,20003,35,212,18,92,0,22,18,114,0.0212805674817995,0.157894736842105
2016,20005,28,178,11,69,0,18,11,87,0.00846880171322885,0.126436781609195
2016,20007,6,69,3,90,0,1,3,91,0.0268357416691242,0.032967032967033
2016,20009,85,583,49,359,5,70,54,429,0.0236012543323981,0.125874125874126
2016,20011,0,147,11,153,0,3,11,156,0.0163145785400544,0.0705128205128205
2016,20013,67,247,18,140,1,3,19,143,0.0214232209737828,0.132867132867133
2016,20015,521,1958,213,896,13,60,226,956,0.0221717148290737,0.236401673640167
2016,20017,24,109,6,30,0,7,6,37,0.0193920335429769,0.162162162162162
2016,20019,29,105,0,44,0,0,0,44,0.0174119509299565,0
2016,20021,70,178,32,248,0,21,32,269,0.0189090397863068,0.118959107806691
2016,20023,9,42,0,27,21,21,21,48,0.0254102699841186,0.4375
2016,20025,12,41,29,70,0,3,29,73,0.0491582491582492,0.397260273972603
2016,20027,24,174,31,165,54,70,85,235,0.0405732044198895,0.361702127659574
2016,20029,53,244,43,102,0,41,43,143,0.0230162562369226,0.300699300699301
2016,20031,23,200,24,186,3,21,27,207,0.0348133198789102,0.130434782608696
2016,20033,0,35,0,13,0,0,0,13,0.00970873786407767,0
2016,20035,82,842,117,590,15,130,132,720,0.0307416421160497,0.183333333333333
2016,20037,128,422,280,490,26,26,306,516,0.0219546440879888,0.593023255813954
2016,20039,5,54,6,42,0,0,6,42,0.0193816335948316,0.142857142857143
2016,20041,63,496,101,360,0,35,101,395,0.0296124147237424,0.255696202531646
2016,20043,16,42,9,140,0,3,9,143,0.0277131782945736,0.0629370629370629
2016,20045,871,1758,1280,1936,396,524,1676,2460,0.037350257352383,0.68130081300813
2016,20047,14,77,6,35,0,0,6,35,0.0167865707434053,0.171428571428571
2016,20049,6,58,0,17,0,0,0,17,0.00834151128557409,0
2016,20051,156,636,154,332,1,100,155,432,0.0246631651061886,0.358796296296296
2016,20053,28,277,5,58,0,15,5,73,0.0157633340531203,0.0684931506849315
2016,20055,96,308,93,405,15,108,108,513,0.0238106289162219,0.210526315789474
2016,20057,165,518,99,507,10,219,109,726,0.0357970514274444,0.150137741046832
2016,20059,54,427,46,251,0,14,46,265,0.0156259213397016,0.173584905660377
2016,20061,166,910,479,1899,90,698,569,2597,0.132297503820683,0.219098960338853
2016,20063,18,52,9,27,13,13,22,40,0.0205867215645908,0.55
2016,20065,16,58,0,11,0,0,0,11,0.00566718186501803,0
2016,20067,15,88,27,54,0,1,27,55,0.0117798243735275,0.490909090909091
2016,20069,39,110,14,81,0,3,14,84,0.0222929936305732,0.166666666666667
2016,20071,0,19,0,5,0,9,0,14,0.0160550458715596,0
2016,20073,37,182,1,23,0,1,1,24,0.00527936647602288,0.0416666666666667
2016,20075,0,32,10,41,2,2,12,43,0.0274584929757344,0.27906976744186
2016,20077,15,69,21,57,0,3,21,60,0.0148184736972092,0.35
2016,20079,178,585,57,319,0,114,57,433,0.0188441117590739,0.131639722863741
2016,20081,4,74,9,40,0,0,9,40,0.0161290322580645,0.225
2016,20083,10,47,8,21,8,8,16,29,0.0209537572254335,0.551724137931034
2016,20085,113,376,92,214,0,0,92,214,0.0238413547237077,0.429906542056075
2016,20087,198,669,0,60,0,0,0,60,0.00455753892897835,0
2016,20089,11,52,0,20,0,4,0,24,0.0107095046854083,0
2016,20091,2794,6826,7889,14192,1023,1757,8912,15949,0.0416097051917558,0.558781114803436
2016,20093,21,92,0,67,0,47,0,114,0.0459122029802658,0
2016,20095,45,134,29,160,0,0,29,160,0.0293201392706615,0.18125
2016,20097,11,43,8,18,0,0,8,18,0.0109555690809495,0.444444444444444
2016,20099,32,452,74,223,0,10,74,233,0.0165177938465901,0.317596566523605
2016,20101,2,33,2,13,0,3,2,16,0.013663535439795,0.125
2016,20103,328,1807,1879,3382,329,467,2208,3849,0.0725145537783304,0.573655494933749
2016,20105,21,91,7,27,0,8,7,35,0.0160476845483723,0.2
2016,20107,14,175,43,81,2,4,45,85,0.012711230746224,0.529411764705882
2016,20109,6,48,2,9,1,10,3,19,0.00992685475444096,0.157894736842105
2016,20111,106,505,74,566,0,0,74,566,0.0283014150707535,0.130742049469965
2016,20113,200,666,103,315,0,45,103,360,0.0181488203266788,0.286111111111111
2016,20115,26,231,29,76,8,30,37,106,0.0125995483180792,0.349056603773585
2016,20117,19,158,17,88,6,6,23,94,0.0133409026397956,0.24468085106383
2016,20119,9,95,5,41,0,3,5,44,0.0157086754730453,0.113636363636364
2016,20121,101,691,66,410,28,28,94,438,0.0199671772428884,0.214611872146119
2016,20123,80,187,18,18,0,1,18,19,0.00444548432381844,0.947368421052632
2016,20125,140,534,147,569,40,68,187,637,0.0281310722487193,0.293563579277865
2016,20127,30,99,12,149,3,29,15,178,0.0429433051869723,0.0842696629213483
2016,20129,26,58,2,7,0,0,2,7,0.00359158542842483,0.285714285714286
2016,20131,76,189,27,55,0,13,27,68,0.0100755667506297,0.397058823529412
2016,20133,125,564,23,49,11,41,34,90,0.00833256179983335,0.377777777777778
2016,20135,19,27,0,12,0,4,0,16,0.00725952813067151,0
2016,20137,39,437,6,43,0,0,6,43,0.0106304079110012,0.13953488372093
2016,20139,47,507,60,165,0,0,60,165,0.0149782135076253,0.363636363636364
2016,20141,31,97,12,76,0,11,12,87,0.032258064516129,0.137931034482759
2016,20143,20,184,6,44,0,0,6,44,0.0106563332526035,0.136363636363636
2016,20145,56,513,69,227,0,7,69,234,0.0463182897862233,0.294871794871795
2016,20147,37,131,18,29,0,0,18,29,0.00762957116548277,0.620689655172414
2016,20149,178,598,173,455,5,22,178,477,0.0331273005069797,0.373165618448637
2016,20151,25,173,115,147,0,35,115,182,0.0287610619469027,0.631868131868132
2016,20153,11,43,21,26,0,10,21,36,0.0189274447949527,0.583333333333333
2016,20155,363,1566,109,734,0,175,109,909,0.020954356846473,0.11991199119912
2016,20157,12,64,9,66,0,0,9,66,0.0186072737524669,0.136363636363636
2016,20159,67,319,15,66,0,2,15,68,0.0106583072100313,0.220588235294118
2016,20161,437,1621,813,1993,285,1035,1098,3028,0.0813147859713196,0.362615587846764
2016,20163,7,118,10,32,0,5,10,37,0.0102012682657844,0.27027027027027
2016,20165,16,64,8,37,0,0,8,37,0.0160242529233434,0.216216216216216
2016,20167,87,296,6,170,0,1,6,171,0.0342273819055244,0.0350877192982456
2016,20169,144,819,176,421,0,96,176,517,0.0140991027843683,0.340425531914894
2016,20171,39,224,17,17,0,0,17,17,0.00511585916340656,1
2016,20173,1479,4885,1973,5590,391,1141,2364,6731,0.0206780025498057,0.351210815629178
2016,20175,42,269,108,385,0,90,108,475,0.0360012126724269,0.227368421052632
2016,20177,548,2472,680,2225,68,325,748,2550,0.0212803244623589,0.293333333333333
2016,20179,0,63,5,8,0,16,5,24,0.0129171151776103,0.208333333333333
2016,20181,61,203,112,212,0,0,112,212,0.0513068731848984,0.528301886792453
2016,20183,1,21,6,37,0,0,6,37,0.0134106560347952,0.162162162162162
2016,20185,19,97,2,14,4,4,6,18,0.00604838709677419,0.333333333333333
2016,20187,4,23,15,29,0,6,15,35,0.0247349823321555,0.428571428571429
2016,20189,14,116,11,181,0,6,11,187,0.052690898844745,0.0588235294117647
2016,20191,134,661,44,276,1,20,45,296,0.0187841096585861,0.152027027027027
2016,20193,53,142,28,69,0,0,28,69,0.0136741973840666,0.405797101449275
2016,20195,8,100,14,41,0,0,14,41,0.018955154877485,0.341463414634146
2016,20197,25,250,5,71,2,8,7,79,0.0165757448594209,0.0886075949367089
2016,20199,11,18,0,15,0,0,0,15,0.0141376060320452,0
2016,20201,4,86,17,90,0,0,17,90,0.0227790432801822,0.188888888888889
2016,20203,0,13,3,14,0,0,3,14,0.00983836964160225,0.214285714285714
2016,20205,17,189,11,68,0,0,11,68,0.010935992280476,0.161764705882353
2016,20207,21,93,2,28,0,0,2,28,0.012012012012012,0.0714285714285714
2016,20209,714,2696,869,3078,206,623,1075,3701,0.0364562298683005,0.29046203728722
2016,21001,77,362,71,279,0,11,71,290,0.0227397475103897,0.244827586206897
2016,21003,58,493,0,306,21,46,21,352,0.0254574383452665,0.0596590909090909
2016,21005,132,919,7,46,4,11,11,57,0.00380761523046092,0.192982456140351
2016,21007,24,148,5,85,0,0,5,85,0.0147415886229622,0.0588235294117647
2016,21009,169,729,98,489,4,24,102,513,0.0174394887136252,0.198830409356725
2016,21011,66,411,0,67,0,26,0,93,0.011460258780037,0
2016,21013,24,559,73,324,0,0,73,324,0.0166769610870908,0.225308641975309
2016,21015,868,3313,942,2911,417,475,1359,3386,0.0415291967669533,0.401358535144714
2016,21017,82,456,64,224,0,0,64,224,0.0161394913178183,0.285714285714286
2016,21019,197,1030,220,1096,15,70,235,1166,0.0335713463088794,0.201543739279588
2016,21021,212,969,185,561,7,35,192,596,0.0300146044216145,0.322147651006711
2016,21023,47,196,0,32,0,10,0,42,0.00737100737100737,0
2016,21025,8,173,42,112,0,14,42,126,0.0134028294862249,0.333333333333333
2016,21027,10,414,22,282,0,72,22,354,0.0255282324944112,0.0621468926553672
2016,21029,307,2357,125,514,9,68,134,582,0.0109625164814466,0.230240549828179
2016,21031,4,204,6,91,0,0,6,91,0.0101167315175097,0.0659340659340659
2016,21033,124,254,32,140,0,3,32,143,0.0159991049451779,0.223776223776224
2016,21035,105,373,178,375,105,218,283,593,0.0254834550923936,0.477234401349073
2016,21037,500,1452,702,1833,16,64,718,1897,0.0306987733436903,0.378492356352135
2016,21039,24,75,1,21,0,0,1,21,0.00600686498855835,0.0476190476190476
2016,21041,14,327,46,306,0,10,46,316,0.0439132851584213,0.145569620253165
2016,21043,48,677,65,239,0,96,65,335,0.0182154314610407,0.194029850746269
2016,21045,45,321,28,249,0,39,28,288,0.025974025974026,0.0972222222222222
2016,21047,216,1292,245,2899,264,550,509,3449,0.0823287900126513,0.147579008408234
2016,21049,99,992,75,606,33,65,108,671,0.0268604139145751,0.160953800298063
2016,21051,41,363,41,322,0,15,41,337,0.0226220044304222,0.121661721068249
2016,21053,0,163,0,44,0,0,0,44,0.00630191922085362,0
2016,21055,0,152,0,102,0,0,0,102,0.0157919182535996,0
2016,21057,38,117,24,84,0,5,24,89,0.0185959047221061,0.269662921348315
2016,21059,154,1493,205,882,123,336,328,1218,0.0183430972425114,0.269293924466338
2016,21061,20,302,6,121,0,0,6,121,0.0140779522978476,0.0495867768595041
2016,21063,20,554,0,2,0,0,0,2,0.000354672814328782,0
2016,21065,47,351,0,42,0,11,0,53,0.00520117762512267,0
2016,21067,2231,7243,3094,6157,984,2115,4078,8272,0.0411734841169502,0.492988394584139
2016,21069,20,190,3,68,0,0,3,68,0.00692675970255679,0.0441176470588235
2016,21071,99,769,20,146,0,0,20,146,0.00550030138637734,0.136986301369863
2016,21073,417,1583,160,708,87,207,247,915,0.0263529276230523,0.269945355191257
2016,21075,9,324,0,136,0,0,0,136,0.0306513409961686,0
2016,21077,38,275,29,113,6,8,35,121,0.0215379138483446,0.289256198347107
2016,21079,77,543,0,61,7,23,7,84,0.00697674418604651,0.0833333333333333
2016,21081,93,829,45,118,0,0,45,118,0.00747782002534854,0.38135593220339
2016,21083,48,300,24,225,32,101,56,326,0.0128696064111168,0.171779141104294
2016,21085,105,602,0,148,0,35,0,183,0.0103688594254632,0
2016,21087,12,334,0,40,0,16,0,56,0.00707427993936331,0
2016,21089,86,710,137,533,0,14,137,547,0.0213014525487753,0.250457038391225
2016,21091,65,255,6,212,0,0,6,212,0.0362455120533424,0.0283018867924528
2016,21093,427,2518,1148,3457,258,800,1406,4257,0.0610602713789839,0.330279539581865
2016,21095,25,360,5,90,0,0,5,90,0.00463797990208709,0.0555555555555556
2016,21097,32,467,41,190,0,0,41,190,0.0148379539242483,0.215789473684211
2016,21099,84,311,18,123,10,14,28,137,0.0109276541437345,0.204379562043796
2016,21101,118,816,95,604,16,87,111,691,0.0216167177626228,0.160636758321274
2016,21103,33,617,0,78,0,0,0,78,0.0073342736248237,0
2016,21105,17,98,12,74,0,0,12,74,0.0223970944309927,0.162162162162162
2016,21107,71,851,33,109,12,37,45,146,0.00453571095715928,0.308219178082192
2016,21109,0,249,0,82,0,0,0,82,0.00884287717027931,0
2016,21111,2213,8385,4644,10326,926,2334,5570,12660,0.0243404900013651,0.439968404423381
2016,21113,573,2017,270,446,113,136,383,582,0.0176326233829188,0.65807560137457
2016,21115,65,467,41,252,0,44,41,296,0.0182670945445569,0.138513513513514
2016,21117,1067,3842,1285,3670,196,337,1481,4007,0.0364123767549639,0.369603194409783
2016,21119,24,287,59,187,0,3,59,190,0.0174104279299918,0.310526315789474
2016,21121,19,750,45,298,0,31,45,329,0.0154547162720782,0.13677811550152
2016,21123,65,454,37,72,0,30,37,102,0.0102978293791015,0.362745098039216
2016,21125,62,1649,92,700,0,34,92,734,0.0179554294380978,0.125340599455041
2016,21127,13,185,7,187,0,7,7,194,0.017799798146619,0.0360824742268041
2016,21129,6,371,2,117,0,0,2,117,0.0235792019347037,0.0170940170940171
2016,21131,0,217,0,127,12,12,12,139,0.0181509532515017,0.0863309352517986
2016,21133,23,172,2,40,14,14,16,54,0.00326146040949447,0.296296296296296
2016,21135,20,192,17,200,0,0,17,200,0.0210526315789474,0.085
2016,21137,141,997,12,74,0,10,12,84,0.00499970239866675,0.142857142857143
2016,21139,8,145,10,54,0,10,10,64,0.00939104915627293,0.15625
2016,21141,69,586,69,341,0,19,69,360,0.0197595916351062,0.191666666666667
2016,21143,59,521,37,143,0,23,37,166,0.0252126366950182,0.22289156626506
2016,21145,173,1040,260,725,0,82,260,807,0.0175335679833138,0.322180916976456
2016,21147,33,265,3,313,0,22,3,335,0.0272734673939591,0.00895522388059702
2016,21149,27,146,3,34,3,3,6,37,0.00562480997263606,0.162162162162162
2016,21151,350,1952,311,1057,70,122,381,1179,0.0221971194577803,0.323155216284987
2016,21153,2,135,0,0,0,10,0,10,0.00113096584483149,0
2016,21155,80,767,53,87,0,45,53,132,0.00997204804714059,0.401515151515151
2016,21157,86,561,83,347,22,22,105,369,0.0162949878560389,0.284552845528455
2016,21159,0,414,25,268,0,8,25,276,0.0316550063080629,0.0905797101449275
2016,21161,112,467,30,246,0,95,30,341,0.0289695013167955,0.0879765395894428
2016,21163,105,892,285,782,12,104,297,886,0.0463292198284878,0.335214446952596
2016,21165,1,172,4,51,0,16,4,67,0.0146096816397732,0.0597014925373134
2016,21167,163,787,51,98,0,38,51,136,0.00907513679434139,0.375
2016,21169,0,168,49,161,0,0,49,161,0.023079128440367,0.304347826086957
2016,21171,18,202,13,49,12,18,25,67,0.00899449590549067,0.373134328358209
2016,21173,114,1079,4,225,0,0,4,225,0.012158875979465,0.0177777777777778
2016,21175,18,568,7,65,0,0,7,65,0.00659697554044453,0.107692307692308
2016,21177,39,583,22,213,0,25,22,238,0.0109935793801099,0.092436974789916
2016,21179,96,1182,46,269,15,56,61,325,0.0108979947689625,0.187692307692308
2016,21181,15,147,0,48,0,8,0,56,0.0114730587994263,0
2016,21183,0,631,40,280,0,1,40,281,0.0170841439688716,0.142348754448399
2016,21185,543,3073,334,807,138,187,472,994,0.0234804998464555,0.474849094567404
2016,21187,26,307,23,51,2,8,25,59,0.00806561859193438,0.423728813559322
2016,21189,4,71,0,0,0,0,0,0,0,NA
2016,21191,13,195,24,134,0,0,24,134,0.0134551661813435,0.17910447761194
2016,21193,177,614,11,95,0,15,11,110,0.00563784531802573,0.1
2016,21195,145,830,126,688,0,98,126,786,0.0179071833777596,0.16030534351145
2016,21197,24,367,5,42,0,15,5,57,0.00682961897915169,0.087719298245614
2016,21199,139,1121,100,717,0,21,100,738,0.0165441176470588,0.13550135501355
2016,21201,7,48,8,17,0,0,8,17,0.0107120352867045,0.470588235294118
2016,21203,22,456,1,43,0,9,1,52,0.00439634764964491,0.0192307692307692
2016,21205,189,961,26,239,0,0,26,239,0.0171855899906522,0.108786610878661
2016,21207,30,284,3,53,0,7,3,60,0.00482936252414681,0.05
2016,21209,312,1230,234,747,31,124,265,871,0.0263484284720332,0.304247990815155
2016,21211,160,1375,158,583,21,115,179,698,0.0229892628944075,0.256446991404011
2016,21213,40,422,25,80,0,0,25,80,0.00657138163298834,0.3125
2016,21215,104,567,75,116,0,0,75,116,0.00952615586761928,0.646551724137931
2016,21217,90,695,0,172,16,70,16,242,0.0147219856430223,0.0661157024793388
2016,21219,32,244,39,199,4,31,43,230,0.0284583024003959,0.18695652173913
2016,21221,43,149,18,124,4,18,22,142,0.0138888888888889,0.154929577464789
2016,21223,4,230,0,28,20,20,20,48,0.0079773973741067,0.416666666666667
2016,21225,5,249,48,140,0,0,48,140,0.0143958868894602,0.342857142857143
2016,21227,363,2093,564,1982,120,451,684,2433,0.0331444296106585,0.281134401972873
2016,21229,46,337,7,57,0,0,7,57,0.00711077844311377,0.12280701754386
2016,21231,54,240,0,228,0,0,0,228,0.0157057243232073,0
2016,21233,32,356,10,49,0,0,10,49,0.00535226652102676,0.204081632653061
2016,21235,56,619,74,309,0,0,74,309,0.0134958071278826,0.239482200647249
2016,21237,10,219,0,22,0,0,0,22,0.00438421681944998,0
2016,21239,188,650,84,178,0,153,84,331,0.0187344351369708,0.253776435045317
2016,22001,220,1288,75,488,34,239,109,727,0.0181437021138536,0.149931224209078
2016,22003,33,728,49,444,0,138,49,582,0.032464996932002,0.084192439862543
2016,22005,607,1927,355,1186,57,184,412,1370,0.0183150183150183,0.300729927007299
2016,22007,37,331,37,204,0,12,37,216,0.0138978252477159,0.171296296296296
2016,22009,65,1099,7,90,0,21,7,111,0.00397521756258282,0.0630630630630631
2016,22011,183,1109,57,497,111,164,168,661,0.0274308005145869,0.254160363086233
2016,22013,47,344,36,125,0,11,36,136,0.014171095133896,0.264705882352941
2016,22015,893,3196,980,2392,140,518,1120,2910,0.0358665910715606,0.384879725085911
2016,22017,793,3496,744,1853,180,367,924,2220,0.0132276708574152,0.416216216216216
2016,22019,412,2220,815,3015,134,250,949,3265,0.0252961548295124,0.290658499234303
2016,22021,2,370,0,68,3,38,3,106,0.0157130151200712,0.0283018867924528
2016,22023,9,59,0,30,0,11,0,41,0.00900307422046552,0
2016,22025,24,462,101,122,0,0,101,122,0.0176965477226574,0.827868852459016
2016,22027,44,577,0,124,0,23,0,147,0.0125351752366334,0
2016,22029,69,793,8,119,0,9,8,128,0.00945067926757236,0.0625
2016,22031,26,395,8,200,0,29,8,229,0.012532151261424,0.0349344978165939
2016,22033,2246,6361,2569,4925,626,1189,3195,6114,0.0219038509076449,0.522571148184495
2016,22035,10,528,8,135,0,0,8,135,0.0293669784642158,0.0592592592592593
2016,22037,29,943,59,120,0,0,59,120,0.00843348091924942,0.491666666666667
2016,22039,26,768,4,291,0,195,4,486,0.0224594482184944,0.00823045267489712
2016,22041,78,609,34,126,0,11,34,137,0.0101368849426563,0.248175182481752
2016,22043,5,366,0,561,0,75,0,636,0.0404657377362092,0
2016,22045,267,1454,61,590,0,198,61,788,0.0166062547416337,0.0774111675126904
2016,22047,93,1431,9,308,0,7,9,315,0.0137940094587493,0.0285714285714286
2016,22049,19,715,34,240,0,0,34,240,0.0214094558429973,0.141666666666667
2016,22051,2159,7417,1548,4327,406,1229,1954,5556,0.0183401443180543,0.351691864650828
2016,22053,89,759,32,133,0,0,32,133,0.00643787211384869,0.240601503759398
2016,22055,1754,5550,1235,3515,189,579,1424,4094,0.0265856240218711,0.347826086956522
2016,22057,336,1858,205,504,62,227,267,731,0.0112383734337766,0.365253077975376
2016,22059,18,380,0,160,0,12,0,172,0.0169591796489844,0
2016,22061,227,771,137,396,0,29,137,425,0.0166666666666667,0.322352941176471
2016,22063,883,2718,40,1254,13,241,53,1495,0.0169088955493977,0.0354515050167224
2016,22065,14,498,10,153,0,23,10,176,0.0226921093347086,0.0568181818181818
2016,22067,30,268,80,163,0,0,80,163,0.00909648975947318,0.49079754601227
2016,22069,98,501,43,221,3,16,46,237,0.0101742938095647,0.194092827004219
2016,22071,2281,6645,4931,8398,904,1391,5835,9789,0.0369164975901888,0.596077229543365
2016,22073,575,3221,574,1241,54,143,628,1384,0.0138662071314785,0.453757225433526
2016,22075,50,204,128,422,0,80,128,502,0.0329569327731092,0.254980079681275
2016,22077,31,182,3,98,0,33,3,131,0.0085031805789952,0.0229007633587786
2016,22079,164,1674,329,1182,13,96,342,1278,0.0147246897791297,0.267605633802817
2016,22081,6,200,0,2,0,21,0,23,0.0039882087740593,0
2016,22083,93,566,58,134,0,9,58,143,0.010452452306118,0.405594405594406
2016,22085,27,297,9,125,6,20,15,145,0.00884577842850171,0.103448275862069
2016,22087,111,1172,42,372,75,141,117,513,0.0182335169717434,0.228070175438596
2016,22089,264,1306,115,462,56,138,171,600,0.0172880769895695,0.285
2016,22091,6,322,0,4,0,0,0,4,0.000556870388417096,0
2016,22093,4,375,8,43,0,3,8,46,0.00316891705704051,0.173913043478261
2016,22095,98,647,33,327,11,11,44,338,0.011783161931323,0.130177514792899
2016,22097,176,1267,53,373,1,12,54,385,0.00715214564369311,0.14025974025974
2016,22099,190,951,6,251,41,212,47,463,0.0131113187777872,0.101511879049676
2016,22101,51,530,75,242,25,78,100,320,0.0090955602296629,0.3125
2016,22103,1440,4615,1949,4115,178,533,2127,4648,0.0278775737874035,0.457616179001721
2016,22105,511,2425,279,1359,0,61,279,1420,0.0174522214711485,0.196478873239437
2016,22107,0,7,0,22,0,0,0,22,0.00675053697453206,0
2016,22109,386,1990,126,1256,17,165,143,1421,0.01932781110159,0.100633356790992
2016,22111,34,323,39,86,0,0,39,86,0.00553873897082501,0.453488372093023
2016,22113,165,1483,65,289,13,71,78,360,0.00927213722763097,0.216666666666667
2016,22115,98,483,542,2101,180,569,722,2670,0.0857473183891066,0.270411985018727
2016,22117,94,840,48,607,21,75,69,682,0.0217807869187532,0.101173020527859
2016,22119,101,715,7,205,26,59,33,264,0.00956833750135914,0.125
2016,22121,114,905,117,463,0,14,117,477,0.0286297341095973,0.245283018867925
2016,22123,8,213,12,97,0,0,12,97,0.0125128998968008,0.123711340206186
2016,22125,251,577,7,103,12,12,19,115,0.0108541764983483,0.165217391304348
2016,22127,7,453,39,104,0,11,39,115,0.0112900058904379,0.339130434782609
2016,23001,626,2029,412,1067,19,104,431,1171,0.0157829474081462,0.368061485909479
2016,23003,70,340,152,829,16,70,168,899,0.0176766683707578,0.186874304783092
2016,23005,1607,4071,3217,5812,570,1134,3787,6946,0.0337814177884989,0.54520587388425
2016,23007,103,599,163,430,2,12,165,442,0.0205438066465257,0.373303167420814
2016,23009,199,802,174,587,37,206,211,793,0.0194267515923567,0.266078184110971
2016,23011,711,2161,495,1232,31,57,526,1289,0.0149260644518811,0.408068269976726
2016,23013,208,759,284,663,68,78,352,741,0.024869109947644,0.475033738191633
2016,23015,171,692,198,395,33,47,231,442,0.0170045781556573,0.52262443438914
2016,23017,120,999,279,796,13,63,292,859,0.0205394290086557,0.339930151338766
2016,23019,435,2032,723,2068,116,178,839,2246,0.0210840545969998,0.373552983081033
2016,23021,38,284,36,104,0,2,36,106,0.00815447342103239,0.339622641509434
2016,23023,392,1156,167,450,19,41,186,491,0.018980980361837,0.378818737270876
2016,23025,138,1075,167,611,30,35,197,646,0.0172064777327935,0.304953560371517
2016,23027,249,757,221,586,45,136,266,722,0.0253386677897101,0.368421052631579
2016,23029,82,397,184,361,77,107,261,468,0.0199514004348382,0.557692307692308
2016,23031,762,2922,2302,4289,126,320,2428,4609,0.0317413312213767,0.526795400303753
2016,24001,87,861,175,938,64,136,239,1074,0.0211446459157758,0.222532588454376
2016,24003,3258,9102,5311,9601,807,1846,6118,11447,0.0299145187465537,0.534463178125273
2016,24005,5093,15259,4363,7933,1642,3502,6005,11435,0.0200935531938821,0.525142107564495
2016,24009,631,1929,586,1234,124,224,710,1458,0.0240486911771983,0.486968449931413
2016,24011,156,952,24,214,0,8,24,222,0.0100739665108681,0.108108108108108
2016,24013,1515,3140,354,1153,80,119,434,1272,0.0110865131521606,0.341194968553459
2016,24015,94,950,760,1965,62,144,822,2109,0.0304245589232389,0.389758179231863
2016,24017,699,2752,879,2274,62,335,941,2609,0.0256523705582758,0.360674587964737
2016,24019,278,635,31,213,0,51,31,264,0.011422143382512,0.117424242424242
2016,24021,1834,3897,1720,3339,537,942,2257,4281,0.0261734010748152,0.527213267928054
2016,24023,52,193,63,372,0,22,63,394,0.0185411764705882,0.15989847715736
2016,24025,1491,4298,1532,3270,203,499,1735,3769,0.0220244495348511,0.460334306182011
2016,24027,4678,8088,3741,5118,781,1618,4522,6736,0.0324884848192539,0.671318289786223
2016,24029,152,305,201,399,17,36,218,435,0.0312320505456634,0.501149425287356
2016,24031,4558,10191,17658,23932,5886,10005,23544,33937,0.0482075408713637,0.693756077437605
2016,24033,3350,9421,7315,18589,1692,4098,9007,22687,0.0379454242872793,0.397011504385772
2016,24035,439,1600,334,527,161,250,495,777,0.0227992957746479,0.637065637065637
2016,24037,536,2087,805,2375,155,387,960,2762,0.038092873791496,0.347574221578566
2016,24039,49,1577,180,409,9,12,189,421,0.024824576920809,0.448931116389549
2016,24041,260,929,265,761,6,30,271,791,0.0281114507072287,0.342604298356511
2016,24043,485,3388,592,2190,72,230,664,2420,0.0233311480467394,0.274380165289256
2016,24045,378,1732,328,1498,133,229,461,1727,0.0272165663315157,0.26693688477128
2016,24047,519,1345,262,899,34,139,296,1038,0.0268800497203232,0.285163776493256
2016,24510,5350,14010,5718,8772,1453,2755,7171,11527,0.0273138066589103,0.622104623926434
2016,25001,1543,3150,1292,2466,115,452,1407,2918,0.0177053437615664,0.482179575051405
2016,25003,401,860,703,1912,96,269,799,2181,0.0234723089175402,0.366345712975699
2016,25005,1922,6665,1860,4904,401,1042,2261,5946,0.015487440222544,0.380255634039691
2016,25007,93,124,269,369,0,102,269,471,0.037010843941537,0.571125265392781
2016,25009,4557,9897,3198,6762,1132,3354,4330,10116,0.0191770330574439,0.428034796362198
2016,25011,570,1416,484,812,68,269,552,1081,0.0206281963208915,0.51063829787234
2016,25013,1385,4338,1148,4019,248,1809,1396,5828,0.0186896706538819,0.239533287577213
2016,25015,1076,2595,1355,1858,445,682,1800,2540,0.0258106474001362,0.708661417322835
2016,25017,15630,24691,16843,22732,8464,12957,25307,35689,0.032680139551494,0.709098041413321
2016,25019,76,400,127,143,29,33,156,176,0.0226075786769428,0.886363636363636
2016,25021,11118,19094,5219,7355,2906,4345,8125,11700,0.0242833304276357,0.694444444444444
2016,25023,3666,9079,1486,3688,289,1474,1775,5162,0.0147974452763986,0.343858969391709
2016,25025,11733,19418,10995,13788,4351,7985,15346,21773,0.0417071325268894,0.704817893721582
2016,25027,3863,9613,3015,6658,1093,3086,4108,9744,0.0176229619380917,0.421592775041051
2016,26001,56,343,29,160,5,30,34,190,0.0222170252572498,0.178947368421053
2016,26003,55,534,6,67,0,12,6,79,0.010904071773637,0.0759493670886076
2016,26005,676,2706,214,598,4,91,218,689,0.00901525658807212,0.316400580551524
2016,26007,110,573,51,192,13,30,64,222,0.0104964539007092,0.288288288288288
2016,26009,133,584,58,189,5,18,63,207,0.0119722382880278,0.304347826086957
2016,26011,31,397,6,44,4,18,10,62,0.00542622089970243,0.161290322580645
2016,26013,54,447,23,48,0,2,23,50,0.0077857365306758,0.46
2016,26015,302,1363,150,389,9,58,159,447,0.0108642815477348,0.355704697986577
2016,26017,334,1620,163,485,73,136,236,621,0.00829061198333867,0.380032206119163
2016,26019,116,437,86,219,13,22,99,241,0.0185256360980859,0.410788381742739
2016,26021,350,1437,1296,2600,487,581,1783,3181,0.0297665278622561,0.560515561144294
2016,26023,155,983,94,414,4,53,98,467,0.015617162157643,0.209850107066381
2016,26025,450,2673,394,1186,66,184,460,1370,0.0150559377541376,0.335766423357664
2016,26027,52,812,166,831,5,59,171,890,0.0243555360954518,0.192134831460674
2016,26029,286,767,95,301,11,47,106,348,0.0182840329953239,0.304597701149425
2016,26031,147,679,90,273,0,23,90,296,0.015398220881236,0.304054054054054
2016,26033,102,1358,253,526,13,44,266,570,0.0215851857462037,0.466666666666667
2016,26035,100,952,4,189,2,16,6,205,0.00922384701912261,0.0292682926829268
2016,26037,770,2262,244,611,19,71,263,682,0.0131007722156057,0.385630498533724
2016,26039,85,597,7,68,6,24,13,92,0.00891041162227603,0.141304347826087
2016,26041,146,517,97,406,5,44,102,450,0.0169907494808382,0.226666666666667
2016,26043,68,198,71,417,9,47,80,464,0.0246729767095608,0.172413793103448
2016,26045,1166,4329,386,943,135,352,521,1295,0.0172416088617875,0.402316602316602
2016,26047,288,858,210,400,14,48,224,448,0.0188886078084155,0.5
2016,26049,1190,5934,730,3134,140,487,870,3621,0.0130026824092128,0.24026512013256
2016,26051,154,756,23,72,0,9,23,81,0.00432530570833556,0.283950617283951
2016,26053,16,430,56,220,11,15,67,235,0.0197462398117805,0.285106382978723
2016,26055,682,2856,500,1084,81,147,581,1231,0.0190201016671559,0.471974004874086
2016,26057,89,1210,62,172,9,62,71,234,0.00828025477707006,0.303418803418803
2016,26059,67,652,178,526,0,63,178,589,0.0188649029530459,0.302207130730051
2016,26061,91,394,201,429,91,187,292,616,0.0287447503499767,0.474025974025974
2016,26063,134,611,33,103,0,24,33,127,0.00540080799489687,0.259842519685039
2016,26065,2281,6636,1690,3207,951,1231,2641,4438,0.0260814884901768,0.595087877422262
2016,26067,411,2491,37,496,0,86,37,582,0.0134491842676896,0.063573883161512
2016,26069,205,865,91,509,12,32,103,541,0.0277322124256715,0.190388170055453
2016,26071,5,61,25,172,2,13,27,185,0.0207538703163563,0.145945945945946
2016,26073,337,1488,180,495,106,294,286,789,0.0210906174819567,0.362484157160963
2016,26075,1016,4973,308,923,89,237,397,1160,0.0105934138189257,0.342241379310345
2016,26077,1873,4614,1209,3319,288,430,1497,3749,0.0234126661962068,0.399306481728461
2016,26079,161,747,18,147,7,13,25,160,0.0129387028950348,0.15625
2016,26081,4823,11912,3149,6188,756,1663,3905,7851,0.0192142495282707,0.497388867660171
2016,26083,17,50,15,28,0,2,15,30,0.0175438596491228,0.5
2016,26085,31,446,26,114,4,6,30,120,0.0137284063608283,0.25
2016,26087,514,2318,179,580,39,162,218,742,0.0120693581443768,0.293800539083558
2016,26089,301,771,176,370,6,14,182,384,0.0230935770988694,0.473958333333333
2016,26091,306,1943,294,845,18,118,312,963,0.0142588507040585,0.32398753894081
2016,26093,1813,4391,478,1176,150,290,628,1466,0.0114581379353467,0.42837653478854
2016,26095,67,358,8,31,0,12,8,43,0.00874694873881204,0.186046511627907
2016,26097,109,243,31,135,6,31,37,166,0.0197760304979747,0.22289156626506
2016,26099,4926,18662,1230,4133,1123,2546,2353,6679,0.0111707830252267,0.352298248240755
2016,26101,75,725,100,313,13,29,113,342,0.0188637617209046,0.330409356725146
2016,26103,214,1233,346,900,53,99,399,999,0.0223815391508906,0.399399399399399
2016,26105,204,905,114,409,6,51,120,460,0.0223561430793157,0.260869565217391
2016,26107,251,1020,48,200,0,28,48,228,0.00860962162978627,0.210526315789474
2016,26109,49,315,95,448,4,32,99,480,0.0277264325323475,0.20625
2016,26111,389,1805,468,1023,201,285,669,1308,0.0227537618509176,0.511467889908257
2016,26113,52,490,34,126,0,8,34,134,0.0128710018249928,0.253731343283582
2016,26115,417,2540,418,1696,21,151,439,1847,0.0178178661007139,0.237682728749323
2016,26117,234,2086,86,412,16,65,102,477,0.011018711018711,0.213836477987421
2016,26119,50,419,14,133,4,6,18,139,0.018697874630078,0.129496402877698
2016,26121,574,4681,174,1051,66,207,240,1258,0.0108495040965934,0.190779014308426
2016,26123,132,1235,68,384,11,58,79,442,0.0133684178689169,0.178733031674208
2016,26125,11083,26448,7421,11559,4957,6819,12378,18378,0.0213509736197324,0.673522690173033
2016,26127,192,814,48,218,10,59,58,277,0.015547822182308,0.209386281588448
2016,26129,64,640,14,133,3,16,17,149,0.009517725966145,0.114093959731544
2016,26131,8,48,13,70,0,10,13,80,0.0158321789036216,0.1625
2016,26133,67,574,30,176,0,7,30,183,0.0114439372146833,0.163934426229508
2016,26135,19,260,17,58,0,27,17,85,0.0136480411046885,0.2
2016,26137,239,740,53,227,10,16,63,243,0.0143252962329777,0.259259259259259
2016,26139,1854,6066,1106,2020,298,637,1404,2657,0.0156573186326217,0.528415506210011
2016,26141,75,382,49,96,0,13,49,109,0.0108145649369977,0.44954128440367
2016,26143,84,734,43,319,0,25,43,344,0.0182155149589621,0.125
2016,26145,665,2901,333,1323,107,359,440,1682,0.0127535352769458,0.261593341260404
2016,26147,655,3637,327,1315,46,141,373,1456,0.013036665622062,0.256181318681319
2016,26149,190,1060,85,560,8,25,93,585,0.0143907898944675,0.158974358974359
2016,26151,113,932,53,254,6,35,59,289,0.00987089282054785,0.204152249134948
2016,26153,31,157,15,49,0,2,15,51,0.00834833851694222,0.294117647058824
2016,26155,248,1268,165,493,3,46,168,539,0.0113428312885372,0.311688311688312
2016,26157,120,1040,83,342,4,42,87,384,0.0100723953415172,0.2265625
2016,26159,291,1429,165,676,132,287,297,963,0.0189190782106442,0.308411214953271
2016,26161,2948,7202,4228,5919,2349,3010,6577,8929,0.0403024148047845,0.7365886437451
2016,26163,6618,19748,3770,11101,2114,4970,5884,16071,0.0137553901169349,0.366125318897393
2016,26165,85,779,52,246,0,27,52,273,0.0120492563004811,0.19047619047619
2016,27001,41,372,12,86,2,20,14,106,0.00870136266622886,0.132075471698113
2016,27003,2688,10010,899,2819,138,565,1037,3384,0.0147173307006824,0.306442080378251
2016,27005,189,687,192,390,10,77,202,467,0.0204510619662798,0.43254817987152
2016,27007,297,759,131,383,27,70,158,453,0.016442831215971,0.34878587196468
2016,27009,450,1900,7,342,0,52,7,394,0.014844956859199,0.0177664974619289
2016,27011,43,101,6,32,0,4,6,36,0.00970612024804529,0.166666666666667
2016,27013,507,1293,249,703,60,112,309,815,0.0214795878027568,0.379141104294479
2016,27015,90,218,36,165,2,21,38,186,0.0107081174438687,0.204301075268817
2016,27017,225,938,60,245,0,6,60,251,0.0101743007701662,0.239043824701195
2016,27019,1536,3662,537,921,120,244,657,1165,0.0186534304699384,0.563948497854077
2016,27021,151,698,54,165,10,37,64,202,0.00976081179028751,0.316831683168317
2016,27023,90,442,36,83,5,7,41,90,0.0106559318020365,0.455555555555556
2016,27025,368,2080,99,290,22,54,121,344,0.00926923906014227,0.351744186046512
2016,27027,127,570,495,1197,53,78,548,1275,0.0344752994619149,0.429803921568627
2016,27029,30,178,8,69,0,19,8,88,0.0147206423553028,0.0909090909090909
2016,27031,26,74,15,42,4,25,19,67,0.0163694111898363,0.283582089552239
2016,27033,56,266,61,145,3,25,64,170,0.0214321734745335,0.376470588235294
2016,27035,334,1381,126,733,19,90,145,823,0.0184186379607457,0.176184690157959
2016,27037,4151,10232,2140,4034,724,1622,2864,5656,0.0205415770817595,0.506364922206506
2016,27039,124,627,33,94,3,23,36,117,0.00887035633055345,0.307692307692308
2016,27041,162,904,97,251,0,22,97,273,0.0104003962055697,0.355311355311355
2016,27043,52,327,31,68,0,20,31,88,0.00866738894907909,0.352272727272727
2016,27045,70,361,64,201,5,17,69,218,0.0151157953127167,0.31651376146789
2016,27047,148,574,62,226,4,28,66,254,0.0116119594038585,0.259842519685039
2016,27049,293,1177,74,399,30,96,104,495,0.0152439024390244,0.21010101010101
2016,27051,13,100,9,47,2,4,11,51,0.012002824193928,0.215686274509804
2016,27053,11004,23240,10766,18779,4105,6681,14871,25460,0.0306134718514778,0.584092694422624
2016,27055,25,174,67,260,3,6,70,266,0.019859638644169,0.263157894736842
2016,27057,166,568,46,186,4,11,50,197,0.0131675690127665,0.253807106598985
2016,27059,324,1495,40,141,0,69,40,210,0.00803920067376158,0.19047619047619
2016,27061,224,1010,71,349,10,37,81,386,0.0118740002460933,0.209844559585492
2016,27063,77,230,5,87,8,17,13,104,0.0145515600951448,0.125
2016,27065,61,477,50,155,4,16,54,171,0.0151932474455797,0.315789473684211
2016,27067,151,653,89,324,26,45,115,369,0.0129075136420876,0.311653116531165
2016,27069,7,57,8,26,2,3,10,29,0.00915115178289681,0.344827586206897
2016,27071,6,125,65,96,1,10,66,106,0.0111391340899538,0.622641509433962
2016,27073,26,85,7,54,2,11,9,65,0.0128306356099487,0.138461538461538
2016,27075,89,222,68,110,21,31,89,141,0.0173325138291334,0.631205673758865
2016,27077,12,84,1,28,0,0,1,28,0.00962199312714777,0.0357142857142857
2016,27079,190,765,49,230,12,18,61,248,0.013141857877166,0.245967741935484
2016,27081,15,129,29,94,0,0,29,94,0.0228044638524988,0.308510638297872
2016,27083,98,420,155,310,1,9,156,319,0.0193944552529183,0.489028213166144
2016,27085,161,764,24,53,1,23,25,76,0.00307729683767259,0.328947368421053
2016,27087,13,119,6,26,0,0,6,26,0.00773349196906603,0.230769230769231
2016,27089,33,136,18,114,0,7,18,121,0.0184563758389262,0.148760330578512
2016,27091,82,311,34,230,2,41,36,271,0.0189034598214286,0.132841328413284
2016,27093,95,647,23,87,13,70,36,157,0.00994237223735039,0.229299363057325
2016,27095,76,934,31,119,0,16,31,135,0.00761464267584184,0.22962962962963
2016,27097,125,752,43,123,3,58,46,181,0.00798095154107324,0.25414364640884
2016,27099,158,939,110,343,71,187,181,530,0.0202336412918989,0.341509433962264
2016,27101,44,187,32,71,2,12,34,83,0.0135887360838245,0.409638554216867
2016,27103,367,1291,70,280,35,64,105,344,0.0160022328697027,0.305232558139535
2016,27105,25,184,57,229,4,67,61,296,0.0211988827615842,0.206081081081081
2016,27107,32,87,28,80,0,10,28,90,0.0193465176268272,0.311111111111111
2016,27109,850,2363,1281,2240,474,742,1755,2982,0.0294696063801401,0.588531187122736
2016,27111,240,1034,276,729,9,49,285,778,0.0189206935966342,0.366323907455013
2016,27113,56,324,67,254,0,10,67,264,0.0272445820433437,0.253787878787879
2016,27115,153,957,49,333,0,27,49,360,0.017095640611644,0.136111111111111
2016,27117,31,138,10,124,0,53,10,177,0.0280373831775701,0.0564971751412429
2016,27119,122,499,138,473,40,50,178,523,0.0249296915963583,0.340344168260038
2016,27121,60,382,7,79,3,8,10,87,0.0109461499748364,0.114942528735632
2016,27123,7172,16814,3854,6888,1272,2611,5126,9499,0.0271435674402922,0.539635751131698
2016,27125,25,119,0,8,0,2,0,10,0.003584229390681,0
2016,27127,73,231,18,92,8,24,26,116,0.0109289617486339,0.224137931034483
2016,27129,47,307,33,101,4,13,37,114,0.010817992028848,0.324561403508772
2016,27131,427,2600,230,597,44,184,274,781,0.0189978107516419,0.350832266325224
2016,27133,33,90,77,246,8,8,85,254,0.0391190512860003,0.334645669291339
2016,27135,71,271,14,82,0,24,14,106,0.0101087163837498,0.132075471698113
2016,27137,745,2475,860,1897,94,185,954,2082,0.0153048847723012,0.45821325648415
2016,27139,1559,4789,397,1142,53,271,450,1413,0.0158657085111161,0.318471337579618
2016,27141,777,3750,195,641,60,119,255,760,0.0129987856397626,0.335526315789474
2016,27143,42,259,1,147,2,45,3,192,0.0187426786411558,0.015625
2016,27145,718,3269,439,1202,94,400,533,1602,0.0169617143825174,0.33270911360799
2016,27147,81,790,130,321,54,57,184,378,0.0154968842243358,0.486772486772487
2016,27149,32,219,34,64,43,49,77,113,0.0197621545995103,0.68141592920354
2016,27151,46,202,35,73,0,25,35,98,0.014672855217847,0.357142857142857
2016,27153,120,623,85,144,0,37,85,181,0.0109108445355356,0.469613259668508
2016,27155,3,34,10,41,0,5,10,46,0.0185036202735318,0.217391304347826
2016,27157,134,553,51,113,5,32,56,145,0.00963583200425306,0.386206896551724
2016,27159,42,356,18,81,0,17,18,98,0.0104667307486917,0.183673469387755
2016,27161,80,503,37,242,12,30,49,272,0.0206639823748386,0.180147058823529
2016,27163,3439,7860,1415,2712,297,617,1712,3329,0.020008895513776,0.514268549113848
2016,27165,71,241,10,24,0,3,10,27,0.00363489499192246,0.37037037037037
2016,27167,19,80,86,212,0,3,86,215,0.0464162348877375,0.4
2016,27169,88,309,175,576,26,44,201,620,0.0199806638736706,0.324193548387097
2016,27171,966,3336,173,713,18,128,191,841,0.0101090235957352,0.227110582639715
2016,27173,39,224,36,104,10,21,46,125,0.0178494930743967,0.368
2016,28001,48,80,46,422,21,369,67,791,0.0357030015797788,0.0847029077117573
2016,28003,35,702,104,775,0,0,104,775,0.0307673984675851,0.134193548387097
2016,28005,47,135,5,12,0,0,5,12,0.00129799891833423,0.416666666666667
2016,28007,37,466,25,330,4,19,29,349,0.0276501346854698,0.0830945558739255
2016,28009,4,122,47,193,0,2,47,195,0.0340314136125654,0.241025641025641
2016,28011,130,598,143,295,19,27,162,322,0.0150862068965517,0.503105590062112
2016,28013,10,322,2,40,7,21,9,61,0.00616161616161616,0.147540983606557
2016,28015,15,148,46,64,21,21,67,85,0.0116854550453671,0.788235294117647
2016,28017,35,453,0,26,0,0,0,26,0.00229297116147808,0
2016,28019,13,184,0,171,0,0,0,171,0.0299947377653043,0
2016,28021,2,64,0,11,0,15,0,26,0.00492704187985598,0
2016,28023,17,123,29,131,0,16,29,147,0.0132337054375225,0.197278911564626
2016,28025,34,208,61,149,0,7,61,156,0.0116461366181411,0.391025641025641
2016,28027,46,334,45,344,0,0,45,344,0.0226524430396418,0.130813953488372
2016,28029,35,446,44,146,0,21,44,167,0.00889717634523175,0.263473053892216
2016,28031,142,504,7,42,0,33,7,75,0.00586029067041725,0.0933333333333333
2016,28033,252,2212,1207,4153,56,351,1263,4504,0.0407587055672193,0.280417406749556
2016,28035,573,2641,254,902,67,165,321,1067,0.0228857001908929,0.300843486410497
2016,28037,27,54,0,16,0,43,0,59,0.011071495590167,0
2016,28039,66,493,4,265,0,10,4,275,0.0181614053625677,0.0145454545454545
2016,28041,17,1316,0,102,0,0,0,102,0.0102450783447168,0
2016,28043,87,319,11,104,0,8,11,112,0.00773213669313083,0.0982142857142857
2016,28045,166,848,204,1210,45,74,249,1284,0.0401375429821819,0.19392523364486
2016,28047,607,3446,1528,5617,205,555,1733,6172,0.0475376249672659,0.280784186649384
2016,28049,1316,3935,747,1891,105,357,852,2248,0.0145507268890701,0.379003558718861
2016,28051,20,106,17,82,0,38,17,120,0.0107421000805658,0.141666666666667
2016,28053,0,105,0,0,0,0,0,0,0,NA
2016,28055,8,157,0,24,0,0,0,24,0.0227703984819734,0
2016,28057,83,555,38,179,0,23,38,202,0.0129032258064516,0.188118811881188
2016,28059,402,1886,375,1683,31,183,406,1866,0.0197715569306406,0.217577706323687
2016,28061,46,330,0,81,0,3,0,84,0.00745672436750999,0
2016,28063,0,114,0,12,0,0,0,12,0.00243062588616569,0
2016,28065,3,253,47,75,0,0,47,75,0.00917543430389038,0.626666666666667
2016,28067,194,684,158,341,0,21,158,362,0.0080841465865696,0.43646408839779
2016,28069,26,263,5,77,0,0,5,77,0.0112375948628138,0.0649350649350649
2016,28071,342,1058,578,994,70,88,648,1082,0.0366779661016949,0.598890942698706
2016,28073,1002,3576,554,1026,15,42,569,1068,0.0277460251480827,0.532771535580524
2016,28075,236,1476,444,1380,0,29,444,1409,0.0269196232399075,0.315117104329312
2016,28077,5,126,17,85,0,7,17,92,0.0109146992525804,0.184782608695652
2016,28079,27,446,57,168,8,36,65,204,0.0140971598369152,0.318627450980392
2016,28081,451,2075,263,855,105,151,368,1006,0.0179690988657676,0.365805168986084
2016,28083,18,223,10,94,0,53,10,147,0.00794852384557154,0.0680272108843537
2016,28085,47,215,33,116,0,17,33,133,0.00578738958269875,0.24812030075188
2016,28087,197,986,345,862,61,119,406,981,0.0249263136497612,0.413863404689093
2016,28089,1286,2790,880,1360,78,218,958,1578,0.0235793374475143,0.607097591888466
2016,28091,98,569,27,321,7,40,34,361,0.02074474198368,0.0941828254847645
2016,28093,65,573,21,206,0,35,21,241,0.00984557561892311,0.0871369294605809
2016,28095,117,595,35,126,0,26,35,152,0.00618892508143322,0.230263157894737
2016,28097,20,134,14,40,0,42,14,82,0.0116925709396834,0.170731707317073
2016,28099,99,576,0,139,0,0,0,139,0.00745508179136498,0
2016,28101,56,438,0,70,0,0,0,70,0.0050654895433823,0
2016,28103,0,112,10,88,0,32,10,120,0.0165152766308836,0.0833333333333333
2016,28105,220,698,360,671,44,75,404,746,0.0299490144124614,0.541554959785523
2016,28107,47,421,4,170,0,0,4,170,0.00764044943820225,0.0235294117647059
2016,28109,39,474,101,1431,0,11,101,1442,0.0389224789462319,0.0700416088765603
2016,28111,34,285,22,129,0,27,22,156,0.0188065099457505,0.141025641025641
2016,28113,30,418,68,413,0,26,68,439,0.0172386711694023,0.154897494305239
2016,28115,58,757,38,482,0,0,38,482,0.0241870734644721,0.0788381742738589
2016,28117,145,546,40,93,0,1,40,94,0.00560993077106708,0.425531914893617
2016,28119,0,148,0,65,0,5,0,70,0.0139192682441837,0
2016,28121,1419,5141,771,1749,31,190,802,1939,0.0193302694673459,0.413615265600825
2016,28123,92,737,57,207,0,17,57,224,0.0123280132085856,0.254464285714286
2016,28125,37,97,0,22,0,0,0,22,0.0072083879423329,0
2016,28127,77,474,0,134,0,7,0,141,0.00779608536989937,0
2016,28129,25,202,0,0,0,24,0,24,0.00222965440356745,0
2016,28131,16,365,8,167,0,26,8,193,0.0161994292429075,0.0414507772020725
2016,28133,40,1309,27,88,4,13,31,101,0.00565636200716846,0.306930693069307
2016,28135,21,130,11,795,0,9,11,804,0.0793682132280355,0.013681592039801
2016,28137,85,602,28,342,0,12,28,354,0.0194238683127572,0.0790960451977401
2016,28139,4,225,15,97,0,9,15,106,0.00731488510109723,0.141509433962264
2016,28141,23,395,14,128,0,39,14,167,0.0122344322344322,0.0838323353293413
2016,28143,150,413,37,140,0,0,37,140,0.0222504767959313,0.264285714285714
2016,28145,89,445,26,135,0,0,26,135,0.00728508984944148,0.192592592592593
2016,28147,0,229,20,204,0,0,20,204,0.0207612456747405,0.0980392156862745
2016,28149,101,425,69,395,25,110,94,505,0.015916540595058,0.186138613861386
2016,28151,126,547,96,499,11,60,107,559,0.0179615705931495,0.191413237924866
2016,28153,10,269,0,84,19,19,19,103,0.00759979340367446,0.184466019417476
2016,28155,15,168,17,124,0,0,17,124,0.0182031708749266,0.137096774193548
2016,28157,7,400,24,47,0,7,24,54,0.00846527668913623,0.444444444444444
2016,28159,124,432,10,100,0,5,10,105,0.00825601509671332,0.0952380952380952
2016,28161,11,159,26,107,0,13,26,120,0.0142281242589519,0.216666666666667
2016,28163,53,379,216,1090,13,80,229,1170,0.0630014538797049,0.195726495726496
2016,29001,51,185,185,422,0,100,185,522,0.0383231774465898,0.354406130268199
2016,29003,102,364,54,229,6,15,60,244,0.0203248646397334,0.245901639344262
2016,29005,14,73,7,94,0,5,7,99,0.0250950570342205,0.0707070707070707
2016,29007,101,1245,21,228,0,46,21,274,0.0155161673933971,0.0766423357664234
2016,29009,138,759,85,701,0,100,85,801,0.0324449125081011,0.106117353308365
2016,29011,41,172,59,197,0,4,59,201,0.0246504782928624,0.293532338308458
2016,29013,55,347,49,224,0,10,49,234,0.0206659012629162,0.209401709401709
2016,29015,58,657,30,354,0,5,30,359,0.0248425714483427,0.0835654596100279
2016,29017,46,374,0,24,0,10,0,34,0.00395624854549686,0
2016,29019,1076,2963,1720,2987,535,698,2255,3685,0.0362425744521814,0.611940298507463
2016,29021,234,2437,386,1604,21,85,407,1689,0.0282323443376515,0.24097098875074
2016,29023,112,725,56,603,0,34,56,637,0.0218068535825545,0.0879120879120879
2016,29025,37,308,11,55,0,0,11,55,0.00883818094166801,0.2
2016,29027,179,2384,69,621,17,56,86,677,0.0225644102256441,0.127031019202363
2016,29029,284,1116,282,1139,17,24,299,1163,0.0353506185598346,0.257093723129837
2016,29031,488,1865,380,1038,26,138,406,1176,0.0234913405645113,0.345238095238095
2016,29033,37,182,0,88,0,27,0,115,0.0184058898847631,0
2016,29035,19,96,25,57,0,18,25,75,0.0176595243701436,0.333333333333333
2016,29037,379,1856,255,1138,20,61,275,1199,0.0176591012857711,0.229357798165138
2016,29039,65,449,44,250,0,16,44,266,0.0275106008894405,0.165413533834586
2016,29041,28,162,3,8,0,4,3,12,0.00223131275567125,0.25
2016,29043,723,2932,355,1224,16,66,371,1290,0.0237149790425767,0.287596899224806
2016,29045,13,140,16,95,0,21,16,116,0.024247491638796,0.137931034482759
2016,29047,1609,6319,1758,4204,129,303,1887,4507,0.0289039953825435,0.41868205014422
2016,29049,185,782,53,284,0,7,53,291,0.0206984849562558,0.18213058419244
2016,29051,645,3105,362,660,82,130,444,790,0.0151937686315992,0.562025316455696
2016,29053,58,806,30,138,0,8,30,146,0.0121363258520366,0.205479452054795
2016,29055,155,837,8,218,6,47,14,265,0.0157055651040123,0.0528301886792453
2016,29057,56,313,18,101,12,24,30,125,0.0228979666605605,0.24
2016,29059,36,598,0,204,0,0,0,204,0.0179530053683006,0
2016,29061,43,212,18,106,0,6,18,112,0.020546688680976,0.160714285714286
2016,29063,31,1136,30,199,0,2,30,201,0.0212092434314657,0.149253731343284
2016,29065,73,450,14,119,0,17,14,136,0.0124610591900312,0.102941176470588
2016,29067,45,356,3,137,0,66,3,203,0.021007968539791,0.0147783251231527
2016,29069,45,633,22,440,0,38,22,478,0.0232932118317821,0.0460251046025105
2016,29071,407,2197,178,598,10,77,188,675,0.00967561601421957,0.278518518518518
2016,29073,91,499,69,109,0,0,69,109,0.0102385872628217,0.63302752293578
2016,29075,35,163,20,60,3,6,23,66,0.0143790849673203,0.348484848484849
2016,29077,1974,6571,1267,4350,200,553,1467,4903,0.0264334043184085,0.29920456863145
2016,29079,52,224,11,108,0,23,11,131,0.0190684133915575,0.083969465648855
2016,29081,24,176,11,138,0,8,11,146,0.0246247259234272,0.0753424657534247
2016,29083,109,632,26,144,13,52,39,196,0.0126012601260126,0.198979591836735
2016,29085,10,318,11,128,0,4,11,132,0.0183997769724003,0.0833333333333333
2016,29087,22,99,33,68,0,7,33,75,0.0224215246636771,0.44
2016,29089,43,175,20,43,0,2,20,45,0.0068534876637222,0.444444444444444
2016,29091,50,730,41,312,15,49,56,361,0.0132652311310355,0.155124653739612
2016,29093,33,402,6,99,0,0,6,99,0.0136382421821187,0.0606060606060606
2016,29095,2613,8235,5260,12161,621,1329,5881,13490,0.0293834485582725,0.435952557449963
2016,29097,233,1650,528,2141,28,75,556,2216,0.0291333613798906,0.250902527075812
2016,29099,1286,5317,218,1295,62,161,280,1456,0.00962931120002645,0.192307692307692
2016,29101,164,1362,210,776,81,452,291,1228,0.0395542098821104,0.236970684039088
2016,29103,28,62,12,77,0,3,12,80,0.0294767870302137,0.15
2016,29105,122,805,130,498,66,101,196,599,0.0248331329546868,0.327212020033389
2016,29107,142,776,85,336,46,66,131,402,0.0178128323289614,0.325870646766169
2016,29109,176,1144,62,564,0,41,62,605,0.023714330511132,0.102479338842975
2016,29111,14,188,0,139,0,0,0,139,0.0210351089588378,0
2016,29113,257,1258,29,120,0,3,29,123,0.0034820518627562,0.235772357723577
2016,29115,27,170,0,16,0,15,0,31,0.00366473578437167,0
2016,29117,50,699,34,112,0,16,34,128,0.0119827747612807,0.265625
2016,29119,33,317,18,620,0,12,18,632,0.042624940986039,0.0284810126582278
2016,29121,45,348,0,53,15,15,15,68,0.00639939770374553,0.220588235294118
2016,29123,73,264,12,36,0,0,12,36,0.00419776119402985,0.333333333333333
2016,29125,47,449,27,117,2,21,29,138,0.021674257892257,0.210144927536232
2016,29127,171,656,98,324,12,23,110,347,0.0179430167020011,0.31700288184438
2016,29129,8,46,7,28,0,0,7,28,0.0111332007952286,0.25
2016,29131,112,492,38,193,0,0,38,193,0.0112398811950381,0.196891191709845
2016,29133,14,431,40,105,0,22,40,127,0.0128737962493664,0.31496062992126
2016,29135,62,1106,23,145,0,2,23,147,0.0138888888888889,0.156462585034014
2016,29137,71,370,14,110,0,11,14,121,0.0197777051323962,0.115702479338843
2016,29139,26,411,15,84,19,28,34,112,0.0134972282477705,0.303571428571429
2016,29141,89,739,29,330,16,29,45,359,0.0249270934592418,0.125348189415042
2016,29143,37,305,3,78,0,14,3,92,0.00732834156444161,0.0326086956521739
2016,29145,251,1773,188,719,8,25,196,744,0.0189931583784336,0.263440860215054
2016,29147,61,868,130,303,15,19,145,322,0.0256247015756804,0.450310559006211
2016,29149,21,183,65,290,0,3,65,293,0.0380173867912288,0.221843003412969
2016,29151,50,207,2,37,0,0,2,37,0.00399783900594273,0.0540540540540541
2016,29153,32,346,6,176,0,0,6,176,0.0248939179632249,0.0340909090909091
2016,29155,57,192,2,354,0,36,2,390,0.0342495828576447,0.00512820512820513
2016,29157,82,369,50,336,10,20,60,356,0.0274776165483174,0.168539325842697
2016,29159,222,967,141,475,25,103,166,578,0.0207354260089686,0.28719723183391
2016,29161,270,1145,323,629,97,189,420,818,0.0294456443484521,0.513447432762836
2016,29163,90,1026,41,205,2,21,43,226,0.0177157638943325,0.190265486725664
2016,29165,1011,3365,1044,2624,196,481,1240,3105,0.0483674995326812,0.399355877616747
2016,29167,105,807,118,476,0,8,118,484,0.0245212280879522,0.243801652892562
2016,29169,238,1044,1705,4237,422,1019,2127,5256,0.183449094272451,0.404680365296804
2016,29171,32,63,6,45,0,0,6,45,0.0131118881118881,0.133333333333333
2016,29173,55,248,28,68,7,7,35,75,0.0103248898678414,0.466666666666667
2016,29175,93,1384,33,327,34,46,67,373,0.0217277334420691,0.179624664879357
2016,29177,79,622,66,159,0,17,66,176,0.0111980657886365,0.375
2016,29179,0,130,6,29,0,0,6,29,0.00611169652265543,0.206896551724138
2016,29181,27,247,37,102,0,12,37,114,0.0118134715025907,0.324561403508772
2016,29183,2646,7994,1694,3150,364,552,2058,3702,0.0145748031496063,0.555915721231767
2016,29185,49,392,17,246,3,10,20,256,0.0364984317080125,0.078125
2016,29186,93,576,0,99,7,7,7,106,0.00853462157809984,0.0660377358490566
2016,29187,298,2600,27,851,0,57,27,908,0.0197176981541802,0.0297356828193833
2016,29189,5512,16274,7931,13757,1525,2708,9456,16465,0.0239500663299742,0.574309140601275
2016,29195,135,470,27,157,10,49,37,206,0.013618033978978,0.179611650485437
2016,29197,19,114,2,48,0,0,2,48,0.0165460186142709,0.0416666666666667
2016,29199,25,101,4,84,0,0,4,84,0.0269144504966357,0.0476190476190476
2016,29201,124,860,47,405,9,23,56,428,0.0161986223601544,0.130841121495327
2016,29203,14,183,3,126,0,0,3,126,0.0218522372528616,0.0238095238095238
2016,29205,11,102,5,38,2,5,7,43,0.0101391181325159,0.162790697674419
2016,29207,59,766,21,269,0,28,21,297,0.014258281325012,0.0707070707070707
2016,29209,220,1135,158,610,0,21,158,631,0.026507036336904,0.250396196513471
2016,29211,10,108,0,88,0,0,0,88,0.0198019801980198,0
2016,29213,181,1269,237,2215,42,120,279,2335,0.0630467653094287,0.11948608137045
2016,29215,74,889,49,473,0,26,49,499,0.0280968468468468,0.0981963927855711
2016,29217,66,346,50,343,3,35,53,378,0.027153221751311,0.14021164021164
2016,29219,151,850,33,228,7,38,40,266,0.0116600184105554,0.150375939849624
2016,29221,31,648,17,57,0,8,17,65,0.00376811594202899,0.261538461538462
2016,29223,22,296,35,102,8,8,43,110,0.0114273841678787,0.390909090909091
2016,29225,243,1709,77,501,0,1,77,502,0.0208671072868604,0.153386454183267
2016,29227,0,10,5,17,0,0,5,17,0.0113333333333333,0.294117647058824
2016,29229,100,445,20,386,0,9,20,395,0.0318137886597938,0.0506329113924051
2016,29510,4012,10151,3972,6623,623,1061,4595,7684,0.0351564287217591,0.597995835502342
2016,30001,39,211,47,161,0,11,47,172,0.0273928969581143,0.273255813953488
2016,30003,16,112,12,58,9,26,21,84,0.0111450179116359,0.25
2016,30005,36,168,25,71,0,16,25,87,0.0216471759144066,0.28735632183908
2016,30007,77,203,17,49,0,9,17,58,0.0139389569814948,0.293103448275862
2016,30009,27,133,99,229,12,19,111,248,0.0315401246343635,0.44758064516129
2016,30011,0,5,3,7,2,2,5,9,0.00946372239747634,0.555555555555556
2016,30013,268,1241,677,1623,77,266,754,1889,0.0340974729241877,0.399152991000529
2016,30015,17,93,28,82,4,5,32,87,0.0223592906707787,0.367816091954023
2016,30017,57,201,92,302,0,7,92,309,0.0371528195262715,0.297734627831715
2016,30019,3,13,33,33,0,0,33,33,0.0250950570342205,1
2016,30021,57,288,26,318,0,0,26,318,0.0487954580328372,0.0817610062893082
2016,30023,49,242,30,160,6,6,36,166,0.024258366213649,0.216867469879518
2016,30025,4,57,22,40,0,0,22,40,0.0202224469160768,0.55
2016,30027,60,277,7,50,0,2,7,52,0.00619195046439629,0.134615384615385
2016,30029,344,937,807,2540,70,144,877,2684,0.0404558061015314,0.326751117734724
2016,30031,520,1494,1354,2668,168,200,1522,2868,0.0463230662381083,0.53068340306834
2016,30033,0,0,7,11,0,0,7,11,0.0145118733509235,0.636363636363636
2016,30035,52,356,63,119,32,37,95,156,0.0195219622074834,0.608974358974359
2016,30037,5,29,4,20,0,0,4,20,0.0349040139616056,0.2
2016,30039,22,110,23,81,0,0,23,81,0.0331559557920589,0.283950617283951
2016,30041,87,260,13,197,0,30,13,227,0.0220324177424051,0.0572687224669604
2016,30043,135,598,78,229,0,0,78,229,0.0271423491762475,0.34061135371179
2016,30045,18,59,3,24,0,2,3,26,0.0167310167310167,0.115384615384615
2016,30047,210,776,133,488,12,28,145,516,0.02591402169546,0.281007751937984
2016,30049,560,1318,657,1418,67,135,724,1553,0.0337073774227856,0.466194462330972
2016,30051,5,63,11,29,3,6,14,35,0.0213284582571603,0.4
2016,30053,72,228,38,478,0,17,38,495,0.0338669950738916,0.0767676767676768
2016,30055,10,21,5,20,0,0,5,20,0.0161030595813204,0.25
2016,30057,26,179,33,87,2,89,35,176,0.0284974093264249,0.198863636363636
2016,30059,30,55,6,33,0,0,6,33,0.022964509394572,0.181818181818182
2016,30061,0,14,16,172,0,0,16,172,0.0551458800897724,0.0930232558139535
2016,30063,801,2110,1137,2593,249,432,1386,3025,0.0405991222536875,0.458181818181818
2016,30065,0,164,9,44,0,0,9,44,0.0128918839730442,0.204545454545455
2016,30067,72,178,32,172,7,18,39,190,0.0160527205136871,0.205263157894737
2016,30069,5,42,0,0,0,0,0,0,0,NA
2016,30071,5,66,9,41,0,46,9,87,0.0297232661428083,0.103448275862069
2016,30073,32,147,30,83,5,13,35,96,0.0228898426323319,0.364583333333333
2016,30075,1,8,13,21,0,0,13,21,0.0165876777251185,0.619047619047619
2016,30077,43,470,16,79,0,0,16,79,0.0148078725398313,0.20253164556962
2016,30079,0,4,0,0,0,0,0,0,0,NA
2016,30081,129,809,279,1119,32,91,311,1210,0.0402381031558645,0.25702479338843
2016,30083,25,184,139,534,0,0,139,534,0.0704857444561774,0.260299625468165
2016,30085,24,66,42,111,0,0,42,111,0.0173248009989074,0.378378378378378
2016,30087,23,141,10,27,0,0,10,27,0.00465999309630652,0.37037037037037
2016,30089,12,93,74,163,0,0,74,163,0.018957897185392,0.45398773006135
2016,30091,2,14,16,62,0,17,16,79,0.0299015897047691,0.20253164556962
2016,30093,170,891,258,729,0,38,258,767,0.0327274278887182,0.336375488917862
2016,30095,52,243,43,152,5,5,48,157,0.0232799525504152,0.305732484076433
2016,30097,6,85,10,45,2,2,12,47,0.0180283851169927,0.25531914893617
2016,30099,26,173,13,63,0,1,13,64,0.0152744630071599,0.203125
2016,30101,4,291,155,209,4,10,159,219,0.0600328947368421,0.726027397260274
2016,30103,0,6,0,7,0,0,0,7,0.0116666666666667,0
2016,30105,44,134,4,31,0,0,4,31,0.00581613508442777,0.129032258064516
2016,30107,2,10,1,6,0,0,1,6,0.00420757363253857,0.166666666666667
2016,30109,0,3,0,2,0,0,0,2,0.00239808153477218,0
2016,30111,485,2468,969,2915,112,199,1081,3114,0.0294660345757516,0.347141939627489
2016,31001,156,777,41,182,1,45,42,227,0.0111756597085467,0.185022026431718
2016,31003,53,138,3,51,0,8,3,59,0.0131344612644702,0.0508474576271186
2016,31005,5,21,0,0,0,0,0,0,0,NA
2016,31007,4,20,6,32,0,0,6,32,0.0562390158172232,0.1875
2016,31009,4,20,3,6,0,0,3,6,0.0153452685421995,0.5
2016,31011,12,65,13,19,0,3,13,22,0.00593792172739541,0.590909090909091
2016,31013,0,60,9,31,0,0,9,31,0.00411795961742827,0.290322580645161
2016,31015,9,22,2,12,0,2,2,14,0.00956284153005465,0.142857142857143
2016,31017,20,34,0,2,13,13,13,15,0.00655594405594406,0.866666666666667
2016,31019,361,1122,224,660,0,38,224,698,0.0237908585841372,0.320916905444126
2016,31021,17,118,16,45,0,0,16,45,0.00955008488964346,0.355555555555556
2016,31023,18,163,3,9,14,20,17,29,0.00512096062157867,0.586206896551724
2016,31025,252,831,61,180,2,28,63,208,0.0119698451976751,0.302884615384615
2016,31027,49,186,9,122,0,0,9,122,0.0207412444746685,0.0737704918032787
2016,31029,0,56,10,67,0,17,10,84,0.0300429184549356,0.119047619047619
2016,31031,1,45,50,147,0,1,50,148,0.0351961950059453,0.337837837837838
2016,31033,32,88,132,276,38,72,170,348,0.049678800856531,0.488505747126437
2016,31035,18,164,5,56,0,1,5,57,0.0131548580660051,0.087719298245614
2016,31037,22,139,17,29,0,138,17,167,0.0258473920445751,0.101796407185629
2016,31039,19,160,2,56,0,0,2,56,0.00918785890073831,0.0357142857142857
2016,31041,29,106,17,99,11,17,28,116,0.0154275834552467,0.241379310344828
2016,31043,6,150,53,375,0,0,53,375,0.0296185135455335,0.141333333333333
2016,31045,26,124,152,349,0,0,152,349,0.0638258961228969,0.435530085959885
2016,31047,59,515,17,269,4,18,21,287,0.0188085719903008,0.0731707317073171
2016,31049,21,31,12,47,0,0,12,47,0.0333806818181818,0.25531914893617
2016,31051,8,91,18,29,1,3,19,32,0.00816743236345074,0.59375
2016,31053,107,746,67,318,19,41,86,359,0.0145203041579033,0.239554317548747
2016,31055,2280,6912,3761,8118,1079,1947,4840,10065,0.0286296183570894,0.480874316939891
2016,31057,6,28,7,59,3,3,10,62,0.0467571644042232,0.161290322580645
2016,31059,26,123,13,33,0,4,13,37,0.00903099829143275,0.351351351351351
2016,31061,17,93,15,58,0,0,15,58,0.0254833040421793,0.258620689655172
2016,31063,12,38,13,37,0,0,13,37,0.0212034383954155,0.351351351351351
2016,31065,26,124,3,31,0,2,3,33,0.00964912280701754,0.0909090909090909
2016,31067,209,554,93,234,8,12,101,246,0.0159512384904682,0.410569105691057
2016,31069,6,32,26,59,1,1,27,60,0.0402144772117962,0.45
2016,31071,0,30,0,0,0,0,0,0,0,NA
2016,31073,4,72,3,3,0,0,3,3,0.0021551724137931,1
2016,31075,3,11,0,0,0,0,0,0,0,NA
2016,31077,28,77,3,13,0,4,3,17,0.00997067448680352,0.176470588235294
2016,31079,200,1090,191,813,69,181,260,994,0.0254148449285367,0.261569416498994
2016,31081,42,148,25,31,2,3,27,34,0.00548298661506209,0.794117647058823
2016,31083,2,84,9,32,0,0,9,32,0.012764260071799,0.28125
2016,31085,2,24,0,14,0,0,0,14,0.0184696569920844,0
2016,31087,4,36,3,30,0,2,3,32,0.0153994225216554,0.09375
2016,31089,79,216,16,104,0,10,16,114,0.0158135663753641,0.140350877192982
2016,31091,0,14,3,3,0,3,3,6,0.011090573012939,0.5
2016,31093,14,98,10,31,0,0,10,31,0.00695535113304914,0.32258064516129
2016,31095,53,202,6,68,0,0,6,68,0.0128885519332828,0.0882352941176471
2016,31097,12,217,1,31,1,6,2,37,0.0099009900990099,0.0540540540540541
2016,31099,27,203,15,34,0,0,15,34,0.00753379126966541,0.441176470588235
2016,31101,48,145,68,298,4,14,72,312,0.0526760087793348,0.230769230769231
2016,31103,13,20,0,9,0,0,0,9,0.0163934426229508,0
2016,31105,16,49,9,128,6,17,15,145,0.0542664670658683,0.103448275862069
2016,31107,55,128,23,101,0,1,23,102,0.0172239108409321,0.225490196078431
2016,31109,741,3656,1967,4183,704,1373,2671,5556,0.0298358384482786,0.480741540676746
2016,31111,240,638,84,547,17,37,101,584,0.0240072350571405,0.172945205479452
2016,31113,0,25,9,33,0,0,9,33,0.0601092896174863,0.272727272727273
2016,31115,3,11,0,12,0,0,0,12,0.0298507462686567,0
2016,31117,1,8,5,5,0,0,5,5,0.015527950310559,1
2016,31119,143,844,115,374,3,30,118,404,0.0177442023893183,0.292079207920792
2016,31121,17,416,19,96,0,14,19,110,0.0202243059385917,0.172727272727273
2016,31123,8,107,34,139,0,0,34,139,0.0416292303084756,0.244604316546763
2016,31125,15,69,7,39,0,0,7,39,0.015300117693213,0.179487179487179
2016,31127,40,115,17,97,0,5,17,102,0.0221450282240556,0.166666666666667
2016,31129,34,89,15,58,9,9,24,67,0.0209637046307885,0.358208955223881
2016,31131,106,376,33,170,0,0,33,170,0.0156739811912226,0.194117647058824
2016,31133,13,19,3,31,6,6,9,37,0.018993839835729,0.243243243243243
2016,31135,2,76,18,70,5,5,23,75,0.0363548230731944,0.306666666666667
2016,31137,52,234,74,159,2,13,76,172,0.0272972544040628,0.441860465116279
2016,31139,31,159,34,77,0,0,34,77,0.0157851578515785,0.441558441558442
2016,31141,67,414,111,286,0,42,111,328,0.0154120853303261,0.338414634146341
2016,31143,10,82,20,23,0,2,20,25,0.00683994528043776,0.8
2016,31145,0,177,5,187,13,13,18,200,0.027401013837512,0.09
2016,31147,4,53,0,53,0,0,0,53,0.00893609846568875,0
2016,31149,6,40,5,6,0,1,5,7,0.00668576886341929,0.714285714285714
2016,31151,46,320,0,67,0,49,0,116,0.0132148553201185,0
2016,31153,1278,4431,1572,3508,252,712,1824,4220,0.038738341778659,0.432227488151659
2016,31155,150,748,87,195,13,21,100,216,0.0152445479568071,0.462962962962963
2016,31157,95,295,141,563,2,7,143,570,0.0232976375378076,0.250877192982456
2016,31159,120,437,89,235,0,3,89,238,0.0219011686758075,0.373949579831933
2016,31161,12,80,15,84,0,0,15,84,0.0225321888412017,0.178571428571429
2016,31163,15,45,0,29,0,0,0,29,0.0129175946547884,0
2016,31165,11,17,0,3,0,0,0,3,0.00334075723830735,0
2016,31167,61,206,2,44,0,0,2,44,0.0109371116082525,0.0454545454545455
2016,31169,41,99,12,43,0,0,12,43,0.0114911811865313,0.27906976744186
2016,31171,10,35,3,9,0,2,3,11,0.0235546038543897,0.272727272727273
2016,31173,17,90,4,49,0,1,4,50,0.0131613582521716,0.08
2016,31175,24,91,26,75,0,0,26,75,0.0247933884297521,0.346666666666667
2016,31177,139,502,45,301,5,6,50,307,0.0224612232952883,0.162866449511401
2016,31179,30,224,31,77,0,0,31,77,0.0146555005709935,0.402597402597403
2016,31181,23,98,28,60,0,3,28,63,0.0243619489559165,0.444444444444444
2016,31183,4,29,0,0,0,0,0,0,0,NA
2016,31185,111,450,23,136,0,12,23,148,0.0157732068634765,0.155405405405405
2016,32001,85,430,241,799,22,55,263,854,0.0522451976018598,0.307962529274005
2016,32003,685,3037,17839,61432,2878,8604,20717,70036,0.050324787307427,0.295805014563939
2016,32005,200,857,413,1627,14,82,427,1709,0.0478148956409826,0.249853715623171
2016,32007,145,681,233,1087,28,74,261,1161,0.0356124045274685,0.224806201550388
2016,32009,12,12,0,59,0,0,0,59,0.0751592356687898,0
2016,32011,45,45,40,56,0,0,40,56,0.042456406368461,0.714285714285714
2016,32013,75,432,12,443,20,72,32,515,0.047716112295006,0.0621359223300971
2016,32015,0,81,2,70,0,14,2,84,0.0223940282591309,0.0238095238095238
2016,32017,94,438,81,140,0,0,81,140,0.0396039603960396,0.578571428571429
2016,32019,184,1513,252,1684,46,77,298,1761,0.0481147540983607,0.169222032935832
2016,32021,11,121,15,75,0,0,15,75,0.0222684085510689,0.2
2016,32023,71,1065,246,1684,25,25,271,1709,0.0520973052066821,0.158572264482153
2016,32027,25,480,8,94,0,0,8,94,0.0187512467584281,0.0851063829787234
2016,32029,70,139,22,78,0,0,22,78,0.0242461921044451,0.282051282051282
2016,32031,709,3426,4481,12107,782,2032,5263,14139,0.0472773477337703,0.372232831176179
2016,32033,30,360,68,125,0,4,68,129,0.0185185185185185,0.527131782945736
2016,32510,424,2489,472,1827,25,92,497,1919,0.0497924234561495,0.258989056800417
2016,33001,336,1050,452,1013,17,56,469,1069,0.0241418247515808,0.438727782974743
2016,33003,332,863,600,1083,9,23,609,1106,0.0303971416792634,0.550632911392405
2016,33005,174,555,701,1573,87,140,788,1713,0.0326198727958259,0.460011675423234
2016,33007,84,486,134,515,4,12,138,527,0.021340352298036,0.261859582542694
2016,33009,266,1070,1992,3063,349,452,2341,3515,0.0568071627125218,0.666002844950213
2016,33011,1609,4288,3816,8891,1035,1756,4851,10647,0.0378745837957825,0.455621301775148
2016,33013,1003,3555,927,2032,124,247,1051,2279,0.0219575878448035,0.4611671785871
2016,33015,1149,3003,3854,7626,342,559,4196,8185,0.0380563149770314,0.512645082467929
2016,33017,666,2215,745,2234,245,363,990,2597,0.0319926085617493,0.381209087408548
2016,33019,185,729,340,727,9,22,349,749,0.023823155216285,0.465954606141522
2016,34001,896,3279,1188,3086,361,763,1549,3849,0.0205510171391959,0.402442192777345
2016,34003,5228,9722,6759,11157,3052,4588,9811,15745,0.0241041507515994,0.623118450301683
2016,34005,2484,6712,2261,5234,832,1607,3093,6841,0.0218661501384014,0.45212688203479
2016,34007,2144,8123,2805,5923,503,1554,3308,7477,0.0215410943117913,0.442423431857697
2016,34009,324,1289,582,1599,35,158,617,1757,0.0250049810719267,0.351166761525327
2016,34011,352,4214,237,907,56,586,293,1493,0.0142395254127364,0.196249162759545
2016,34013,3940,9532,4063,7780,1301,3257,5364,11037,0.0209452599417396,0.486001630877956
2016,34015,1269,4255,975,2169,119,399,1094,2568,0.0129976616356403,0.42601246105919
2016,34017,4540,7866,9380,13094,4945,7736,14325,20830,0.0442302179660045,0.687710033605377
2016,34019,1045,2390,631,917,129,174,760,1091,0.0123507103639554,0.696608615948671
2016,34021,2394,6817,2381,4283,1486,2253,3867,6536,0.0263677035973197,0.591646266829865
2016,34023,6137,11475,4313,7296,3967,6564,8280,13860,0.0244634715890137,0.597402597402597
2016,34025,4331,8698,2688,5779,706,1729,3394,7508,0.0172604049804131,0.452051145444859
2016,34027,4490,8039,2950,4183,1028,1970,3978,6153,0.0177671130823472,0.646513895660653
2016,34029,3451,9876,1454,4817,304,1022,1758,5839,0.0144455329929145,0.301078951875321
2016,34031,2508,5432,969,2577,600,1911,1569,4488,0.0135023737461867,0.349598930481283
2016,34033,130,1038,129,640,20,132,149,772,0.0172587243745948,0.19300518134715
2016,34035,3986,6395,1939,2496,1262,2013,3201,4509,0.0197099244649601,0.709913506320692
2016,34037,872,2521,392,1100,133,337,525,1437,0.0141637754297429,0.365344467640919
2016,34039,3660,8838,2213,4334,646,2138,2859,6472,0.0174444147954082,0.441749072929543
2016,34041,518,2120,356,1552,73,268,429,1820,0.0243049063860474,0.235714285714286
2016,35001,2326,7754,5934,12153,1028,2453,6962,14606,0.0320774109668465,0.47665343009722
2016,35003,4,92,15,43,1,1,16,44,0.0150684931506849,0.363636363636364
2016,35005,235,756,245,1246,136,198,381,1444,0.0351227105781626,0.263850415512465
2016,35006,159,799,18,134,1,84,19,218,0.0120481927710843,0.0871559633027523
2016,35007,152,442,35,427,8,8,43,435,0.0464644306772057,0.0988505747126437
2016,35009,84,663,501,1516,53,201,554,1717,0.0558901077438885,0.322655794991264
2016,35011,0,33,57,76,0,0,57,76,0.0510752688172043,0.75
2016,35013,290,1706,1065,3319,276,624,1341,3943,0.0308935063307008,0.340096373319807
2016,35015,59,436,292,1039,39,113,331,1152,0.0315676979146686,0.287326388888889
2016,35017,71,218,180,589,31,31,211,620,0.0302276827068402,0.340322580645161
2016,35019,4,215,9,27,0,20,9,47,0.0143118148599269,0.191489361702128
2016,35021,1,7,0,2,2,3,2,5,0.0110132158590308,0.4
2016,35023,17,37,51,141,3,4,54,145,0.047246660149886,0.372413793103448
2016,35025,138,540,208,1181,13,55,221,1236,0.0299796254972349,0.178802588996764
2016,35027,202,532,306,611,44,55,350,666,0.0444770936289569,0.525525525525526
2016,35028,155,334,357,448,85,100,442,548,0.0430817610062893,0.806569343065693
2016,35029,192,565,36,532,65,141,101,673,0.0427491583560948,0.150074294205052
2016,35031,83,359,237,752,51,131,288,883,0.0203035180501265,0.326160815402039
2016,35033,0,89,5,5,0,0,5,5,0.00166002656042497,1
2016,35035,157,810,551,2006,100,837,651,2843,0.0670756163737171,0.228983468167429
2016,35037,12,58,37,74,0,7,37,81,0.0136294800605755,0.45679012345679
2016,35039,141,449,36,198,10,31,46,229,0.00853331345953197,0.200873362445415
2016,35041,132,410,9,256,7,124,16,380,0.0341788091383342,0.0421052631578947
2016,35043,745,2930,943,2286,79,160,1022,2446,0.0263517953911292,0.417825020441537
2016,35045,94,731,703,1920,41,204,744,2124,0.0271885920559133,0.350282485875706
2016,35047,22,231,106,210,0,33,106,243,0.0125835016311947,0.436213991769547
2016,35049,872,2237,2046,3622,191,476,2237,4098,0.0380851479075473,0.545876037091264
2016,35051,13,166,91,228,0,11,91,239,0.0267098793026375,0.380753138075314
2016,35053,7,113,21,136,7,34,28,170,0.0158923062540899,0.164705882352941
2016,35055,123,345,445,711,19,78,464,789,0.032612739222089,0.58808618504436
2016,35057,9,354,7,198,0,164,7,362,0.0332415059687787,0.0193370165745856
2016,35059,7,295,20,93,0,0,20,93,0.0303425774877651,0.21505376344086
2016,35061,121,1861,82,960,16,108,98,1068,0.021212783284009,0.0917602996254682
2016,36001,2678,6602,1439,2683,676,1444,2115,4127,0.0202300946554708,0.512478798158469
2016,36003,123,611,99,286,85,108,184,394,0.0129396696114815,0.467005076142132
2016,36005,5390,21634,1734,6261,1841,8735,3575,14996,0.0165674014611927,0.238396905841558
2016,36007,472,2307,804,1701,231,428,1035,2129,0.0163095520810192,0.486143729450446
2016,36009,127,773,162,540,17,48,179,588,0.0110457798733868,0.304421768707483
2016,36011,407,2148,201,331,18,160,219,491,0.00886345584518738,0.446028513238289
2016,36013,307,1585,192,1116,71,256,263,1372,0.0152047431706101,0.191690962099125
2016,36015,353,1853,288,629,33,104,321,733,0.0121399824442273,0.437926330150068
2016,36017,163,721,98,329,6,20,104,349,0.010049527758581,0.297994269340974
2016,36019,157,2180,112,511,30,126,142,637,0.0115363022257638,0.222919937205651
2016,36021,368,957,211,543,53,119,264,662,0.0144759572281385,0.398791540785498
2016,36023,266,774,77,174,8,14,85,188,0.00615062487731466,0.452127659574468
2016,36025,242,1041,87,384,23,37,110,421,0.0127668607472101,0.261282660332542
2016,36027,1859,6850,888,2060,485,893,1373,2953,0.0145692619654936,0.464950897392482
2016,36029,2352,7471,3006,5927,1495,3021,4501,8948,0.0140294763248667,0.503017434063478
2016,36031,258,1242,212,567,87,169,299,736,0.0253653156878963,0.40625
2016,36033,162,2683,85,454,11,60,96,514,0.0143591462733266,0.186770428015564
2016,36035,264,1211,101,327,27,48,128,375,0.00969017287268405,0.341333333333333
2016,36037,247,1252,29,234,4,36,33,270,0.00651402928900577,0.122222222222222
2016,36039,65,795,76,196,6,13,82,209,0.00596904095504655,0.392344497607655
2016,36041,9,109,7,77,0,2,7,79,0.0220979020979021,0.0886075949367089
2016,36043,175,858,81,238,4,36,85,274,0.0061937700619377,0.31021897810219
2016,36045,402,2065,1225,3464,520,1788,1745,5252,0.0712696086413722,0.332254379284082
2016,36047,17601,30478,12851,18793,6989,14823,19840,33616,0.0191686695805143,0.590195145168967
2016,36049,115,357,66,212,0,62,66,274,0.0148188209843158,0.240875912408759
2016,36051,213,1607,132,371,3,44,135,415,0.00973698411581145,0.325301204819277
2016,36053,355,1330,170,408,133,218,303,626,0.0131496029912196,0.484025559105431
2016,36055,3401,7485,2774,5668,1447,3052,4221,8720,0.0171911749340052,0.484059633027523
2016,36057,198,1068,56,232,30,207,86,439,0.0128201384224513,0.195899772209567
2016,36059,9288,18540,2292,4842,1633,3457,3925,8299,0.00887816723989452,0.472948548017833
2016,36061,16105,26899,30913,35224,15062,20295,45975,55519,0.0448593796333779,0.828094886435274
2016,36063,1224,3444,274,879,73,252,347,1131,0.00752840625436827,0.306808134394341
2016,36065,790,4348,431,1569,158,462,589,2031,0.0126980355870106,0.290004923682915
2016,36067,1890,5357,2096,3919,964,2102,3060,6021,0.0191108882230461,0.508221225710015
2016,36069,1143,2935,435,771,17,110,452,881,0.011589665333614,0.51305334846765
2016,36071,1328,4451,1412,3143,174,473,1586,3616,0.0151789912015582,0.438606194690265
2016,36073,125,1566,28,132,0,34,28,166,0.00559016669472975,0.168674698795181
2016,36075,243,1841,135,566,31,88,166,654,0.00815980236808943,0.253822629969419
2016,36077,327,1002,216,405,72,90,288,495,0.0124156612907271,0.581818181818182
2016,36079,1149,2546,213,522,55,154,268,676,0.00968911694305494,0.396449704142012
2016,36081,15062,31418,6621,11720,6176,16462,12797,28182,0.017279361947512,0.454084167198921
2016,36083,1304,4982,471,1455,222,418,693,1873,0.0170181448132365,0.369994660971703
2016,36085,1264,3746,785,1681,415,1055,1200,2736,0.00843559227970648,0.43859649122807
2016,36087,1498,3001,950,1852,263,935,1213,2787,0.0137299432968614,0.435235019734482
2016,36089,354,2042,369,785,104,228,473,1013,0.014041945634244,0.466929911154985
2016,36091,2163,5086,1487,2602,475,794,1962,3396,0.0214650055937956,0.57773851590106
2016,36093,1034,2895,373,730,438,540,811,1270,0.0119657797542775,0.638582677165354
2016,36095,171,620,21,223,10,31,31,254,0.0115318260237901,0.122047244094488
2016,36097,103,497,18,83,0,51,18,134,0.0100926414099571,0.134328358208955
2016,36099,157,1719,89,244,12,46,101,290,0.0116353715294495,0.348275862068965
2016,36101,452,1621,257,669,93,149,350,818,0.0119781523187536,0.427872860635697
2016,36103,5073,11790,2975,5489,1463,3252,4438,8741,0.0085289698105107,0.507722228577966
2016,36105,367,2083,115,440,94,234,209,674,0.0127121840814787,0.310089020771513
2016,36107,170,600,132,584,30,35,162,619,0.0176953203167434,0.261712439418417
2016,36109,893,1833,1756,2174,1024,1101,2780,3275,0.0548888814400161,0.848854961832061
2016,36111,1013,4135,441,1224,60,304,501,1528,0.0118435840793706,0.327879581151832
2016,36113,387,1856,213,369,39,88,252,457,0.00963748708323668,0.551422319474836
2016,36115,465,2794,186,745,0,45,186,790,0.0176362905746305,0.235443037974684
2016,36117,517,1687,109,593,12,107,121,700,0.0109556452875074,0.172857142857143
2016,36119,8442,14672,4857,7515,2088,4492,6945,12007,0.0181571278862454,0.578412592654285
2016,36121,166,1914,90,292,10,44,100,336,0.0113667117726658,0.297619047619048
2016,36123,210,570,58,339,5,37,63,376,0.0228793963733723,0.167553191489362
2016,37001,786,2796,505,1555,189,464,694,2019,0.0192221640405579,0.343734522040614
2016,37003,167,1107,0,123,3,3,3,126,0.00479324380872675,0.0238095238095238
2016,37005,27,64,10,141,0,6,10,147,0.0183246073298429,0.0680272108843537
2016,37007,63,817,10,162,0,26,10,188,0.0103410341034103,0.0531914893617021
2016,37009,239,688,45,150,2,27,47,177,0.00874894963175325,0.265536723163842
2016,37011,137,1019,62,231,2,17,64,248,0.0188808526836696,0.258064516129032
2016,37013,146,523,108,340,0,55,108,395,0.0116653377041434,0.273417721518987
2016,37015,92,516,0,166,57,60,57,226,0.0151211026361568,0.252212389380531
2016,37017,38,628,24,274,3,94,27,368,0.0151771353157092,0.0733695652173913
2016,37019,740,3229,1745,4259,75,203,1820,4462,0.0485026360128268,0.407888839085612
2016,37021,2056,4859,3129,6093,227,403,3356,6496,0.0358465265400045,0.516625615763547
2016,37023,433,2134,249,725,23,95,272,820,0.0129769421893051,0.331707317073171
2016,37025,1835,4872,1234,3274,148,332,1382,3606,0.0285366085277452,0.383250138657793
2016,37027,107,1727,115,795,0,124,115,919,0.0158464668758837,0.125136017410229
2016,37029,59,295,37,123,0,0,37,123,0.0174989329918907,0.300813008130081
2016,37031,535,1566,593,1316,98,228,691,1544,0.03016980284112,0.447538860103627
2016,37033,28,663,20,221,0,0,20,221,0.0130800189393939,0.0904977375565611
2016,37035,728,3313,531,1624,0,108,531,1732,0.0162374492579711,0.306581986143187
2016,37037,826,1702,708,1127,55,65,763,1192,0.0235540537870255,0.64010067114094
2016,37039,69,132,227,960,0,19,227,979,0.0473518742442563,0.231869254341164
2016,37041,58,143,49,297,0,0,49,297,0.0280718336483932,0.164983164983165
2016,37043,34,105,118,428,0,0,118,428,0.0530359355638166,0.275700934579439
2016,37045,126,1137,249,880,37,82,286,962,0.0145326001571092,0.297297297297297
2016,37047,164,1640,95,701,12,119,107,820,0.0208545269582909,0.130487804878049
2016,37049,385,2479,820,2881,207,575,1027,3456,0.0512159338460854,0.297164351851852
2016,37051,1067,4065,2965,9416,772,2594,3737,12010,0.0596832464505613,0.311157368859284
2016,37053,150,286,183,617,17,51,200,668,0.0379847606050267,0.29940119760479
2016,37055,213,398,366,1133,54,64,420,1197,0.0460349203907392,0.350877192982456
2016,37057,950,3676,527,1515,10,168,537,1683,0.0147577208396906,0.319073083778966
2016,37059,249,1143,30,312,30,72,60,384,0.0130474669566104,0.15625
2016,37061,107,1445,62,384,0,119,62,503,0.0127477317654215,0.123260437375746
2016,37063,4855,9115,4256,6781,1577,2481,5833,9262,0.0465452864228676,0.629777585834593
2016,37065,136,1244,7,307,0,45,7,352,0.0095058061031596,0.0198863636363636
2016,37067,2006,7096,2662,4994,350,705,3012,5699,0.023517808580967,0.528513774346377
2016,37069,524,1978,140,486,7,137,147,623,0.0144380069524913,0.235955056179775
2016,37071,1098,4042,726,2798,48,207,774,3005,0.020753622387668,0.25757071547421
2016,37073,0,53,31,139,0,21,31,160,0.0194057004244997,0.19375
2016,37075,26,53,30,161,0,2,30,163,0.0271485676215856,0.184049079754601
2016,37077,273,1475,162,609,66,138,228,747,0.018438525905265,0.305220883534137
2016,37079,53,1503,36,330,3,50,39,380,0.0255634039690548,0.102631578947368
2016,37081,2556,6921,2899,6616,552,1466,3451,8082,0.0238204711041947,0.426998267755506
2016,37083,137,1185,50,396,26,44,76,440,0.0119708346936555,0.172727272727273
2016,37085,748,3942,1117,3047,90,335,1207,3382,0.0421286031042129,0.356889414547605
2016,37087,481,1361,415,1410,8,19,423,1429,0.0321897596467912,0.296011196641008
2016,37089,605,2086,1510,2952,31,189,1541,3141,0.0383999413181412,0.490608086596625
2016,37091,77,475,130,644,4,6,134,650,0.0386283948416236,0.206153846153846
2016,37093,341,2859,318,1373,121,396,439,1769,0.0543271297831829,0.24816280384398
2016,37095,14,425,0,39,0,0,0,39,0.00958466453674121,0
2016,37097,1035,2640,1171,2849,279,502,1450,3351,0.0295166873662236,0.432706654729931
2016,37099,386,1133,206,510,0,13,206,523,0.0198768622681666,0.393881453154876
2016,37101,961,4090,667,2247,29,129,696,2376,0.019892500125584,0.292929292929293
2016,37103,106,402,0,59,0,0,0,59,0.00791627532537233,0
2016,37105,435,1628,252,558,88,196,340,754,0.0190871579373718,0.450928381962865
2016,37107,111,818,18,385,21,158,39,543,0.0134883374319994,0.0718232044198895
2016,37109,309,1497,321,1386,0,102,321,1488,0.0265842459757383,0.215725806451613
2016,37111,82,656,38,335,0,58,38,393,0.0122479508835354,0.0966921119592875
2016,37113,66,192,380,1260,0,16,380,1276,0.0503571569517345,0.297805642633229
2016,37115,199,547,43,178,8,9,51,187,0.012514220705347,0.272727272727273
2016,37117,82,332,20,122,0,19,20,141,0.00839435613502411,0.141843971631206
2016,37119,5797,13827,15379,27835,2664,4429,18043,32264,0.0481703939598889,0.559230101661294
2016,37121,80,283,12,73,0,0,12,73,0.00646819067871699,0.164383561643836
2016,37123,71,851,26,127,11,35,37,162,0.00840466926070039,0.228395061728395
2016,37125,491,1519,1068,1797,164,281,1232,2078,0.0309663959466508,0.592877767083734
2016,37127,323,2848,161,848,0,199,161,1047,0.0162454033421775,0.153772683858644
2016,37129,1878,5152,1514,3978,186,666,1700,4644,0.0316463028205006,0.366063738156761
2016,37131,65,766,67,287,0,3,67,290,0.0192269442418617,0.231034482758621
2016,37133,605,2587,1931,6999,168,1243,2099,8242,0.082523980215071,0.254671196311575
2016,37135,2155,3892,2603,3657,1018,1296,3621,4953,0.0578810825971112,0.73107207752877
2016,37137,47,612,35,123,16,36,51,159,0.0161716842961758,0.320754716981132
2016,37139,76,999,198,825,0,43,198,868,0.0325495931300859,0.228110599078341
2016,37141,557,2638,262,738,74,126,336,864,0.0218872704243192,0.388888888888889
2016,37143,14,223,71,318,0,3,71,321,0.0320359281437126,0.221183800623053
2016,37145,42,553,83,208,0,63,83,271,0.00984058970913977,0.306273062730627
2016,37147,720,2926,939,2114,69,244,1008,2358,0.0227257394539269,0.427480916030534
2016,37149,58,326,234,488,10,32,244,520,0.0335527164795457,0.469230769230769
2016,37151,341,2551,131,669,0,80,131,749,0.00768339095021696,0.174899866488652
2016,37153,65,818,110,252,0,9,110,261,0.00850439882697947,0.421455938697318
2016,37155,153,1649,115,564,17,132,132,696,0.00817208341160999,0.189655172413793
2016,37157,208,1441,70,760,36,168,106,928,0.0141852644451238,0.114224137931034
2016,37159,482,3342,350,1425,0,78,350,1503,0.0158527581478747,0.232867598137059
2016,37161,213,845,244,669,0,30,244,699,0.0147490135674045,0.349070100143062
2016,37163,345,1667,77,376,4,96,81,472,0.0111006585136406,0.171610169491525
2016,37165,61,1166,83,464,45,89,128,553,0.0233787097319692,0.231464737793852
2016,37167,212,1415,83,282,0,56,83,338,0.00808341703735591,0.245562130177515
2016,37169,108,646,0,144,0,45,0,189,0.00562198822059611,0
2016,37171,108,788,61,416,15,66,76,482,0.00948091032475068,0.157676348547718
2016,37173,4,197,37,129,9,31,46,160,0.0164119396861217,0.2875
2016,37175,200,660,242,664,46,62,288,726,0.0292282297999114,0.396694214876033
2016,37177,0,353,0,23,0,0,0,23,0.00737652341244387,0
2016,37179,1488,3769,1696,4210,108,346,1804,4556,0.0332094175960347,0.395961369622476
2016,37181,107,664,75,315,0,41,75,356,0.011993396893845,0.210674157303371
2016,37183,8622,16425,12736,21514,2774,4935,15510,26449,0.0403028696118588,0.586411584558963
2016,37185,71,828,63,146,16,23,79,169,0.0117060331093718,0.467455621301775
2016,37187,16,74,50,171,0,21,50,192,0.022219650503414,0.260416666666667
2016,37189,397,1189,335,562,11,92,346,654,0.0222154285131968,0.529051987767584
2016,37191,572,3115,404,1959,101,454,505,2413,0.0294451427107103,0.209283050145048
2016,37193,198,1076,163,295,0,43,163,338,0.00691531804325143,0.482248520710059
2016,37195,402,1225,99,525,21,129,120,654,0.0118876669999091,0.18348623853211
2016,37197,84,568,34,277,0,1,34,278,0.0105068218753543,0.122302158273381
2016,37199,23,325,67,253,0,9,67,262,0.0201973481344434,0.255725190839695
2016,38001,3,27,15,31,4,4,19,35,0.0208085612366231,0.542857142857143
2016,38003,38,211,27,243,0,0,27,243,0.0315093360995851,0.111111111111111
2016,38005,42,135,4,55,0,1,4,56,0.0145040145040145,0.0714285714285714
2016,38007,27,64,4,32,0,0,4,32,0.0465793304221252,0.125
2016,38009,13,104,33,93,8,11,41,104,0.0223511712873415,0.394230769230769
2016,38011,9,46,7,25,0,0,7,25,0.0112866817155756,0.28
2016,38013,12,57,14,61,0,2,14,63,0.0414746543778802,0.222222222222222
2016,38015,820,2274,573,1497,23,108,596,1605,0.0263850073976656,0.371339563862928
2016,38017,790,1922,1645,5108,192,426,1837,5534,0.0533156064240778,0.33194795807734
2016,38019,18,63,5,15,0,3,5,18,0.00637845499645641,0.277777777777778
2016,38021,10,74,59,148,0,1,59,149,0.0421976777116964,0.395973154362416
2016,38023,0,22,0,48,0,22,0,70,0.0393037619314992,0
2016,38025,21,107,7,146,0,14,7,160,0.0541088941494758,0.04375
2016,38027,9,26,13,70,0,1,13,71,0.0419373892498523,0.183098591549296
2016,38029,5,7,4,8,0,13,4,21,0.00849171047310958,0.19047619047619
2016,38031,22,80,16,24,0,4,16,28,0.0117154811715481,0.571428571428571
2016,38033,2,2,17,59,0,0,17,59,0.047696038803557,0.288135593220339
2016,38035,202,646,662,1989,142,239,804,2228,0.0552442350607488,0.360861759425494
2016,38037,11,69,8,69,8,8,16,77,0.0424008810572687,0.207792207792208
2016,38039,14,74,0,27,2,8,2,35,0.0202078521939954,0.0571428571428571
2016,38041,14,110,3,75,2,2,5,77,0.0394669400307535,0.0649350649350649
2016,38043,12,66,8,26,1,32,9,58,0.0325476992143659,0.155172413793103
2016,38045,14,49,33,66,0,4,33,70,0.0237127371273713,0.471428571428571
2016,38047,8,25,0,17,0,8,0,25,0.0171703296703297,0
2016,38049,43,147,13,54,0,12,13,66,0.0160936356986101,0.196969696969697
2016,38051,3,22,3,19,0,6,3,25,0.0117757889778615,0.12
2016,38053,59,215,54,273,0,0,54,273,0.0420971472629144,0.197802197802198
2016,38055,77,266,22,126,1,11,23,137,0.0196500286861733,0.167883211678832
2016,38057,61,237,33,175,8,18,41,193,0.031448590516539,0.212435233160622
2016,38059,294,1045,85,535,0,319,85,854,0.0413259133801113,0.0995316159250585
2016,38061,99,316,22,171,0,11,22,182,0.0296561838031612,0.120879120879121
2016,38063,16,108,1,45,0,0,1,45,0.0194636678200692,0.0222222222222222
2016,38065,0,51,0,0,0,0,0,0,0,NA
2016,38067,67,198,11,81,0,19,11,100,0.0192715359414145,0.11
2016,38069,10,199,0,50,0,14,0,64,0.0201956453139792,0
2016,38071,1,228,42,84,0,0,42,84,0.0105686965274283,0.5
2016,38073,12,111,0,39,0,9,0,48,0.0124610591900312,0
2016,38075,17,69,3,24,0,0,3,24,0.0139372822299652,0.125
2016,38077,43,147,57,284,11,45,68,329,0.0313991219698416,0.206686930091185
2016,38079,45,163,0,42,0,10,0,52,0.00631067961165049,0
2016,38081,9,49,18,27,0,31,18,58,0.020863309352518,0.310344827586207
2016,38083,0,33,13,24,0,0,13,24,0.0220588235294118,0.541666666666667
2016,38085,13,40,16,50,0,1,16,51,0.0221162185602775,0.313725490196078
2016,38087,3,3,0,9,0,0,0,9,0.0177165354330709,0
2016,38089,166,616,270,952,9,109,279,1061,0.0543823680164018,0.262959472196041
2016,38091,7,72,2,2,0,0,2,2,0.00137835975189524,1
2016,38093,161,502,114,429,1,3,115,432,0.0296621807195825,0.266203703703704
2016,38095,5,40,2,8,0,0,2,8,0.0049079754601227,0.25
2016,38097,56,147,15,83,4,6,19,89,0.0162943976565361,0.213483146067416
2016,38099,45,116,5,165,22,34,27,199,0.0258912308092636,0.135678391959799
2016,38101,239,990,722,2224,164,499,886,2723,0.0643431001890359,0.325376423062798
2016,38103,12,69,11,26,0,0,11,26,0.0082881734140899,0.423076923076923
2016,38105,86,483,391,1470,35,35,426,1505,0.0734361276471162,0.283056478405316
2016,39001,4,261,8,76,0,0,8,76,0.00397780801842353,0.105263157894737
2016,39003,438,2199,204,951,11,84,215,1035,0.0149363581262447,0.207729468599034
2016,39005,185,1204,89,232,139,145,228,377,0.0107001958391281,0.604774535809019
2016,39007,218,1601,85,750,26,172,111,922,0.0134011627906977,0.120390455531453
2016,39009,314,1062,443,748,82,203,525,951,0.0266849991582019,0.55205047318612
2016,39011,319,1034,80,281,24,30,104,311,0.0100345239247572,0.334405144694534
2016,39013,198,1738,276,760,22,64,298,824,0.0162227078534444,0.361650485436893
2016,39015,80,838,123,555,0,35,123,590,0.0194130034219531,0.208474576271186
2016,39017,2132,7199,1502,3691,293,651,1795,4342,0.0182581198593847,0.413403961308153
2016,39019,95,679,64,203,0,9,64,212,0.0105909976519958,0.30188679245283
2016,39021,130,1112,100,324,0,28,100,352,0.0132305957526781,0.284090909090909
2016,39023,368,2384,320,1040,38,257,358,1297,0.0139630522780122,0.276021588280648
2016,39025,1233,4500,829,2211,86,176,915,2387,0.0175430860250616,0.383326351068287
2016,39027,102,964,119,479,0,58,119,537,0.0193492595395092,0.221601489757914
2016,39029,157,1404,254,1587,31,166,285,1753,0.0233195429209956,0.162578436965203
2016,39031,35,671,72,209,0,23,72,232,0.00920927278501111,0.310344827586207
2016,39033,118,830,27,193,43,98,70,291,0.00979138627187079,0.240549828178694
2016,39035,4867,12694,5468,11198,2161,4617,7629,15815,0.0181384855884198,0.482390135946886
2016,39037,73,671,69,415,34,74,103,489,0.0137754239675475,0.210633946830266
2016,39039,170,726,58,174,8,50,66,224,0.00865499787488891,0.294642857142857
2016,39041,3079,5679,1216,1948,286,368,1502,2316,0.0188542540114135,0.64853195164076
2016,39043,423,1995,151,731,13,41,164,772,0.0143742901297782,0.212435233160622
2016,39045,955,4596,606,1654,24,151,630,1805,0.0179443080257285,0.349030470914127
2016,39047,89,671,53,190,54,132,107,322,0.0163460074115437,0.332298136645963
2016,39049,7681,18839,8957,18112,2866,5434,11823,23546,0.0289912888232216,0.502123502930434
2016,39051,78,611,34,240,0,16,34,256,0.00897143858419485,0.1328125
2016,39053,30,318,115,348,0,11,115,359,0.0174356483729966,0.32033426183844
2016,39055,725,1834,277,439,134,194,411,633,0.00993112537065219,0.649289099526066
2016,39057,1470,3958,1641,2901,304,623,1945,3524,0.0323083411262079,0.551929625425653
2016,39059,112,545,31,258,0,9,31,267,0.009783803591059,0.116104868913858
2016,39061,3721,9968,5446,10904,1749,2552,7195,13456,0.0249300602130616,0.534705707491082
2016,39063,260,1305,259,795,37,60,296,855,0.0167018284106892,0.346198830409357
2016,39065,69,504,97,203,0,18,97,221,0.0114270941054809,0.438914027149321
2016,39067,34,239,15,170,0,15,15,185,0.0165874652559849,0.0810810810810811
2016,39069,122,719,78,202,0,10,78,212,0.0111216031895919,0.367924528301887
2016,39071,117,1017,55,198,11,24,66,222,0.00758974358974359,0.297297297297297
2016,39073,105,800,0,66,0,5,0,71,0.00356533092296877,0
2016,39075,19,435,0,254,0,12,0,266,0.0106861642294713,0
2016,39077,35,1114,77,421,5,16,82,437,0.0111394341065511,0.187643020594966
2016,39079,116,613,43,316,0,49,43,365,0.0164170377366977,0.117808219178082
2016,39081,75,745,297,1224,0,19,297,1243,0.02599874503242,0.238938053097345
2016,39083,369,1356,106,522,9,49,115,571,0.0144461873197389,0.201401050788091
2016,39085,1184,3524,534,1455,86,304,620,1759,0.010764993880049,0.352472996020466
2016,39087,66,357,74,1226,0,75,74,1301,0.0303829985987856,0.0568793235972329
2016,39089,1261,4247,475,1323,96,167,571,1490,0.013075795736764,0.383221476510067
2016,39091,120,875,30,274,20,61,50,335,0.0108005287423026,0.149253731343284
2016,39093,1720,6384,609,1694,134,599,743,2293,0.0110304552167367,0.324029655473179
2016,39095,1485,4981,1456,4560,371,678,1827,5238,0.0180483149048484,0.348797250859107
2016,39097,381,2946,44,300,24,67,68,367,0.0119438929931331,0.185286103542234
2016,39099,447,3798,605,2570,134,360,739,2930,0.017790785223326,0.25221843003413
2016,39101,102,2165,70,452,0,30,70,482,0.0104414886703349,0.145228215767635
2016,39103,1393,4307,595,1187,148,280,743,1467,0.012136103045194,0.506475800954329
2016,39105,101,409,37,199,0,1,37,200,0.0121102028458977,0.185
2016,39107,91,583,67,192,52,125,119,317,0.0116909459708648,0.375394321766562
2016,39109,675,2228,154,736,52,214,206,950,0.013259082471493,0.216842105263158
2016,39111,8,108,25,69,0,26,25,95,0.00907354345749761,0.263157894736842
2016,39113,2463,8639,2234,6062,701,1512,2935,7574,0.0208909692207122,0.387509902297333
2016,39115,9,287,13,84,7,7,20,91,0.00873572045694538,0.21978021978022
2016,39117,44,487,24,132,17,38,41,170,0.00716211661611055,0.241176470588235
2016,39119,263,1215,48,291,25,92,73,383,0.006592423016679,0.190600522193211
2016,39121,33,1025,0,85,0,1,0,86,0.00802313648661256,0
2016,39123,318,916,118,454,2,8,120,462,0.0152782830120044,0.25974025974026
2016,39125,57,355,37,65,0,59,37,124,0.00945482272207396,0.298387096774194
2016,39127,146,867,34,154,0,38,34,192,0.00794340325183071,0.177083333333333
2016,39129,342,3493,48,306,0,56,48,362,0.00928562267538797,0.132596685082873
2016,39131,139,855,21,176,0,23,21,199,0.0103505669406013,0.105527638190955
2016,39133,907,3282,737,1476,350,441,1087,1917,0.0185229918931715,0.567031820552947
2016,39135,74,632,33,410,14,47,47,457,0.015923899787449,0.102844638949672
2016,39137,118,584,31,70,1,15,32,85,0.00376973567500443,0.376470588235294
2016,39139,519,4105,140,781,80,153,220,934,0.0109906920370436,0.235546038543897
2016,39141,193,2584,22,273,8,11,30,284,0.00523589166866393,0.105633802816901
2016,39143,185,854,104,402,0,22,104,424,0.0102980108323416,0.245283018867925
2016,39145,87,988,76,536,0,70,76,606,0.0114077030232295,0.125412541254125
2016,39147,252,1174,34,250,31,50,65,300,0.00809957072275169,0.216666666666667
2016,39149,147,557,66,318,10,50,76,368,0.0113928361351042,0.206521739130435
2016,39151,1174,4879,516,2227,225,528,741,2755,0.0106459029696466,0.268965517241379
2016,39153,2897,8396,2031,3951,459,1098,2490,5049,0.0134592623396564,0.493166963755199
2016,39155,470,2784,451,1582,31,191,482,1773,0.0122066244862271,0.271855611957135
2016,39157,322,1389,147,672,16,69,163,741,0.0115685447988385,0.219973009446694
2016,39159,883,2791,117,435,74,104,191,539,0.0150294175055071,0.354359925788497
2016,39161,168,719,36,335,20,25,56,360,0.0184691155345783,0.155555555555556
2016,39163,33,325,0,29,0,10,0,39,0.00432468396540253,0
2016,39165,3079,7128,1889,3382,742,1134,2631,4516,0.0305258888738678,0.5825952170062
2016,39167,93,448,223,942,10,102,233,1044,0.0240902692849067,0.223180076628352
2016,39169,637,2445,150,414,55,66,205,480,0.00634316523945449,0.427083333333333
2016,39171,99,896,68,425,0,23,68,448,0.0173852303154954,0.151785714285714
2016,39173,863,3021,586,1013,157,374,743,1387,0.017418058520658,0.535688536409517
2016,39175,140,611,0,142,0,9,0,151,0.00979565358417126,0
2016,40001,29,184,22,186,0,3,22,189,0.013273404031182,0.116402116402116
2016,40003,30,321,20,175,1,1,21,176,0.0410639290713952,0.119318181818182
2016,40005,26,783,23,90,0,5,23,95,0.00992167101827676,0.242105263157895
2016,40007,23,90,4,99,2,5,6,104,0.0286028602860286,0.0576923076923077
2016,40009,23,1040,10,231,0,0,10,231,0.0150832517140059,0.0432900432900433
2016,40011,46,376,18,309,0,0,18,309,0.0443646805455851,0.058252427184466
2016,40013,131,509,325,1089,13,40,338,1129,0.0382867607162235,0.299379982285208
2016,40015,113,804,12,268,0,35,12,303,0.0155600061623787,0.0396039603960396
2016,40017,1061,3977,514,2230,57,205,571,2435,0.0285764581621875,0.234496919917864
2016,40019,130,766,134,553,0,76,134,629,0.0195341614906832,0.213036565977742
2016,40021,217,705,230,426,8,21,238,447,0.0149368442157321,0.532438478747204
2016,40023,11,210,12,180,0,0,12,180,0.0175318983149898,0.0666666666666667
2016,40025,3,21,4,18,0,0,4,18,0.0112640801001252,0.222222222222222
2016,40027,1658,7206,1690,3557,487,868,2177,4425,0.0259419720588839,0.491977401129943
2016,40029,22,135,0,49,0,10,0,59,0.0152061855670103,0
2016,40031,364,2412,1652,4888,333,813,1985,5701,0.0735148099911024,0.348184529029995
2016,40033,0,114,15,161,0,3,15,164,0.0393946673072304,0.0914634146341463
2016,40035,59,802,31,177,0,15,31,192,0.0187061574434918,0.161458333333333
2016,40037,209,1416,85,256,10,78,95,334,0.00695847830163128,0.284431137724551
2016,40039,142,848,59,223,10,35,69,258,0.0151737928600835,0.267441860465116
2016,40041,182,813,221,1029,34,38,255,1067,0.0359731634132362,0.238987816307404
2016,40043,82,147,15,42,0,0,15,42,0.0130475302889096,0.357142857142857
2016,40045,18,121,5,82,0,0,5,82,0.0287820287820288,0.0609756097560976
2016,40047,188,1182,480,1497,90,221,570,1718,0.0421781400373171,0.331781140861467
2016,40049,24,307,18,101,0,15,18,116,0.006297160849031,0.155172413793103
2016,40051,430,1563,117,334,0,17,117,351,0.00970793229339529,0.333333333333333
2016,40053,12,111,7,55,0,0,7,55,0.01743264659271,0.127272727272727
2016,40055,15,651,24,86,0,0,24,86,0.0199489677569009,0.27906976744186
2016,40057,5,87,8,31,0,0,8,31,0.0161711006781429,0.258064516129032
2016,40059,21,86,10,11,0,46,10,57,0.0226550079491256,0.175438596491228
2016,40061,11,138,5,71,0,15,5,86,0.00984544934172868,0.0581395348837209
2016,40063,80,625,32,91,4,17,36,108,0.0112044817927171,0.333333333333333
2016,40065,104,624,232,613,30,165,262,778,0.047225931771276,0.336760925449871
2016,40067,37,186,11,70,0,0,11,70,0.0163475011676787,0.157142857142857
2016,40069,35,262,64,266,5,12,69,278,0.0372254954472416,0.248201438848921
2016,40071,174,1010,228,939,20,72,248,1011,0.0337968844019523,0.245301681503462
2016,40073,44,190,21,116,0,0,21,116,0.0115699182126471,0.181034482758621
2016,40075,64,299,19,200,4,7,23,207,0.0322731524789523,0.111111111111111
2016,40077,37,198,22,135,12,24,34,159,0.0223849077854428,0.213836477987421
2016,40079,25,817,104,692,10,24,114,716,0.0213546482149781,0.159217877094972
2016,40081,122,740,65,284,13,55,78,339,0.014462457337884,0.230088495575221
2016,40083,681,1799,161,534,12,20,173,554,0.0184047041626524,0.312274368231047
2016,40085,14,95,16,139,0,20,16,159,0.0246282527881041,0.10062893081761
2016,40087,485,1732,108,247,4,4,112,251,0.0102103079363788,0.446215139442231
2016,40089,32,352,24,265,0,10,24,275,0.0126547328700934,0.0872727272727273
2016,40091,17,433,0,168,0,33,0,201,0.0137051684167462,0
2016,40093,8,188,9,61,0,2,9,63,0.0120921305182342,0.142857142857143
2016,40095,46,389,35,339,0,4,35,343,0.0311846531502864,0.102040816326531
2016,40097,92,694,64,482,2,21,66,503,0.0182882489819663,0.131212723658052
2016,40099,77,346,33,185,0,0,33,185,0.0194450283792306,0.178378378378378
2016,40101,337,2509,113,836,28,59,141,895,0.0192842214130271,0.157541899441341
2016,40103,82,284,57,182,0,13,57,195,0.0248914985958642,0.292307692307692
2016,40105,39,285,8,96,0,0,8,96,0.0132816823464305,0.0833333333333333
2016,40107,40,287,18,53,0,12,18,65,0.00785973397823458,0.276923076923077
2016,40109,3881,14598,4604,12767,1101,2972,5705,15739,0.0317502264415095,0.362475379630218
2016,40111,250,1094,134,441,0,3,134,444,0.0171276472630483,0.301801801801802
2016,40113,269,1798,29,295,0,32,29,327,0.00979423128762692,0.0886850152905199
2016,40115,67,453,89,614,2,15,91,629,0.0302185923612779,0.144674085850556
2016,40117,50,455,11,91,6,22,17,113,0.0100668151447661,0.150442477876106
2016,40119,508,1844,418,1120,307,439,725,1559,0.036515669649131,0.465041693393201
2016,40121,175,1420,97,722,0,24,97,746,0.0239540185595479,0.130026809651475
2016,40123,125,859,65,424,10,63,75,487,0.0198160807291667,0.154004106776181
2016,40125,266,2334,58,629,0,54,58,683,0.0145775083772651,0.0849194729136164
2016,40127,24,265,24,180,0,9,24,189,0.023936170212766,0.126984126984127
2016,40129,10,31,5,38,0,0,5,38,0.0152549177037334,0.131578947368421
2016,40131,481,2397,356,923,9,131,365,1054,0.0176348547717842,0.346299810246679
2016,40133,86,785,11,186,0,4,11,190,0.0114271967282131,0.0578947368421053
2016,40135,80,639,23,763,0,25,23,788,0.0280936931797925,0.0291878172588832
2016,40137,174,1032,68,504,17,39,85,543,0.0178219771563608,0.156537753222836
2016,40139,42,141,80,581,7,7,87,588,0.0449438202247191,0.147959183673469
2016,40141,10,190,30,142,0,25,30,167,0.032509246642009,0.179640718562874
2016,40143,2417,10600,3529,10371,619,1749,4148,12120,0.0295154067013611,0.342244224422442
2016,40145,652,3073,211,833,0,86,211,919,0.0180234952636843,0.229597388465724
2016,40147,228,1067,267,982,118,221,385,1203,0.0339265066696748,0.320033250207814
2016,40149,18,240,18,119,2,8,20,127,0.0164188752424047,0.15748031496063
2016,40151,63,516,69,145,0,0,69,145,0.0253807106598985,0.475862068965517
2016,40153,149,641,26,186,0,69,26,255,0.0184461805555556,0.101960784313725
2016,41001,164,631,107,323,0,9,107,332,0.0281165311653117,0.322289156626506
2016,41003,690,1538,1285,1912,361,451,1646,2363,0.0448148991048399,0.696572154041473
2016,41005,4350,11780,3000,6609,437,850,3437,7459,0.0270850278875203,0.460785628100282
2016,41007,206,1004,388,1316,0,11,388,1327,0.0489451165535556,0.292388847023361
2016,41009,285,1424,387,1109,50,69,437,1178,0.0336340794883508,0.370967741935484
2016,41011,174,1021,289,1304,63,86,352,1390,0.0298193675719741,0.253237410071942
2016,41013,125,875,56,377,0,21,56,398,0.0250645506643995,0.14070351758794
2016,41015,30,405,273,1192,0,46,273,1238,0.0697229105654427,0.220516962843296
2016,41017,1102,3011,2337,4571,275,384,2612,4955,0.0405811582214724,0.527144298688194
2016,41019,211,1729,441,2155,17,103,458,2258,0.0286941493417374,0.202834366696191
2016,41021,10,41,8,12,0,0,8,12,0.00897531787584144,0.666666666666667
2016,41023,21,181,46,113,0,3,46,116,0.0211254780549991,0.396551724137931
2016,41025,32,182,59,132,15,25,74,157,0.0304558680892338,0.471337579617834
2016,41027,91,178,253,439,25,48,278,487,0.031755346896192,0.570841889117043
2016,41029,641,3272,1874,5110,130,360,2004,5470,0.0366104235966562,0.36636197440585
2016,41031,84,908,90,424,3,20,93,444,0.0294840294840295,0.209459459459459
2016,41033,289,1593,655,2343,17,77,672,2420,0.0392691396488495,0.277685950413223
2016,41035,223,979,236,1325,33,78,269,1403,0.0306111317173216,0.191732002851034
2016,41037,53,352,38,150,7,21,45,171,0.0292958711666952,0.263157894736842
2016,41039,1248,4317,2380,6788,552,1051,2932,7839,0.0321167823400716,0.374027299400434
2016,41041,439,983,270,1183,19,36,289,1219,0.0342540815466322,0.237079573420837
2016,41043,726,3281,467,1615,44,159,511,1774,0.02156707798918,0.288049605411499
2016,41045,57,916,102,771,0,62,102,833,0.0419922367293442,0.122448979591837
2016,41047,2117,8497,1402,4081,185,705,1587,4786,0.0225707871951105,0.331592143752612
2016,41049,35,184,18,210,0,18,18,228,0.0324324324324324,0.0789473684210526
2016,41051,6075,15289,12145,21250,2613,4392,14758,25642,0.0459758986027214,0.57554012947508
2016,41053,661,2718,119,872,143,220,262,1092,0.0218199256683851,0.23992673992674
2016,41055,5,50,18,46,0,3,18,49,0.0374617737003058,0.36734693877551
2016,41057,97,577,69,428,13,14,82,442,0.0233442484419563,0.18552036199095
2016,41059,155,1757,138,955,36,87,174,1042,0.0210505050505051,0.166986564299424
2016,41061,137,409,109,400,0,80,109,480,0.0280898876404494,0.227083333333333
2016,41063,43,191,37,206,0,5,37,211,0.0396914973664409,0.175355450236967
2016,41065,107,451,182,633,0,28,182,661,0.0371348314606742,0.275340393343419
2016,41067,5137,12514,6807,13195,2181,3374,8988,16569,0.043557354854822,0.542458808618504
2016,41069,8,76,0,9,0,0,0,9,0.00786713286713287,0
2016,41071,1109,3561,805,2174,61,157,866,2331,0.0345302639765354,0.371514371514371
2016,42001,216,1378,560,1401,36,179,596,1580,0.0223476329896324,0.377215189873418
2016,42003,5584,11201,9638,15602,2804,4492,12442,20094,0.0228298621959796,0.619189807902857
2016,42005,203,1020,87,344,0,51,87,395,0.00798350748832791,0.220253164556962
2016,42007,855,3101,429,1024,43,90,472,1114,0.009093654849269,0.423698384201077
2016,42009,107,400,96,321,12,36,108,357,0.0101115957627599,0.302521008403361
2016,42011,1133,5155,850,2946,168,744,1018,3690,0.0132710421544404,0.275880758807588
2016,42013,301,1410,211,694,44,111,255,805,0.009063784270675,0.316770186335404
2016,42015,64,269,113,574,0,10,113,584,0.0133914239853245,0.193493150684932
2016,42017,3029,8330,3720,7453,884,1816,4604,9269,0.0209614353913336,0.496709461646348
2016,42019,1715,3676,602,1175,40,189,642,1364,0.0104551516916803,0.470674486803519
2016,42021,289,1506,215,962,33,140,248,1102,0.0112171983469392,0.225045372050817
2016,42023,51,152,6,33,0,0,6,33,0.00908590308370044,0.181818181818182
2016,42025,231,1222,133,580,72,100,205,680,0.0144174705819994,0.301470588235294
2016,42027,1253,3317,1284,2100,959,1214,2243,3314,0.0353376483509453,0.676825588412794
2016,42029,3873,7259,3861,6204,1028,1864,4889,8068,0.0233996827063351,0.605974219137333
2016,42031,153,564,99,313,6,38,105,351,0.0134384930510356,0.299145299145299
2016,42033,302,2058,99,869,23,138,122,1007,0.0169745802710539,0.121151936444886
2016,42035,150,583,84,176,0,61,84,237,0.00946296666001198,0.354430379746835
2016,42037,219,757,159,366,44,72,203,438,0.0100176108684217,0.463470319634703
2016,42039,235,1276,217,693,50,136,267,829,0.0138309586572792,0.322074788902292
2016,42041,1639,7473,1861,3245,617,869,2478,4114,0.0242670913702589,0.602333495381624
2016,42043,1667,5753,1467,3805,553,1043,2020,4848,0.025825285127555,0.416666666666667
2016,42045,3323,8668,2451,4658,791,1824,3242,6482,0.0171510974109304,0.500154273372416
2016,42047,6,203,14,76,0,24,14,100,0.00439290107186786,0.14
2016,42049,764,2613,1326,2905,227,525,1553,3430,0.0182690720057097,0.452769679300292
2016,42051,230,1860,207,689,23,82,230,771,0.00790899019326248,0.298313878080415
2016,42053,18,659,17,57,0,6,17,63,0.00969976905311778,0.26984126984127
2016,42055,318,1473,544,1678,91,252,635,1930,0.0182614701902788,0.329015544041451
2016,42057,32,266,26,76,0,2,26,78,0.00749567557178551,0.333333333333333
2016,42059,112,799,67,353,2,40,69,393,0.0146817095038852,0.175572519083969
2016,42061,114,1086,32,90,68,87,100,177,0.00541267851136051,0.564971751412429
2016,42063,259,1155,173,580,36,128,209,708,0.012610205717339,0.295197740112994
2016,42065,86,751,39,229,0,33,39,262,0.00830664848926794,0.148854961832061
2016,42067,57,453,12,71,4,73,16,144,0.008277289187791,0.111111111111111
2016,42069,825,2594,605,1744,200,489,805,2233,0.0149095279428457,0.360501567398119
2016,42071,2148,5799,1710,3946,353,1299,2063,5245,0.0147997866799098,0.393326978074357
2016,42073,180,865,300,854,11,95,311,949,0.0150548892696237,0.327713382507903
2016,42075,696,2629,235,915,9,411,244,1326,0.0141506413676819,0.184012066365008
2016,42077,2020,6827,1633,4244,378,1613,2011,5857,0.0240102977408101,0.343349837800922
2016,42079,764,3419,690,2301,146,632,836,2933,0.0129331822330795,0.285032390044323
2016,42081,309,1856,301,1074,61,123,362,1197,0.0148363906792266,0.302422723475355
2016,42083,71,435,94,384,11,44,105,428,0.014201340500365,0.245327102803738
2016,42085,269,1293,308,1070,2,108,310,1178,0.0147393708866144,0.263157894736842
2016,42087,69,587,45,219,0,66,45,285,0.00872199779654793,0.157894736842105
2016,42089,566,1893,736,2619,135,458,871,3077,0.0271728571680885,0.283067923301917
2016,42091,7914,17530,4971,8520,2182,2965,7153,11485,0.0201195787939464,0.622812363952982
2016,42093,323,694,109,217,33,37,142,254,0.0190062855432505,0.559055118110236
2016,42095,1419,4685,1490,3695,250,733,1740,4428,0.0212560664756117,0.392953929539295
2016,42097,330,1915,132,524,32,125,164,649,0.00955212457501141,0.252696456086287
2016,42099,140,781,88,244,2,54,90,298,0.00930755536121436,0.302013422818792
2016,42101,7234,14936,11693,19277,3993,9050,15686,28327,0.0273624199711761,0.553747308221838
2016,42103,235,727,453,1544,35,36,488,1580,0.0388980526354662,0.308860759493671
2016,42105,43,249,47,253,0,9,47,262,0.0212662337662338,0.179389312977099
2016,42107,205,2074,146,936,19,145,165,1081,0.010182551195343,0.15263644773358
2016,42109,45,535,56,196,14,154,70,350,0.0131529500187899,0.2
2016,42111,253,1376,59,396,10,65,69,461,0.00815308703110907,0.149674620390456
2016,42113,36,129,35,63,0,4,35,67,0.0136206546045944,0.522388059701492
2016,42115,56,554,95,502,10,37,105,539,0.0176559224318658,0.194805194805195
2016,42117,100,427,157,393,7,50,164,443,0.0151034741399884,0.37020316027088
2016,42119,414,1358,178,1150,4,111,182,1261,0.0410241395015941,0.144329896907216
2016,42121,158,899,75,263,2,35,77,298,0.00771900740817489,0.258389261744966
2016,42123,133,618,95,342,11,22,106,364,0.0122898237558242,0.291208791208791
2016,42125,1038,3507,798,1876,83,381,881,2257,0.0151837250918289,0.390341160832964
2016,42127,212,1406,193,806,30,49,223,855,0.0221784130113356,0.260818713450292
2016,42129,1573,5155,801,1991,78,354,879,2345,0.00891462111909858,0.374840085287846
2016,42131,73,469,24,205,7,7,31,212,0.0107592367032075,0.14622641509434
2016,42133,1115,4852,1376,4865,297,1048,1673,5913,0.0194171250307856,0.28293590394047
2016,44001,518,911,403,754,39,71,442,825,0.024158833347975,0.535757575757576
2016,44003,1415,4433,1151,2184,177,300,1328,2484,0.0205990645835407,0.534621578099839
2016,44005,366,817,2511,3808,286,390,2797,4198,0.0706519909791646,0.666269652215341
2016,44007,1290,4063,4894,9929,1486,3317,6380,13246,0.0311432434021043,0.481654839196739
2016,44009,684,1463,1029,1884,108,184,1137,2068,0.0242643262777491,0.549806576402321
2016,45001,140,518,18,179,0,10,18,189,0.0110675177138842,0.0952380952380952
2016,45003,325,1517,786,3080,85,236,871,3316,0.0290085818512654,0.262665862484922
2016,45005,10,421,0,27,0,0,0,27,0.00407608695652174,0
2016,45007,671,2960,609,2097,267,438,876,2535,0.0192686282408921,0.345562130177515
2016,45009,27,157,42,104,0,23,42,127,0.012872491384553,0.330708661417323
2016,45011,44,287,40,150,9,44,49,194,0.0135201059307269,0.252577319587629
2016,45013,568,1725,4482,8901,363,786,4845,9687,0.0780825561618881,0.500154846701765
2016,45015,1462,5354,1453,4635,94,393,1547,5028,0.0385751440430249,0.307677008750994
2016,45017,24,326,9,136,0,0,9,136,0.0126924871675222,0.0661764705882353
2016,45019,1841,6051,6135,10110,633,997,6768,11107,0.0417526567651183,0.609345457819393
2016,45021,277,879,21,648,0,28,21,676,0.0181671593657619,0.0310650887573964
2016,45023,64,396,76,215,0,73,76,288,0.0129694677114293,0.263888888888889
2016,45025,246,781,115,381,0,74,115,455,0.014480761274307,0.252747252747253
2016,45027,117,800,30,373,4,50,34,423,0.0178941579593045,0.0803782505910166
2016,45029,246,732,84,317,0,39,84,356,0.0136597344793185,0.235955056179775
2016,45031,239,1253,138,491,0,23,138,514,0.0112021619736727,0.268482490272374
2016,45033,10,569,7,192,27,27,34,219,0.0107479387514723,0.155251141552511
2016,45035,1080,4739,1078,3290,190,342,1268,3632,0.0371115902193794,0.349118942731278
2016,45037,115,803,127,586,23,118,150,704,0.0371778622729193,0.213068181818182
2016,45039,0,217,31,132,23,60,54,192,0.0116618075801749,0.28125
2016,45041,384,1576,441,1429,10,84,451,1513,0.0163843888070692,0.298083278255122
2016,45043,334,1419,410,1230,0,61,410,1291,0.0290929577464789,0.317583268783888
2016,45045,2372,6215,4202,8980,1100,1984,5302,10964,0.0337888229384319,0.483582634075155
2016,45047,351,1423,323,984,29,49,352,1033,0.0221241781071299,0.340755082284608
2016,45049,79,309,16,299,0,28,16,327,0.023400601116359,0.0489296636085627
2016,45051,838,3308,2577,10663,242,986,2819,11649,0.0534976211032937,0.241995021031848
2016,45053,85,596,188,659,0,31,188,690,0.0364212193190816,0.272463768115942
2016,45055,210,758,226,683,0,70,226,753,0.0174228927092251,0.300132802124834
2016,45057,183,794,730,1821,14,195,744,2016,0.0343458779835426,0.369047619047619
2016,45059,203,2197,94,621,0,70,94,691,0.0153453253386631,0.136034732272069
2016,45061,28,512,10,105,0,11,10,116,0.00932176149148184,0.0862068965517241
2016,45063,1892,6324,1307,4061,277,688,1584,4749,0.0250984329994979,0.333543903979785
2016,45065,65,417,98,211,14,16,112,227,0.0284318637274549,0.493392070484582
2016,45067,17,270,10,392,99,194,109,586,0.0269847117332842,0.186006825938567
2016,45069,52,713,4,410,0,53,4,463,0.0235324015247776,0.00863930885529158
2016,45071,66,629,35,231,19,77,54,308,0.0120223271790468,0.175324675324675
2016,45073,365,1057,521,1306,38,167,559,1473,0.0272954692856481,0.379497623896809
2016,45075,282,987,124,453,2,64,126,517,0.00870912858177653,0.243713733075435
2016,45077,569,2308,628,1802,141,322,769,2124,0.0282804074295986,0.362052730696798
2016,45079,2693,9260,3788,9550,685,1369,4473,10919,0.0439196663086806,0.409652898617089
2016,45081,46,272,116,252,0,27,116,279,0.0200878392972856,0.415770609318996
2016,45083,1094,4697,1334,3986,212,589,1546,4575,0.0233212521600832,0.33792349726776
2016,45085,215,1254,533,1681,118,527,651,2208,0.0317844187251684,0.294836956521739
2016,45087,122,634,3,86,0,7,3,93,0.00472081218274112,0.032258064516129
2016,45089,49,525,19,159,98,173,117,332,0.0144978165938865,0.352409638554217
2016,45091,852,2536,3241,6873,158,332,3399,7205,0.0441767068273092,0.47175572519084
2016,46003,0,28,4,4,0,3,4,7,0.00383982446516731,0.571428571428571
2016,46005,36,153,33,207,42,89,75,296,0.024495200264813,0.253378378378378
2016,46007,2,60,17,28,0,0,17,28,0.0145681581685744,0.607142857142857
2016,46009,56,446,18,99,0,1,18,100,0.0194325689856199,0.18
2016,46011,167,518,246,446,37,81,283,527,0.0301590935103582,0.537001897533207
2016,46013,255,853,176,876,35,46,211,922,0.0361511919698871,0.22885032537961
2016,46015,43,108,6,23,0,0,6,23,0.00644980370162647,0.260869565217391
2016,46017,0,5,3,3,0,0,3,3,0.0029126213592233,1
2016,46019,173,391,0,132,17,21,17,153,0.0217576791808874,0.111111111111111
2016,46021,17,26,4,15,0,0,4,15,0.0138376383763838,0.266666666666667
2016,46023,39,114,23,124,0,0,23,124,0.0216178521617852,0.185483870967742
2016,46025,15,123,3,12,0,0,3,12,0.00488599348534202,0.25
2016,46027,26,125,141,193,37,47,178,240,0.0344184712462355,0.741666666666667
2016,46029,75,495,64,287,0,14,64,301,0.0162063210036074,0.212624584717608
2016,46031,8,19,8,26,13,13,21,39,0.0166952054794521,0.538461538461538
2016,46033,25,208,55,207,20,20,75,227,0.0341815991567535,0.330396475770925
2016,46035,114,618,128,305,0,13,128,318,0.0240854351283799,0.40251572327044
2016,46037,7,113,21,104,6,6,27,110,0.0271940667490729,0.245454545454545
2016,46039,8,61,28,80,0,0,28,80,0.0264637777042673,0.35
2016,46041,7,49,3,17,0,3,3,20,0.00650195058517555,0.15
2016,46043,4,80,11,23,0,2,11,25,0.0118539592223803,0.44
2016,46045,17,80,1,22,5,5,6,27,0.00991189427312775,0.222222222222222
2016,46047,17,61,54,330,0,0,54,330,0.0633275762809442,0.163636363636364
2016,46049,34,141,4,32,0,2,4,34,0.019941348973607,0.117647058823529
2016,46051,8,56,19,56,3,4,22,60,0.0117647058823529,0.366666666666667
2016,46053,5,76,10,72,0,8,10,80,0.0268817204301075,0.125
2016,46055,6,19,18,27,0,0,18,27,0.0184049079754601,0.666666666666667
2016,46057,51,194,3,74,0,1,3,75,0.0204248366013072,0.04
2016,46059,38,57,5,28,0,0,5,28,0.0117795540597392,0.178571428571429
2016,46061,20,75,0,46,0,0,0,46,0.022362664073894,0
2016,46063,2,17,13,21,0,0,13,21,0.0249406175771971,0.619047619047619
2016,46065,85,609,130,318,0,0,130,318,0.0262268041237113,0.408805031446541
2016,46067,27,184,11,55,0,0,11,55,0.0109649122807018,0.2
2016,46069,10,29,4,4,0,0,4,4,0.00378071833648393,1
2016,46071,0,58,16,63,0,0,16,63,0.0346153846153846,0.253968253968254
2016,46073,15,36,25,29,0,12,25,41,0.027891156462585,0.609756097560976
2016,46075,0,4,0,6,0,0,0,6,0.00980392156862745,0
2016,46077,51,170,9,67,0,8,9,75,0.0205817782656422,0.12
2016,46079,82,246,108,252,5,12,113,264,0.0319728715029672,0.428030303030303
2016,46081,227,684,218,623,41,100,259,723,0.0427330220462202,0.358229598893499
2016,46083,785,2180,314,907,0,22,314,929,0.028205361751222,0.33799784714747
2016,46085,17,61,20,57,0,0,20,57,0.023466447097571,0.350877192982456
2016,46087,27,147,2,137,0,4,2,141,0.0376200640341515,0.0141843971631206
2016,46089,5,114,0,101,0,3,0,104,0.0606767794632439,0
2016,46091,67,192,17,108,10,14,27,122,0.0369026013309135,0.221311475409836
2016,46093,184,892,104,670,21,133,125,803,0.0459803023362345,0.155666251556663
2016,46095,0,23,0,15,0,5,0,20,0.0159108989657916,0
2016,46097,14,45,12,44,0,0,12,44,0.0280612244897959,0.272727272727273
2016,46099,765,3040,1128,2873,61,506,1189,3379,0.0283878013946064,0.351879254217224
2016,46101,28,182,2,41,13,46,15,87,0.0203651685393258,0.172413793103448
2016,46102,10,95,17,84,0,0,17,84,0.0119538921303543,0.202380952380952
2016,46103,443,1948,838,2814,111,225,949,3039,0.0420320323089265,0.312273774267851
2016,46105,34,47,17,108,2,2,19,110,0.0503893724232707,0.172727272727273
2016,46107,1,29,3,13,0,0,3,13,0.00742009132420091,0.230769230769231
2016,46109,13,123,31,136,0,7,31,143,0.0220067713142505,0.216783216783217
2016,46111,0,44,6,40,0,0,6,40,0.0233644859813084,0.15
2016,46115,29,141,14,107,0,7,14,114,0.0253108348134991,0.12280701754386
2016,46117,7,42,0,8,0,0,0,8,0.00396235760277365,0
2016,46119,6,6,1,3,0,7,1,10,0.0102880658436214,0.1
2016,46121,0,83,23,78,0,11,23,89,0.0182190378710338,0.258426966292135
2016,46123,22,43,5,57,0,5,5,62,0.0159260210634472,0.0806451612903226
2016,46125,41,210,27,82,3,5,30,87,0.0149484536082474,0.344827586206897
2016,46127,130,276,258,624,0,33,258,657,0.0652173913043478,0.392694063926941
2016,46129,20,159,23,134,46,48,69,182,0.0458553791887125,0.379120879120879
2016,46135,70,422,144,509,0,22,144,531,0.0335100340780008,0.271186440677966
2016,46137,4,18,4,4,0,0,4,4,0.00263504611330698,1
2016,47001,299,2129,306,965,222,292,528,1257,0.0234453687469691,0.420047732696897
2016,47003,125,777,37,496,14,39,51,535,0.0175946328148124,0.0953271028037383
2016,47005,43,198,69,166,30,41,99,207,0.0173978819969743,0.478260869565217
2016,47007,77,691,0,143,0,0,0,143,0.0139880661254035,0
2016,47009,507,2024,523,1550,50,165,573,1715,0.0192023468290935,0.334110787172012
2016,47011,368,1379,383,1808,46,160,429,1968,0.0284290357529794,0.217987804878049
2016,47013,27,344,64,555,0,28,64,583,0.0203646779376834,0.109777015437393
2016,47015,101,779,37,171,0,11,37,182,0.0184341132381242,0.203296703296703
2016,47017,84,448,38,221,0,27,38,248,0.0126932132255093,0.153225806451613
2016,47019,298,1287,35,565,13,59,48,624,0.0151599815359199,0.0769230769230769
2016,47021,269,1446,209,477,0,9,209,486,0.0179084678310856,0.430041152263374
2016,47023,0,183,28,198,0,28,28,226,0.0206242014966235,0.123893805309735
2016,47025,217,501,214,842,4,38,218,880,0.0391250222301263,0.247727272727273
2016,47027,10,234,10,79,2,9,12,88,0.0155093408530137,0.136363636363636
2016,47029,51,355,89,638,0,0,89,638,0.0252743334785881,0.139498432601881
2016,47031,171,1286,256,957,36,59,292,1016,0.0278501137578465,0.28740157480315
2016,47033,72,365,0,70,0,0,0,70,0.00708215297450425,0
2016,47035,130,1119,367,1297,14,51,381,1348,0.0308848462631169,0.282640949554896
2016,47037,4722,11336,9220,16391,1572,3426,10792,19817,0.0436327687223263,0.544582933844679
2016,47039,13,258,19,93,0,0,19,93,0.0110819828408008,0.204301075268817
2016,47041,99,479,3,45,0,1,3,46,0.00345267582376342,0.0652173913043478
2016,47043,163,1101,189,538,0,0,189,538,0.0154579933340995,0.351301115241636
2016,47045,93,693,49,224,50,106,99,330,0.0129188850610711,0.3
2016,47047,267,814,93,367,27,80,120,447,0.0158882490936234,0.268456375838926
2016,47049,10,338,69,287,0,20,69,307,0.024264938349668,0.224755700325733
2016,47051,225,786,127,606,0,40,127,646,0.0229493054815446,0.196594427244582
2016,47053,126,955,89,289,0,28,89,317,0.0094322780290407,0.280757097791798
2016,47055,100,582,59,347,20,50,79,397,0.0195105170041282,0.198992443324937
2016,47057,34,582,53,359,18,58,71,417,0.0255561684133113,0.170263788968825
2016,47059,128,1019,160,803,14,96,174,899,0.0183424467477352,0.193548387096774
2016,47061,16,196,0,23,0,0,0,23,0.00243000528262018,0
2016,47063,165,1039,74,741,70,112,144,853,0.0196598137733936,0.168815943728019
2016,47065,1356,3318,2571,7503,315,649,2886,8152,0.0335019664733756,0.354023552502453
2016,47067,3,114,3,46,0,18,3,64,0.0134680134680135,0.046875
2016,47069,31,373,3,65,8,10,11,75,0.00410868850662868,0.146666666666667
2016,47071,27,335,76,362,0,8,76,370,0.0198625724715482,0.205405405405405
2016,47073,196,1364,151,623,0,12,151,635,0.0157115993665875,0.237795275590551
2016,47075,7,340,7,39,0,88,7,127,0.0101324397638423,0.0551181102362205
2016,47077,76,575,47,160,0,50,47,210,0.0109136264421578,0.223809523809524
2016,47079,6,365,38,488,2,2,40,490,0.0210970464135021,0.0816326530612245
2016,47081,39,918,42,148,0,8,42,156,0.00926971299542457,0.269230769230769
2016,47083,14,244,25,98,7,14,32,112,0.0195564868168325,0.285714285714286
2016,47085,34,293,24,168,0,101,24,269,0.0210782009089484,0.0892193308550186
2016,47087,30,331,3,52,10,10,13,62,0.00735555819195634,0.209677419354839
2016,47089,216,1622,135,920,18,62,153,982,0.0266146299157113,0.155804480651731
2016,47091,14,728,12,264,15,28,27,292,0.0217553270749516,0.0924657534246575
2016,47093,2110,7603,3561,7789,571,923,4132,8712,0.0292852148658097,0.474288337924702
2016,47095,65,767,1,47,0,14,1,61,0.0107299912049252,0.0163934426229508
2016,47097,25,1247,35,185,0,1,35,186,0.0101004615802335,0.188172043010753
2016,47099,103,454,33,348,9,29,42,377,0.0132201844513799,0.111405835543767
2016,47101,56,125,34,117,16,16,50,133,0.0158389901155174,0.37593984962406
2016,47103,68,449,49,675,8,41,57,716,0.0303995244767121,0.079608938547486
2016,47105,204,1229,334,923,0,79,334,1002,0.0269913530695256,0.333333333333333
2016,47107,50,833,102,673,8,87,110,760,0.0207366984993179,0.144736842105263
2016,47109,22,264,17,314,4,11,21,325,0.0178935197929857,0.0646153846153846
2016,47111,4,440,32,252,0,23,32,275,0.0178757150286011,0.116363636363636
2016,47113,440,1672,251,781,32,58,283,839,0.0130067436632819,0.3373063170441
2016,47115,62,362,87,213,0,0,87,213,0.0105445544554455,0.408450704225352
2016,47117,80,833,71,286,6,6,77,292,0.0136391237330095,0.263698630136986
2016,47119,470,2248,367,1502,34,228,401,1730,0.0294132648724008,0.231791907514451
2016,47121,10,220,0,98,0,0,0,98,0.0115294117647059,0
2016,47123,68,826,25,607,3,15,28,622,0.0194460076283374,0.045016077170418
2016,47125,356,1741,2430,7787,400,1202,2830,8989,0.0776694834707173,0.314829235732562
2016,47127,32,232,7,8,0,0,7,8,0.00172228202368138,0.875
2016,47129,57,1433,0,192,0,14,0,206,0.0132620871692526,0
2016,47131,75,661,75,436,0,0,75,436,0.0201992124160296,0.172018348623853
2016,47133,39,376,47,115,0,0,47,115,0.00747092834405249,0.408695652173913
2016,47135,8,136,3,9,3,8,6,17,0.00306582506762849,0.352941176470588
2016,47137,38,217,2,77,0,0,2,77,0.0199069286452947,0.025974025974026
2016,47139,14,397,19,334,12,13,31,347,0.0288829698684868,0.0893371757925072
2016,47141,249,1011,303,847,207,317,510,1164,0.0244686889071073,0.438144329896907
2016,47143,134,832,72,456,11,41,83,497,0.0225806451612903,0.167002012072435
2016,47145,191,834,99,610,65,165,164,775,0.0199932925728143,0.211612903225806
2016,47147,563,2137,111,683,8,31,119,714,0.0156373193166886,0.166666666666667
2016,47149,1418,5321,1714,5145,379,861,2093,6006,0.0334683733345221,0.348484848484849
2016,47151,25,272,19,154,0,16,19,170,0.0114833828694947,0.111764705882353
2016,47153,67,457,81,163,0,4,81,167,0.0161446249033256,0.48502994011976
2016,47155,262,2147,372,2195,33,184,405,2379,0.0356960657803919,0.170239596469105
2016,47157,1546,5525,5509,14761,985,2119,6494,16880,0.0279981024982667,0.384715639810427
2016,47159,44,500,0,54,0,0,0,54,0.00412056466997329,0
2016,47161,33,258,5,172,4,30,9,202,0.0215581643543223,0.0445544554455446
2016,47163,570,2600,530,3239,107,229,637,3468,0.0306587927437321,0.183679354094579
2016,47165,1227,4018,1226,3277,151,398,1377,3675,0.0314419671121302,0.37469387755102
2016,47167,171,1703,142,891,40,173,182,1064,0.0264137828310412,0.171052631578947
2016,47169,16,301,8,13,0,10,8,23,0.00430792283199101,0.347826086956522
2016,47171,37,409,28,191,0,33,28,224,0.0168878166465621,0.125
2016,47173,17,454,9,85,0,5,9,90,0.00675371454299865,0.1
2016,47175,15,162,38,86,0,3,38,89,0.0216492337630747,0.426966292134831
2016,47177,31,621,8,168,0,95,8,263,0.00961643935792899,0.0304182509505703
2016,47179,596,2238,568,1709,134,241,702,1950,0.0227508721167645,0.36
2016,47181,10,380,5,67,16,16,21,83,0.00670923935009296,0.253012048192771
2016,47183,82,412,45,335,7,25,52,360,0.0167558761926926,0.144444444444444
2016,47185,62,614,0,259,0,8,0,267,0.0143556105166944,0
2016,47187,3409,5752,3278,5076,580,796,3858,5872,0.0441357746309492,0.657016348773842
2016,47189,1029,3238,695,1957,105,345,800,2302,0.0269010084956704,0.347523892267593
2016,48001,123,4047,10,249,0,95,10,344,0.00822160082216008,0.0290697674418605
2016,48003,0,556,12,134,0,32,12,166,0.0162792978326959,0.072289156626506
2016,48005,519,2371,100,747,15,82,115,829,0.014608186928404,0.138721351025332
2016,48007,153,1601,83,215,12,14,95,229,0.0125122937383892,0.414847161572052
2016,48009,35,215,9,30,0,0,9,30,0.00492610837438424,0.3
2016,48011,16,87,0,8,0,0,0,8,0.00588668138337013,0
2016,48013,180,1308,161,560,50,72,211,632,0.0210246174318031,0.333860759493671
2016,48015,272,1051,64,118,1,52,65,170,0.00864480040681414,0.382352941176471
2016,48017,0,246,0,52,0,0,0,52,0.0120454018994672,0
2016,48019,188,1173,31,194,0,11,31,205,0.012813300831302,0.151219512195122
2016,48021,688,3758,120,580,138,333,258,913,0.017600678580379,0.282584884994524
2016,48023,75,157,9,17,0,0,9,17,0.00647619047619048,0.529411764705882
2016,48025,188,2886,41,261,18,61,59,322,0.0144973211471793,0.183229813664596
2016,48027,1836,7022,2730,8893,833,2600,3563,11493,0.0578383465268307,0.310014791612286
2016,48029,8669,27174,9274,22555,3833,8106,13107,30661,0.0261817256490568,0.42748116499788
2016,48031,44,299,14,114,0,40,14,154,0.0189585128647052,0.0909090909090909
2016,48033,19,65,3,3,0,5,3,8,0.0173913043478261,0.375
2016,48035,109,702,2,61,0,0,2,61,0.00477009696590554,0.0327868852459016
2016,48037,247,1607,419,1977,23,82,442,2059,0.03277096928219,0.214667314230209
2016,48039,2870,9676,1357,3222,432,753,1789,3975,0.0181609678539447,0.450062893081761
2016,48041,1880,6089,1553,2483,1183,1489,2736,3972,0.0370837184550318,0.688821752265861
2016,48043,188,575,39,212,0,18,39,230,0.0351628191408042,0.169565217391304
2016,48045,0,14,14,35,0,0,14,35,0.0304347826086957,0.4
2016,48047,8,219,7,60,0,116,7,176,0.0417259364627786,0.0397727272727273
2016,48049,222,1079,57,159,7,39,64,198,0.00772050222256882,0.323232323232323
2016,48051,141,720,6,75,0,0,6,75,0.00620706778118017,0.08
2016,48053,346,1988,29,316,0,72,29,388,0.0124895384021116,0.0747422680412371
2016,48055,163,2134,24,397,35,72,59,469,0.0184282907662083,0.125799573560768
2016,48057,138,464,27,122,52,83,79,205,0.0141711599612885,0.385365853658537
2016,48059,43,366,20,66,0,8,20,74,0.00778291964661338,0.27027027027027
2016,48061,847,3160,389,1598,309,1463,698,3061,0.0126669232329001,0.228030055537406
2016,48063,95,256,28,170,0,10,28,180,0.0220102714600147,0.155555555555556
2016,48065,125,245,0,78,0,0,0,78,0.0194659346144248,0
2016,48067,159,532,34,248,0,13,34,261,0.0122523706694207,0.130268199233716
2016,48069,4,190,0,65,0,23,0,88,0.0187154402381965,0
2016,48071,489,1404,23,361,0,0,23,361,0.0149136577708006,0.0637119113573407
2016,48073,146,1400,58,350,0,81,58,431,0.0129258637236084,0.134570765661253
2016,48075,57,311,28,80,0,0,28,80,0.0167679731712429,0.35
2016,48077,82,576,0,32,0,20,0,52,0.00702133405347016,0
2016,48079,11,42,0,13,0,0,0,13,0.00704607046070461,0
2016,48081,61,115,4,5,0,3,4,8,0.00335852225020991,0.5
2016,48083,37,154,0,55,0,7,0,62,0.0102192187242459,0
2016,48085,11009,23460,9187,14856,3295,5406,12482,20262,0.0352555514182608,0.616030006909486
2016,48087,13,104,0,45,0,0,0,45,0.0220804710500491,0
2016,48089,105,272,56,82,0,0,56,82,0.00573306299377753,0.682926829268293
2016,48091,2392,5645,394,1357,184,339,578,1696,0.0196872787212555,0.340801886792453
2016,48093,46,319,27,53,0,19,27,72,0.00770053475935829,0.375
2016,48095,0,265,0,176,0,116,0,292,0.0939813324750563,0
2016,48097,209,1147,136,403,7,29,143,432,0.0166300958540247,0.331018518518519
2016,48099,299,2963,377,2222,46,651,423,2873,0.0614584893148223,0.147232857640097
2016,48101,4,36,0,6,0,0,0,6,0.00551470588235294,0
2016,48103,22,140,14,57,0,0,14,57,0.0194141689373297,0.245614035087719
2016,48105,0,82,0,4,0,0,0,4,0.00159489633173844,0
2016,48107,5,229,2,8,0,0,2,8,0.00208604954367666,0.25
2016,48109,14,110,0,14,0,1,0,15,0.0099009900990099,0
2016,48111,15,222,29,99,5,13,34,112,0.0272771553823673,0.303571428571429
2016,48113,18418,45208,14316,28924,5845,13341,20161,42265,0.0265802898959051,0.477014077842186
2016,48115,99,524,10,102,0,59,10,161,0.0187187536332985,0.062111801242236
2016,48117,52,393,6,126,0,40,6,166,0.0149173256649892,0.036144578313253
2016,48119,51,206,0,29,0,0,0,29,0.00798678050123933,0
2016,48121,12917,28669,5825,13328,1854,3007,7679,16335,0.0337049440107955,0.470094888276706
2016,48123,30,1125,28,57,5,13,33,70,0.00481795030628398,0.471428571428571
2016,48125,2,97,0,5,0,30,0,35,0.0214855739717618,0
2016,48127,9,237,0,39,0,12,0,51,0.00777083650769465,0
2016,48129,11,80,19,41,0,0,19,41,0.0178260869565217,0.463414634146341
2016,48131,32,523,0,14,0,0,0,14,0.00186442935144493,0
2016,48133,126,570,41,112,4,35,45,147,0.0119250425894378,0.306122448979592
2016,48135,778,3900,323,1681,238,787,561,2468,0.0272568639144744,0.227309562398703
2016,48137,7,24,5,12,0,1,5,13,0.00895316804407714,0.384615384615385
2016,48139,1099,4013,261,742,64,318,325,1060,0.0104157454627637,0.306603773584906
2016,48141,922,3679,3755,11783,1880,6202,5635,17985,0.0360351515540097,0.313316652766194
2016,48143,383,1266,94,343,0,15,94,358,0.0155341490931181,0.262569832402235
2016,48145,86,1008,0,24,0,10,0,34,0.00286460527424383,0
2016,48147,309,2536,30,350,28,71,58,421,0.0177562210037959,0.137767220902613
2016,48149,128,469,3,22,0,18,3,40,0.00224681233499972,0.075
2016,48151,30,100,0,0,0,0,0,0,0,NA
2016,48153,3,86,0,12,9,9,9,21,0.00535304613815957,0.428571428571429
2016,48155,6,28,0,0,0,0,0,0,0,NA
2016,48157,7274,18616,4142,7493,3008,5887,7150,13380,0.0307985526061376,0.534379671150972
2016,48159,19,261,12,28,0,0,12,28,0.00385781206944062,0.428571428571429
2016,48161,90,903,44,147,0,21,44,168,0.0122869889563373,0.261904761904762
2016,48163,25,628,0,38,0,593,0,631,0.0568314869854994,0
2016,48165,156,565,12,313,0,181,12,494,0.0458638937888775,0.0242914979757085
2016,48167,3961,10621,1073,2950,359,696,1432,3646,0.0174394688758574,0.392759188151399
2016,48169,39,491,0,327,11,185,11,512,0.10706817231284,0.021484375
2016,48171,307,862,53,223,0,33,53,256,0.0135722616901707,0.20703125
2016,48173,19,26,0,7,0,0,0,7,0.00852618757612668,0
2016,48175,42,192,0,141,0,10,0,151,0.0288167938931298,0
2016,48177,21,539,12,106,0,23,12,129,0.00991087891825446,0.0930232558139535
2016,48179,176,1198,19,182,0,13,19,195,0.0126895295112904,0.0974358974358974
2016,48181,670,3444,282,1778,110,174,392,1952,0.0233962987822418,0.200819672131148
2016,48183,862,3635,265,1006,72,298,337,1304,0.0165213865801743,0.258435582822086
2016,48185,137,1472,0,79,22,47,22,126,0.00673508659397049,0.174603174603175
2016,48187,1293,4701,662,1927,175,345,837,2272,0.0238257532063046,0.368397887323944
2016,48189,193,1742,6,149,0,65,6,214,0.0101143775404102,0.0280373831775701
2016,48191,12,66,0,39,0,0,0,39,0.0188133140376266,0
2016,48193,51,200,0,9,0,0,0,9,0.00152232746955345,0
2016,48195,18,134,0,81,0,0,0,81,0.0234510712217719,0
2016,48197,1,84,0,9,0,0,0,9,0.0032258064516129,0
2016,48199,83,1331,94,150,9,52,103,202,0.00542107240620471,0.50990099009901
2016,48201,19518,52689,22998,51760,16354,33052,39352,84812,0.0303703730228927,0.46399094467764
2016,48203,163,1285,190,558,8,98,198,656,0.0151096370001843,0.301829268292683
2016,48205,44,486,27,72,2,6,29,78,0.0177071509648127,0.371794871794872
2016,48207,26,677,9,122,6,80,15,202,0.0467700856679787,0.0742574257425743
2016,48209,2868,8201,811,2229,182,630,993,2859,0.0262026743408089,0.347324239244491
2016,48211,28,113,6,105,0,0,6,105,0.0420168067226891,0.0571428571428571
2016,48213,446,2240,27,568,34,132,61,700,0.0126596014034072,0.0871428571428571
2016,48215,1094,6448,1075,4513,769,3386,1844,7899,0.0172738803358992,0.233447271806558
2016,48217,214,1244,60,246,2,59,62,305,0.0128372406246054,0.20327868852459
2016,48219,143,978,0,110,49,65,49,175,0.0122574770610072,0.28
2016,48221,591,1818,124,296,9,211,133,507,0.0130156855697892,0.26232741617357
2016,48223,158,1009,51,222,0,33,51,255,0.0106676706827309,0.2
2016,48225,28,686,21,139,0,21,21,160,0.00961943125112728,0.13125
2016,48227,127,1365,30,740,18,303,48,1043,0.0425714285714286,0.0460210930009588
2016,48229,0,111,0,35,0,213,0,248,0.108486439195101,0
2016,48231,421,3030,242,924,110,222,352,1146,0.0195010720484634,0.307155322862129
2016,48233,122,572,43,265,0,4,43,269,0.0189998587371098,0.159851301115242
2016,48235,6,70,0,37,0,0,0,37,0.0342910101946247,0
2016,48237,51,822,0,79,0,20,0,99,0.0162162162162162,0
2016,48239,38,391,83,213,0,19,83,232,0.0236807185873226,0.357758620689655
2016,48241,20,746,6,169,0,22,6,191,0.00793387056575559,0.031413612565445
2016,48243,26,45,30,30,0,15,30,45,0.025802752293578,0.666666666666667
2016,48245,1056,6825,643,2753,310,610,953,3363,0.0201223014695323,0.28337793636634
2016,48247,6,99,0,1,0,0,0,1,0.00030543677458766,0
2016,48249,67,736,12,164,36,175,48,339,0.0131624927198602,0.141592920353982
2016,48251,1148,4267,317,966,2,141,319,1107,0.0108227012758469,0.288166214995483
2016,48253,105,2695,2,107,0,0,2,107,0.00722046021998785,0.0186915887850467
2016,48255,46,725,0,44,4,161,4,205,0.0198816797594802,0.0195121951219512
2016,48257,878,4771,110,681,46,251,156,932,0.0129933499700261,0.167381974248927
2016,48259,596,2011,247,661,0,0,247,661,0.0246017567366384,0.373676248108926
2016,48261,0,1,1,1,0,0,1,1,0.00286532951289398,1
2016,48263,11,38,0,8,0,0,0,8,0.0160642570281124,0
2016,48265,568,2205,157,425,71,98,228,523,0.0143448805507556,0.435946462715105
2016,48267,48,155,0,50,0,9,0,59,0.0170668209430142,0
2016,48269,0,0,0,0,0,0,0,0,0,NA
2016,48271,9,174,0,37,0,175,0,212,0.0826510721247563,0
2016,48273,374,725,200,428,27,68,227,496,0.0280511254382988,0.457661290322581
2016,48275,22,208,3,39,6,18,9,57,0.0227635782747604,0.157894736842105
2016,48277,140,1030,100,503,27,47,127,550,0.0164061567832001,0.230909090909091
2016,48279,27,301,7,169,17,60,24,229,0.0267992978349912,0.104803493449782
2016,48281,137,574,48,230,0,65,48,295,0.0212123391098008,0.16271186440678
2016,48283,16,393,20,104,0,158,20,262,0.0547658862876254,0.0763358778625954
2016,48285,163,798,7,18,0,11,7,29,0.00212890911760388,0.241379310344828
2016,48287,77,545,11,94,0,22,11,116,0.010279131590607,0.0948275862068965
2016,48289,115,615,0,40,0,23,0,63,0.00533040020306287,0
2016,48291,365,5880,79,425,23,41,102,466,0.00907073617004711,0.218884120171674
2016,48293,101,616,30,77,0,5,30,82,0.00520271556373327,0.365853658536585
2016,48295,19,72,5,53,0,1,5,54,0.0236738272687418,0.0925925925925926
2016,48297,89,459,35,90,14,151,49,241,0.0278870631798195,0.203319502074689
2016,48299,286,832,27,202,0,14,27,216,0.0138897820075879,0.125
2016,48301,0,0,0,4,0,0,0,4,0.0597014925373134,0
2016,48303,1698,6333,1191,3055,346,659,1537,3714,0.0215234474605346,0.413839526117394
2016,48305,28,176,0,28,0,1,0,29,0.0078125,0
2016,48307,32,290,1,34,0,0,1,34,0.00583690987124463,0.0294117647058824
2016,48309,1055,4011,851,2145,135,350,986,2495,0.0170618123132262,0.395190380761523
2016,48311,9,12,0,4,0,0,0,4,0.00843881856540084,0
2016,48313,98,1044,15,38,0,8,15,46,0.00466247719440503,0.326086956521739
2016,48315,116,401,25,131,0,6,25,137,0.0176591905130188,0.182481751824818
2016,48317,46,93,23,23,0,0,23,23,0.00714063955293387,1
2016,48319,25,154,16,16,0,0,16,16,0.00516295579219103,1
2016,48321,39,646,15,97,28,29,43,126,0.00528945048486629,0.341269841269841
2016,48323,25,736,17,259,61,476,78,735,0.0230581001380349,0.106122448979592
2016,48325,510,1896,69,197,0,19,69,216,0.00680700869784445,0.319444444444444
2016,48327,6,131,0,33,0,0,0,33,0.0213730569948187,0
2016,48329,1403,4732,884,3163,217,583,1101,3746,0.0387087440841548,0.293913507741591
2016,48331,166,1144,93,211,0,23,93,234,0.0143154288510951,0.397435897435897
2016,48333,22,145,0,10,20,20,20,30,0.00907166616268521,0.666666666666667
2016,48335,37,905,20,30,0,29,20,59,0.00958414554905783,0.338983050847458
2016,48337,83,723,58,156,0,53,58,209,0.0153914132115767,0.277511961722488
2016,48339,5083,14618,3587,7409,1461,2456,5048,9865,0.0293191072012364,0.511708058793715
2016,48341,109,553,23,283,0,10,23,293,0.0228834739144018,0.0784982935153584
2016,48343,55,413,4,37,7,18,11,55,0.00622453598913536,0.2
2016,48345,7,38,0,8,0,0,0,8,0.0113154172560113,0
2016,48347,311,1193,190,410,21,83,211,493,0.0132334782842111,0.427991886409736
2016,48349,95,1218,71,233,0,7,71,240,0.00763213127265789,0.295833333333333
2016,48351,4,369,0,42,0,4,0,46,0.00495102787643957,0
2016,48353,61,503,6,201,0,0,6,201,0.0205290572975181,0.0298507462686567
2016,48355,2290,8422,1648,4211,249,564,1897,4775,0.0208388794574472,0.397277486910995
2016,48357,33,73,32,177,6,27,38,204,0.033041788143829,0.186274509803922
2016,48359,15,45,0,8,0,0,0,8,0.00671140939597315,0
2016,48361,369,1883,184,798,71,130,255,928,0.0166272486203684,0.274784482758621
2016,48363,186,988,67,187,15,39,82,226,0.0119280097112999,0.36283185840708
2016,48365,51,517,0,48,0,22,0,70,0.00439450059639651,0
2016,48367,782,4449,495,1580,25,271,520,1851,0.0223369978399121,0.280929227444625
2016,48369,53,219,34,103,0,97,34,200,0.0333055786844296,0.17
2016,48371,72,1167,0,120,0,21,0,141,0.013314447592068,0
2016,48373,235,1678,56,265,23,241,79,506,0.0151774198386274,0.156126482213439
2016,48375,680,4638,301,1298,54,517,355,1815,0.0236756629837858,0.195592286501377
2016,48377,74,121,45,150,38,62,83,212,0.0455717970765262,0.391509433962264
2016,48379,16,387,0,26,0,35,0,61,0.00748833783452001,0
2016,48381,1087,4594,429,1414,76,147,505,1561,0.0186279072542632,0.323510570147341
2016,48383,24,133,19,56,0,42,19,98,0.0418088737201365,0.193877551020408
2016,48385,70,206,0,7,0,0,0,7,0.00281917035843737,0
2016,48387,68,372,13,72,0,12,13,84,0.00938232994526974,0.154761904761905
2016,48389,41,530,16,399,0,333,16,732,0.0761310452418097,0.0218579234972678
2016,48391,17,271,0,9,0,1,0,10,0.00201045436268597,0
2016,48393,21,86,0,0,0,0,0,0,0,NA
2016,48395,163,495,0,44,0,17,0,61,0.00549995491840231,0
2016,48397,1161,3110,576,1084,85,190,661,1274,0.022479840488416,0.51883830455259
2016,48399,24,157,12,38,0,10,12,48,0.00680947652149241,0.25
2016,48401,432,4926,3,235,2,73,5,308,0.00854368932038835,0.0162337662337662
2016,48403,23,163,18,95,0,6,18,101,0.0134451544195953,0.178217821782178
2016,48405,16,204,18,36,20,32,38,68,0.0108991825613079,0.558823529411765
2016,48407,211,1373,2,312,0,65,2,377,0.0198734844491302,0.00530503978779841
2016,48409,275,2174,120,659,37,237,157,896,0.0212277002535004,0.175223214285714
2016,48411,18,472,0,72,0,0,0,72,0.0172579098753595,0
2016,48413,0,19,0,3,0,0,0,3,0.00152983171851096,0
2016,48415,153,984,15,55,0,3,15,58,0.00519666696532569,0.258620689655172
2016,48417,5,83,1,5,0,0,1,5,0.00223813786929275,0.2
2016,48419,246,523,7,218,0,0,7,218,0.0132983590556945,0.0321100917431193
2016,48421,1,52,0,3,0,0,0,3,0.00144161460836136,0
2016,48423,1752,5967,1018,2686,210,496,1228,3182,0.0223679678328659,0.385920804525456
2016,48425,17,336,19,40,0,0,19,40,0.00675333445888908,0.475
2016,48427,0,606,12,88,3,479,15,567,0.0163348794330328,0.0264550264550265
2016,48429,56,453,5,93,9,9,14,102,0.0155345720377703,0.137254901960784
2016,48431,12,14,0,0,0,0,0,0,0,NA
2016,48433,0,39,0,2,1,4,1,6,0.00677200902934537,0.166666666666667
2016,48435,15,139,0,0,0,4,0,4,0.00157790927021696,0
2016,48437,10,403,11,54,0,4,11,58,0.0115056536401508,0.189655172413793
2016,48439,12009,35797,10184,24830,3620,8910,13804,33740,0.0273076767431508,0.409128630705394
2016,48441,745,3089,510,1666,98,456,608,2122,0.025901107083135,0.286522148916117
2016,48443,12,20,0,0,0,5,0,5,0.00771604938271605,0
2016,48445,94,864,8,98,12,57,20,155,0.0192259985115356,0.129032258064516
2016,48447,0,34,5,12,0,3,5,15,0.0133096716947649,0.333333333333333
2016,48449,105,582,65,360,8,44,73,404,0.0205399359398038,0.180693069306931
2016,48451,777,2742,1207,2756,142,278,1349,3034,0.0409187155245661,0.444627554383652
2016,48453,12115,26661,14524,22574,4159,6801,18683,29375,0.0382593088968685,0.636017021276596
2016,48455,86,650,25,206,0,12,25,218,0.020775755265415,0.114678899082569
2016,48457,89,777,0,148,0,0,0,148,0.00985812296010125,0
2016,48459,355,1488,39,338,30,30,69,368,0.0135743268166728,0.1875
2016,48461,19,94,0,22,0,5,0,27,0.012546468401487,0
2016,48463,127,578,0,232,0,25,0,257,0.0155006031363088,0
2016,48465,245,789,64,382,67,407,131,789,0.027093849799114,0.166032953105196
2016,48467,313,1710,58,305,0,34,58,339,0.00926482645531566,0.171091445427729
2016,48469,403,1798,247,829,76,188,323,1017,0.0173262688041978,0.317600786627335
2016,48471,372,3751,98,333,125,131,223,464,0.0102814092621316,0.480603448275862
2016,48473,259,1255,25,140,30,50,55,190,0.00749625187406297,0.289473684210526
2016,48475,152,398,0,105,0,0,0,105,0.0146280300919476,0
2016,48477,205,811,10,77,12,53,22,130,0.00563087451812708,0.169230769230769
2016,48479,236,1310,182,871,283,1933,465,2804,0.0193694564947086,0.16583452211127
2016,48481,75,496,20,99,26,82,46,181,0.00673688912048238,0.25414364640884
2016,48483,25,190,9,115,0,0,9,115,0.0302950474183351,0.0782608695652174
2016,48485,530,3863,446,1945,191,388,637,2333,0.0277295742506002,0.273039005572225
2016,48487,38,274,89,160,6,53,95,213,0.0244715073529412,0.446009389671362
2016,48489,6,860,21,208,0,302,21,510,0.0373107030506987,0.0411764705882353
2016,48491,9109,21144,5003,10894,777,2292,5780,13186,0.0413144421954995,0.438343697861368
2016,48493,220,1220,0,142,45,109,45,251,0.0080790524011845,0.179282868525896
2016,48495,51,208,32,104,23,56,55,160,0.0346620450606586,0.34375
2016,48497,649,2460,107,483,0,103,107,586,0.0141823374234614,0.18259385665529
2016,48499,214,1693,78,412,0,105,78,517,0.0165641419966679,0.150870406189555
2016,48501,0,80,0,39,0,34,0,73,0.0149835796387521,0
2016,48503,59,254,26,40,0,33,26,73,0.00585498877125441,0.356164383561644
2016,48505,0,107,19,19,0,0,19,19,0.00238393977415307,1
2016,48507,14,248,5,58,0,38,5,96,0.013868824039295,0.0520833333333333
2016,49001,20,140,11,82,0,5,11,87,0.0232558139534884,0.126436781609195
2016,49003,294,1155,108,675,41,84,149,759,0.025203387016437,0.19631093544137
2016,49005,464,1417,472,1205,223,376,695,1581,0.0266309565920461,0.439595192915876
2016,49007,71,466,16,239,3,6,19,245,0.0186113643269523,0.0775510204081633
2016,49009,0,25,0,0,0,0,0,0,0,NA
2016,49011,2485,7125,1746,4440,450,923,2196,5363,0.0283974477773954,0.4094723102741
2016,49013,59,394,19,113,3,12,22,125,0.0109198916746746,0.176
2016,49015,41,207,18,93,0,0,18,93,0.0145448858304661,0.193548387096774
2016,49017,56,138,29,70,0,0,29,70,0.0212378640776699,0.414285714285714
2016,49019,0,51,109,190,0,0,109,190,0.0283117270153479,0.573684210526316
2016,49021,221,853,227,1079,24,86,251,1165,0.0445387467981802,0.215450643776824
2016,49023,10,149,0,100,0,3,0,103,0.0176672384219554,0
2016,49025,88,147,62,249,14,14,76,263,0.0526210484193677,0.288973384030418
2016,49027,45,179,26,169,0,13,26,182,0.0238407126015195,0.142857142857143
2016,49029,42,143,51,124,0,0,51,124,0.0208403361344538,0.411290322580645
2016,49031,11,22,5,26,0,0,5,26,0.0193740685543964,0.192307692307692
2016,49033,0,47,0,45,0,0,0,45,0.032561505065123,0
2016,49035,4765,11137,9138,18606,2094,4147,11232,22753,0.0336580848634032,0.493649189117918
2016,49037,40,177,66,307,6,11,72,318,0.0360994437507095,0.226415094339623
2016,49039,178,1357,74,173,9,23,83,196,0.0120489334234954,0.423469387755102
2016,49041,105,516,53,161,0,25,53,186,0.0144803425457376,0.28494623655914
2016,49043,388,783,539,822,70,148,609,970,0.0377608221737776,0.627835051546392
2016,49045,303,1668,205,850,39,39,244,889,0.0251798561151079,0.274465691788526
2016,49047,145,764,112,740,27,124,139,864,0.0417875798026698,0.16087962962963
2016,49049,2131,6292,3392,7810,586,1517,3978,9327,0.0340694905100744,0.426503698938565
2016,49051,247,684,466,745,77,141,543,886,0.053479809259371,0.612866817155756
2016,49053,858,3036,1292,4320,197,346,1489,4666,0.0490254793800893,0.319117016716674
2016,49055,0,10,0,19,0,28,0,47,0.0262716601453326,0
2016,49057,960,5808,830,2732,68,699,898,3431,0.0232926001357773,0.261731273681143
2016,50001,142,661,209,532,17,52,226,584,0.0231387931376045,0.386986301369863
2016,50003,104,284,302,813,2,11,304,824,0.0317692871187878,0.368932038834951
2016,50005,132,536,253,635,29,63,282,698,0.0322908956328645,0.404011461318052
2016,50007,504,1558,1877,2637,203,381,2080,3018,0.0288792773482355,0.689198144466534
2016,50009,12,110,23,99,0,1,23,100,0.021468441391155,0.23
2016,50011,249,787,152,363,3,43,155,406,0.0120869306341173,0.381773399014778
2016,50013,68,152,52,78,2,6,54,84,0.0163360560093349,0.642857142857143
2016,50015,150,377,157,399,9,71,166,470,0.0271221651566738,0.353191489361702
2016,50017,198,431,236,444,8,39,244,483,0.0231255386383223,0.505175983436853
2016,50019,66,266,202,457,25,31,227,488,0.0249323047054616,0.465163934426229
2016,50021,90,339,481,1034,34,75,515,1109,0.0256155587379314,0.464382326420198
2016,50023,377,800,689,1078,51,92,740,1170,0.0279023180387294,0.632478632478632
2016,50025,192,408,331,823,46,71,377,894,0.0280514590524004,0.421700223713647
2016,50027,167,806,750,1361,88,100,838,1461,0.0350074279963579,0.573579739904175
2016,51001,30,100,145,467,266,311,411,778,0.0326205450733753,0.52827763496144
2016,51003,1536,3365,1413,1942,405,561,1818,2503,0.0357438665638477,0.726328405912904
2016,51005,23,222,116,225,0,0,116,225,0.01919795221843,0.515555555555556
2016,51007,36,294,0,84,0,10,0,94,0.0105333930972658,0
2016,51009,45,661,70,291,0,79,70,370,0.0164480995776839,0.189189189189189
2016,51011,4,56,14,107,6,28,20,135,0.0124435431837036,0.148148148148148
2016,51013,4667,6421,9828,11762,3007,3585,12835,15347,0.0903758840607021,0.836319801915684
2016,51015,489,2260,305,723,87,87,392,810,0.0150837988826816,0.483950617283951
2016,51017,1,158,25,130,0,0,25,130,0.0376484216623226,0.192307692307692
2016,51019,652,2250,266,598,38,146,304,744,0.0135051733526956,0.408602150537634
2016,51021,25,480,32,100,0,0,32,100,0.0196772924045651,0.32
2016,51023,189,755,62,228,0,2,62,230,0.00956977615045352,0.269565217391304
2016,51025,30,537,4,129,0,3,4,132,0.0110626885685551,0.0303030303030303
2016,51027,16,284,99,239,0,0,99,239,0.0138078456294413,0.414225941422594
2016,51029,71,748,23,110,0,14,23,124,0.0100469940042133,0.185483870967742
2016,51031,334,1310,191,403,0,39,191,442,0.0113214313157962,0.432126696832579
2016,51033,195,1354,271,544,0,4,271,548,0.0270150357406951,0.494525547445255
2016,51035,34,402,60,272,0,4,60,276,0.0125952630858395,0.217391304347826
2016,51036,57,149,7,47,0,2,7,49,0.00899247568361167,0.142857142857143
2016,51037,6,187,23,92,0,0,23,92,0.0108388312912347,0.25
2016,51041,2726,7931,2169,4274,419,869,2588,5143,0.0233641038687285,0.503208244215438
2016,51043,174,489,30,176,0,8,30,184,0.0181084538923334,0.16304347826087
2016,51045,0,175,0,54,0,0,0,54,0.0136605110043005,0
2016,51047,251,1394,324,630,11,40,335,670,0.0205194168810486,0.5
2016,51049,18,125,0,66,0,38,0,104,0.0151980125675873,0
2016,51051,60,291,0,36,0,0,0,36,0.0032599837000815,0
2016,51053,74,773,8,96,0,2,8,98,0.0049567548429518,0.0816326530612245
2016,51057,54,256,18,50,0,9,18,59,0.00746551942300392,0.305084745762712
2016,51059,13409,20861,18075,24926,6930,11447,25005,36373,0.0473123790297405,0.687460478926676
2016,51061,856,2133,200,554,29,70,229,624,0.013417335024835,0.366987179487179
2016,51063,108,292,29,146,0,44,29,190,0.0166476824673618,0.152631578947368
2016,51065,473,1376,63,257,15,27,78,284,0.0153513513513514,0.274647887323944
2016,51067,166,1472,207,494,0,30,207,524,0.0129664456102148,0.395038167938931
2016,51069,594,2084,432,917,142,238,574,1155,0.0205245761808295,0.496969696969697
2016,51071,31,196,38,161,0,18,38,179,0.0148535391253838,0.212290502793296
2016,51073,288,975,175,400,21,59,196,459,0.0173962478681069,0.427015250544662
2016,51075,222,1090,10,113,16,16,26,129,0.00791896869244935,0.201550387596899
2016,51077,17,282,24,83,0,1,24,84,0.00733880831731609,0.285714285714286
2016,51079,151,685,40,134,0,27,40,161,0.0122461398037575,0.248447204968944
2016,51081,55,1139,7,142,0,0,7,142,0.0163972286374134,0.0492957746478873
2016,51083,79,409,31,183,8,35,39,218,0.00864187742805042,0.178899082568807
2016,51085,1293,2652,439,1003,97,239,536,1242,0.0178723036852633,0.431561996779388
2016,51087,3544,9764,2197,3867,915,1551,3112,5418,0.0246057985757884,0.57438169066076
2016,51089,79,1070,17,567,0,6,17,573,0.0151147454497494,0.0296684118673647
2016,51091,18,63,3,11,0,0,3,11,0.00595560368164591,0.272727272727273
2016,51093,219,1181,154,316,70,166,224,482,0.0188104901654699,0.464730290456432
2016,51095,824,2205,1158,2220,300,423,1458,2643,0.0508895563770795,0.551645856980704
2016,51097,18,168,11,73,0,0,11,73,0.0137709866063007,0.150684931506849
2016,51099,132,543,180,580,6,51,186,631,0.0382818661651398,0.294770206022187
2016,51101,106,494,38,122,0,41,38,163,0.0144927536231884,0.233128834355828
2016,51103,111,274,51,139,18,19,69,158,0.0181734529560617,0.436708860759494
2016,51105,25,327,30,508,0,38,30,546,0.0295694557270512,0.0549450549450549
2016,51107,5475,8660,3637,5886,1143,2940,4780,8826,0.0382352686346032,0.541581690460004
2016,51109,194,1150,207,367,0,44,207,411,0.0166383288802526,0.503649635036496
2016,51111,30,315,0,45,0,19,0,64,0.00703142166556801,0
2016,51113,56,579,65,112,0,0,65,112,0.0120378331900258,0.580357142857143
2016,51115,12,286,19,37,0,0,19,37,0.00545803215813542,0.513513513513513
2016,51117,95,514,203,385,20,35,223,420,0.0182664289131475,0.530952380952381
2016,51119,48,349,50,139,0,0,50,139,0.016763145200193,0.359712230215827
2016,51121,736,1689,1159,1809,587,778,1746,2587,0.0480855018587361,0.674913026671821
2016,51125,193,364,67,97,16,26,83,123,0.0113322277501382,0.67479674796748
2016,51127,319,1320,18,153,33,33,51,186,0.0129409309121269,0.274193548387097
2016,51131,115,217,19,69,0,1,19,70,0.00792662212659948,0.271428571428571
2016,51133,215,484,8,54,0,0,8,54,0.00560514843263442,0.148148148148148
2016,51135,262,1012,14,94,0,12,14,106,0.00962761126248865,0.132075471698113
2016,51137,210,1235,189,335,10,32,199,367,0.0149478657543174,0.542234332425068
2016,51139,58,446,66,169,20,20,86,189,0.0110075713453698,0.455026455026455
2016,51141,105,505,41,181,25,25,66,206,0.0151115023474178,0.320388349514563
2016,51143,136,1434,54,445,0,15,54,460,0.0101516121201421,0.117391304347826
2016,51145,455,1401,53,286,0,37,53,323,0.0158317811979218,0.164086687306502
2016,51147,99,570,118,220,21,60,139,280,0.0215916101172116,0.496428571428571
2016,51149,208,1604,344,1353,126,223,470,1576,0.0606690533933865,0.298223350253807
2016,51153,4010,11545,3434,7918,1066,2535,4500,10453,0.0372598852938765,0.430498421505788
2016,51155,193,1010,28,273,30,48,58,321,0.0125833006664053,0.180685358255452
2016,51157,17,93,14,103,0,0,14,103,0.0184290570764001,0.135922330097087
2016,51159,106,483,32,76,0,16,32,92,0.0137745171432849,0.347826086956522
2016,51161,982,3364,457,1376,123,329,580,1705,0.0254538397229189,0.340175953079179
2016,51163,229,698,91,269,13,23,104,292,0.0173633822917286,0.356164383561644
2016,51165,473,1562,228,583,37,77,265,660,0.0123832038725656,0.401515151515151
2016,51167,84,547,49,239,0,52,49,291,0.0143229807550327,0.168384879725086
2016,51169,55,478,37,263,0,9,37,272,0.0164728682170543,0.136029411764706
2016,51171,466,1374,195,824,37,68,232,892,0.0289197250680846,0.260089686098655
2016,51173,67,389,51,261,5,60,56,321,0.0141341200299414,0.174454828660436
2016,51175,39,655,16,120,0,27,16,147,0.0110310670868978,0.108843537414966
2016,51177,1055,3696,718,1832,124,373,842,2205,0.0261048693572638,0.381859410430839
2016,51179,1449,4816,1594,3854,406,650,2000,4504,0.0512382967589275,0.44404973357016
2016,51181,41,113,23,41,0,0,23,41,0.008272800645682,0.560975609756098
2016,51183,132,1320,17,71,9,15,26,86,0.00878088625689197,0.302325581395349
2016,51185,69,559,46,718,0,44,46,762,0.0243108728943338,0.0603674540682415
2016,51187,310,1109,144,479,26,43,170,522,0.0196181599518942,0.325670498084291
2016,51191,346,1191,407,955,45,69,452,1024,0.0257396375336199,0.44140625
2016,51193,202,575,79,310,0,20,79,330,0.0255497057912666,0.239393939393939
2016,51195,23,748,65,569,8,44,73,613,0.0219194736465708,0.119086460032626
2016,51197,112,401,0,123,0,45,0,168,0.00791594025349856,0
2016,51199,880,2133,831,1688,279,473,1110,2161,0.0486197043669989,0.513651087459509
2016,51510,4364,7038,6169,8173,1544,2683,7713,10856,0.0942721178227795,0.71048268238762
2016,51520,85,476,74,605,0,5,74,610,0.0497188034884669,0.121311475409836
2016,51530,38,168,55,86,0,0,55,86,0.0208282877209978,0.63953488372093
2016,51540,1045,2266,1142,1418,261,552,1403,1970,0.0690501226778829,0.712182741116751
2016,51550,2027,8601,1461,3961,303,757,1764,4718,0.0305208205300712,0.373887240356083
2016,51570,84,738,58,218,18,31,76,249,0.0203198955443121,0.305220883534137
2016,51580,33,254,0,111,0,26,0,137,0.034931157572667,0
2016,51590,204,983,190,726,38,77,228,803,0.0275320578756086,0.283935242839352
2016,51595,51,196,0,105,0,0,0,105,0.0283860502838605,0
2016,51600,880,1436,203,284,255,303,458,587,0.0353252693025215,0.780238500851789
2016,51610,330,440,365,435,193,253,558,688,0.0737564322469983,0.811046511627907
2016,51620,123,407,0,28,0,0,0,28,0.00485605272285813,0
2016,51630,719,1480,274,781,60,96,334,877,0.0533422541207956,0.380843785632839
2016,51640,28,186,9,53,2,2,11,55,0.0111313499291641,0.2
2016,51650,862,4966,667,2423,122,356,789,2779,0.0307533973706343,0.283915077365959
2016,51660,812,2339,284,836,161,402,445,1238,0.0491406343031795,0.359450726978998
2016,51670,154,756,161,328,0,4,161,332,0.0224021592442645,0.484939759036145
2016,51678,45,152,12,80,0,0,12,80,0.0315831030398737,0.15
2016,51680,875,2717,515,1021,156,321,671,1342,0.0305,0.5
2016,51683,485,1601,120,372,33,209,153,581,0.0221502096835684,0.263339070567986
2016,51685,209,986,45,129,52,225,97,354,0.0345601874450844,0.274011299435028
2016,51690,69,530,22,196,0,8,22,204,0.0215690420807782,0.107843137254902
2016,51700,1193,5291,1236,3970,197,842,1433,4812,0.0415511747791622,0.297797173732336
2016,51710,2212,7966,2293,6583,509,909,2802,7492,0.049822442709511,0.373998932194341
2016,51720,20,354,33,80,0,0,33,80,0.0285714285714286,0.4125
2016,51730,260,1569,148,442,138,238,286,680,0.0307525325615051,0.420588235294118
2016,51735,122,400,89,161,0,19,89,180,0.0211939244083363,0.494444444444444
2016,51740,700,3784,429,1601,47,99,476,1700,0.0267830416082429,0.28
2016,51750,104,684,39,42,0,0,39,42,0.00561422269750033,0.928571428571429
2016,51760,3775,9637,2406,4069,387,802,2793,4871,0.0332382564074569,0.573393553685075
2016,51770,853,3426,576,1694,81,319,657,2013,0.0290509726952606,0.326378539493294
2016,51775,308,1457,103,288,46,53,149,341,0.0200883652430044,0.436950146627566
2016,51790,321,1326,131,361,22,39,153,400,0.0230813618003462,0.3825
2016,51800,737,2216,487,1357,189,330,676,1687,0.0291268840967558,0.400711321873148
2016,51810,2580,9386,4151,10272,1010,2164,5161,12436,0.0413013443859929,0.415004824702477
2016,51820,293,1002,137,232,15,15,152,247,0.0168462692674942,0.615384615384615
2016,51830,348,749,281,401,74,74,355,475,0.0649084449303088,0.747368421052632
2016,51840,439,1382,321,791,26,85,347,876,0.048432575883231,0.396118721461187
2016,53001,49,301,33,93,0,31,33,124,0.0118399694452401,0.266129032258065
2016,53003,62,265,214,868,0,22,214,890,0.0565546165088645,0.240449438202247
2016,53005,1210,3704,1012,2687,202,541,1214,3228,0.0268046202263612,0.376084262701363
2016,53007,567,1815,175,367,38,230,213,597,0.0119057115507339,0.35678391959799
2016,53009,257,944,541,1607,0,106,541,1713,0.031213556851312,0.315820198482195
2016,53011,862,3689,4333,13240,408,1213,4741,14453,0.0481933737028837,0.328028782951636
2016,53013,33,111,11,45,0,0,11,45,0.0152078404866509,0.244444444444444
2016,53015,245,1385,265,1552,46,101,311,1653,0.0233257133180933,0.188142770719903
2016,53017,182,1102,108,523,9,72,117,595,0.0227576974564926,0.196638655462185
2016,53019,31,277,7,171,0,0,7,171,0.0306451612903226,0.0409356725146199
2016,53021,578,3104,129,640,0,169,129,809,0.0162156744838645,0.159456118665019
2016,53023,16,18,14,78,0,0,14,78,0.047301394784718,0.179487179487179
2016,53025,294,1663,129,652,12,448,141,1100,0.0198495046646336,0.128181818181818
2016,53027,288,2224,170,789,5,83,175,872,0.0171694100968733,0.200688073394495
2016,53029,661,2225,634,2530,88,277,722,2807,0.0487876944468584,0.257214107588172
2016,53031,424,1132,517,1074,56,92,573,1166,0.0473887421255842,0.491423670668954
2016,53033,8669,23566,29789,46570,13054,19481,42843,66051,0.0450929015767599,0.648635145569333
2016,53035,1477,4370,2873,6849,662,1245,3535,8094,0.0459168912211034,0.436743266617247
2016,53037,444,1548,387,851,84,129,471,980,0.0382722799343904,0.480612244897959
2016,53039,111,228,102,274,4,22,106,296,0.0196507999734449,0.358108108108108
2016,53041,446,2347,135,990,3,141,138,1131,0.0213299637899819,0.122015915119363
2016,53043,25,275,24,94,3,20,27,114,0.0152386044646438,0.236842105263158
2016,53045,443,2742,165,897,18,127,183,1024,0.0229144289294665,0.1787109375
2016,53047,191,678,110,392,15,69,125,461,0.0160868199741773,0.27114967462039
2016,53049,73,526,101,300,0,31,101,331,0.0209480412632112,0.305135951661631
2016,53051,21,317,69,308,0,18,69,326,0.0340505535826196,0.211656441717791
2016,53053,3903,16386,6096,15384,1210,3535,7306,18919,0.034267404940056,0.386172630688726
2016,53055,166,339,201,392,16,32,217,424,0.0327488993589248,0.511792452830189
2016,53057,893,3227,574,1993,160,388,734,2381,0.028551557085127,0.30827383452331
2016,53059,15,220,54,248,15,38,69,286,0.035031847133758,0.241258741258741
2016,53061,6458,18130,3958,11048,1077,2705,5035,13753,0.0265527560575345,0.366101941394605
2016,53063,1635,7456,2956,8697,379,1002,3335,9699,0.0297259111011674,0.343849881431075
2016,53065,110,879,108,513,55,145,163,658,0.021239509360878,0.247720364741641
2016,53067,2098,7872,2181,5774,563,1635,2744,7409,0.0402365642785767,0.370360372519908
2016,53069,11,91,0,9,0,0,0,9,0.0029296875,0
2016,53071,297,1786,310,947,122,139,432,1086,0.027814773076529,0.397790055248619
2016,53073,751,2699,1039,2695,374,810,1413,3505,0.0256406504897693,0.403138373751783
2016,53075,369,1013,844,1286,229,269,1073,1555,0.0678446771378709,0.690032154340836
2016,53077,440,1946,684,1985,170,549,854,2534,0.0170519161535615,0.337016574585635
2016,54001,13,219,45,211,5,5,50,216,0.0189390618149934,0.231481481481481
2016,54003,282,1122,542,3495,0,53,542,3548,0.047369826435247,0.152762119503946
2016,54005,32,265,13,149,8,18,21,167,0.0100149925037481,0.125748502994012
2016,54007,37,463,6,113,9,34,15,147,0.0140468227424749,0.102040816326531
2016,54009,126,366,62,360,0,0,62,360,0.0213713268032057,0.172222222222222
2016,54011,369,1582,655,1738,25,128,680,1866,0.0290157051780438,0.364415862808146
2016,54013,82,207,0,11,0,0,0,11,0.00202168718985481,0
2016,54015,0,89,7,15,0,13,7,28,0.00440944881889764,0.25
2016,54017,22,416,62,197,0,0,62,197,0.0331370899915896,0.314720812182741
2016,54019,47,423,72,214,7,15,79,229,0.00705831586734065,0.344978165938865
2016,54021,13,243,54,337,0,36,54,373,0.0619601328903654,0.144772117962467
2016,54023,0,165,0,106,0,41,0,147,0.0172050561797753,0
2016,54025,174,584,145,591,55,55,200,646,0.0247898998426647,0.309597523219814
2016,54027,60,330,21,339,0,0,21,339,0.0200354609929078,0.0619469026548673
2016,54029,108,414,203,746,14,93,217,839,0.0380033519046972,0.258641239570918
2016,54031,0,211,50,258,19,93,69,351,0.0345098810343132,0.196581196581197
2016,54033,170,883,241,689,26,42,267,731,0.0149828854864826,0.365253077975376
2016,54035,53,385,18,237,9,16,27,253,0.012269046118035,0.106719367588933
2016,54037,106,562,469,1879,39,116,508,1995,0.0529318121517644,0.254636591478697
2016,54039,634,2549,778,2050,140,239,918,2289,0.0168149328945339,0.401048492791612
2016,54041,58,422,21,162,8,8,29,170,0.0143666018761092,0.170588235294118
2016,54043,3,324,28,236,0,4,28,240,0.0159193420005306,0.116666666666667
2016,54045,55,395,3,258,13,22,16,280,0.0110636952742216,0.0571428571428571
2016,54047,0,380,12,247,0,38,12,285,0.0189633375474083,0.0421052631578947
2016,54049,177,724,169,821,0,53,169,874,0.0224580517511627,0.193363844393593
2016,54051,32,415,21,125,15,55,36,180,0.0077120822622108,0.2
2016,54053,52,428,42,324,0,0,42,324,0.0166358595194085,0.12962962962963
2016,54055,45,455,163,1013,40,53,203,1066,0.0245814693538717,0.190431519699812
2016,54057,0,129,27,126,1,1,28,127,0.00656873900899969,0.220472440944882
2016,54059,26,182,52,309,0,9,52,318,0.0176784523015344,0.163522012578616
2016,54061,565,1529,1082,1900,331,467,1413,2367,0.0380907935179672,0.596958174904943
2016,54063,50,248,43,332,42,49,85,381,0.0384498940357251,0.223097112860892
2016,54065,33,142,99,703,2,2,101,705,0.0545454545454545,0.143262411347518
2016,54067,27,178,14,208,0,0,14,208,0.0111791895087606,0.0673076923076923
2016,54069,85,337,414,948,32,78,446,1026,0.0338245475225002,0.434697855750487
2016,54071,17,81,15,97,0,0,15,97,0.0177590626144269,0.154639175257732
2016,54073,13,446,10,94,0,0,10,94,0.0170043415340087,0.106382978723404
2016,54075,23,240,34,117,4,4,38,121,0.0185156847742923,0.31404958677686
2016,54077,75,458,66,549,18,55,84,604,0.0244000969540276,0.139072847682119
2016,54079,340,860,48,295,44,79,92,374,0.00938095715862346,0.245989304812834
2016,54081,272,1795,158,1003,8,78,166,1081,0.0194120710399195,0.153561517113784
2016,54083,93,779,49,142,0,12,49,154,0.00728201248344997,0.318181818181818
2016,54085,38,84,12,96,0,0,12,96,0.0132798450684742,0.125
2016,54087,96,431,19,71,8,15,27,86,0.00831801915078828,0.313953488372093
2016,54089,20,322,89,548,0,30,89,578,0.0568785672111789,0.153979238754325
2016,54091,78,504,26,146,8,27,34,173,0.0140982804987369,0.196531791907514
2016,54093,20,124,3,78,0,0,3,78,0.0150346954510409,0.0384615384615385
2016,54095,41,112,14,161,0,40,14,201,0.0307292462926158,0.0696517412935323
2016,54097,71,255,39,231,0,8,39,239,0.0143802647412756,0.163179916317992
2016,54099,108,686,159,494,0,5,159,499,0.0171189406154585,0.318637274549098
2016,54101,46,223,19,80,0,0,19,80,0.0124921923797626,0.2375
2016,54103,21,140,15,153,0,0,15,153,0.0133379827390812,0.0980392156862745
2016,54105,0,21,0,25,0,0,0,25,0.00603281853281853,0
2016,54107,207,600,255,1333,0,55,255,1388,0.0226886360664313,0.18371757925072
2016,54109,3,153,0,77,0,0,0,77,0.00479422202851628,0
2016,55001,117,629,71,420,6,49,77,469,0.029045643153527,0.164179104477612
2016,55003,40,387,107,177,0,22,107,199,0.0184412936706515,0.537688442211055
2016,55005,207,994,60,379,34,41,94,420,0.0129793874965234,0.223809523809524
2016,55007,82,241,68,140,2,9,70,149,0.0130244755244755,0.469798657718121
2016,55009,1011,4014,1099,2365,197,610,1296,2975,0.0175219539776308,0.43563025210084
2016,55011,76,266,18,152,0,6,18,158,0.0166053599579611,0.113924050632911
2016,55013,20,195,107,343,5,7,112,350,0.0301490223102765,0.32
2016,55015,427,1121,58,193,60,80,118,273,0.00821620970897162,0.432234432234432
2016,55017,237,2191,84,295,79,81,163,376,0.00849890373183246,0.433510638297872
2016,55019,92,541,19,91,16,62,35,153,0.00704646985676784,0.228758169934641
2016,55021,344,1620,175,492,19,59,194,551,0.0138289328380685,0.352087114337568
2016,55023,39,492,76,287,2,28,78,315,0.0266474917519668,0.247619047619048
2016,55025,2796,6963,5166,8241,1351,2107,6517,10348,0.0307189018615987,0.629783533049865
2016,55027,393,3261,143,718,28,84,171,802,0.012725714829742,0.213216957605985
2016,55029,227,457,232,546,9,21,241,567,0.0264421955883039,0.425044091710758
2016,55031,92,266,253,1154,15,96,268,1250,0.040703353956366,0.2144
2016,55033,209,989,149,471,9,54,158,525,0.019404915912031,0.300952380952381
2016,55035,453,1721,417,938,45,131,462,1069,0.0167912792158834,0.432179607109448
2016,55037,13,125,8,79,1,21,9,100,0.0284090909090909,0.09
2016,55039,356,1847,202,410,183,242,385,652,0.00925150762681802,0.590490797546012
2016,55041,23,172,29,66,0,7,29,73,0.0112359550561798,0.397260273972603
2016,55043,153,746,128,416,28,88,156,504,0.0158261634114174,0.30952380952381
2016,55045,296,885,161,412,0,3,161,415,0.0160479505027069,0.387951807228916
2016,55047,72,384,19,88,0,12,19,100,0.00748166990872363,0.19
2016,55049,115,465,55,151,18,52,73,203,0.0122296523886981,0.359605911330049
2016,55051,38,182,49,146,0,7,49,153,0.0327272727272727,0.320261437908497
2016,55053,138,902,28,155,0,8,28,163,0.0113273106323836,0.171779141104294
2016,55055,565,2015,152,469,112,213,264,682,0.0119401939843832,0.387096774193548
2016,55057,136,872,41,256,16,23,57,279,0.0145426114151681,0.204301075268817
2016,55059,471,2122,593,2840,64,143,657,2983,0.0269966966831078,0.220248072410325
2016,55061,84,295,28,110,33,72,61,182,0.0125751399157051,0.335164835164835
2016,55063,627,1817,664,1482,75,197,739,1679,0.0226073140518124,0.440142942227516
2016,55065,73,369,16,128,5,22,21,150,0.0132275132275132,0.14
2016,55067,106,423,29,88,24,42,53,130,0.00912793147029911,0.407692307692308
2016,55069,124,759,99,222,0,22,99,244,0.01181598062954,0.405737704918033
2016,55071,241,823,127,424,16,66,143,490,0.00858850542478047,0.291836734693878
2016,55073,525,2010,663,1321,56,264,719,1585,0.0170893172898607,0.453627760252366
2016,55075,96,530,41,578,4,76,45,654,0.0217174736003188,0.0688073394495413
2016,55077,72,415,21,145,0,9,21,154,0.0136998487679032,0.136363636363636
2016,55078,20,129,4,24,0,0,4,24,0.00956937799043062,0.166666666666667
2016,55079,4829,10906,4542,9476,1098,2198,5640,11674,0.0187490464068611,0.483124892924447
2016,55081,173,892,179,653,13,41,192,694,0.0227071949743153,0.276657060518732
2016,55083,117,774,70,199,0,29,70,228,0.00837650170836548,0.307017543859649
2016,55085,117,495,119,295,20,22,139,317,0.0116844821231109,0.438485804416404
2016,55087,1295,4423,641,1330,161,293,802,1623,0.0133391412979157,0.494146642020949
2016,55089,1153,2019,506,887,98,188,604,1075,0.0177363471374361,0.561860465116279
2016,55091,39,177,15,48,5,8,20,56,0.0107238605898123,0.357142857142857
2016,55093,141,595,168,434,8,44,176,478,0.0186930507215205,0.368200836820084
2016,55095,132,720,214,663,11,45,225,708,0.0229103970488302,0.317796610169492
2016,55097,297,1581,194,565,72,179,266,744,0.0166030662114213,0.35752688172043
2016,55099,68,353,47,161,0,18,47,179,0.0168804224820822,0.262569832402235
2016,55101,862,3730,515,1819,103,194,618,2013,0.0152464194015042,0.307004470938897
2016,55103,95,368,27,119,11,22,38,141,0.01145596360091,0.269503546099291
2016,55105,421,1939,744,1938,73,168,817,2106,0.0194366509155346,0.387939221272555
2016,55107,59,300,16,55,0,33,16,88,0.0085628101586066,0.181818181818182
2016,55109,256,968,547,1666,45,81,592,1747,0.0302055777443505,0.33886662850601
2016,55111,273,1370,254,583,24,45,278,628,0.0142918913998316,0.442675159235669
2016,55113,100,352,83,205,4,6,87,211,0.0174394578064303,0.412322274881517
2016,55115,185,1153,100,280,0,26,100,306,0.0104007341694708,0.326797385620915
2016,55117,353,1965,228,684,41,198,269,882,0.0110428065255224,0.304988662131519
2016,55119,94,325,39,107,0,20,39,127,0.00892794376098418,0.307086614173228
2016,55121,100,482,57,193,0,40,57,233,0.0115352245160652,0.244635193133047
2016,55123,101,392,54,157,4,13,58,170,0.00831377151799687,0.341176470588235
2016,55125,157,469,170,335,7,22,177,357,0.0215579710144928,0.495798319327731
2016,55127,599,2033,675,1832,28,109,703,1941,0.0288852180900933,0.362184441009789
2016,55129,103,359,72,236,13,26,85,262,0.0222486413043478,0.324427480916031
2016,55131,1063,2923,257,786,76,157,333,943,0.0101373868547225,0.353128313891835
2016,55133,3694,8950,1896,3260,448,798,2344,4058,0.0146907095199997,0.577624445539675
2016,55135,367,1429,41,325,40,94,81,419,0.0112670754006669,0.193317422434368
2016,55137,90,857,49,181,7,28,56,209,0.0115272185759197,0.267942583732057
2016,55139,1122,5041,609,1380,62,168,671,1548,0.0136744284654252,0.433462532299742
2016,55141,349,1509,165,403,10,72,175,475,0.00912163459691977,0.368421052631579
2016,56001,116,367,496,1060,118,142,614,1202,0.0586398673041272,0.510815307820299
2016,56003,15,274,16,238,0,3,16,241,0.0299602187966186,0.0663900414937759
2016,56005,218,747,105,1567,54,56,159,1623,0.0532270759543487,0.0979667282809612
2016,56007,67,288,101,337,0,25,101,362,0.0340994724943482,0.279005524861878
2016,56009,55,222,38,177,0,0,38,177,0.0185127078757452,0.214689265536723
2016,56011,10,102,23,129,0,0,23,129,0.0252396791234592,0.178294573643411
2016,56013,119,733,211,914,0,37,211,951,0.035192243644303,0.221871713985279
2016,56015,44,246,95,406,0,0,95,406,0.0429039416675473,0.233990147783251
2016,56017,35,123,54,179,2,33,56,212,0.0585311982330204,0.264150943396226
2016,56019,13,167,81,104,0,28,81,132,0.0218109715796431,0.613636363636364
2016,56021,218,783,1029,3233,50,130,1079,3363,0.0522537640423251,0.320844484091585
2016,56023,32,354,180,741,0,29,180,770,0.0628109960029366,0.233766233766234
2016,56025,113,1028,621,1640,44,236,665,1876,0.0346746021477552,0.354477611940299
2016,56027,3,94,1,36,0,0,1,36,0.0204081632653061,0.0277777777777778
2016,56029,62,255,249,583,1,18,250,601,0.0295027244612439,0.415973377703827
2016,56031,56,207,71,302,0,39,71,341,0.0539130434782609,0.208211143695015
2016,56033,95,401,328,669,5,5,333,674,0.0320311757437506,0.49406528189911
2016,56035,65,148,81,492,83,83,164,575,0.0824254587155963,0.285217391304348
2016,56037,122,417,392,1302,21,70,413,1372,0.0482979547294681,0.301020408163265
2016,56039,117,358,430,797,76,91,506,888,0.0524822695035461,0.56981981981982
2016,56041,81,430,119,520,41,42,160,562,0.0431014648362604,0.284697508896797
2016,56043,10,129,29,72,0,14,29,86,0.0147361206305689,0.337209302325581
2016,56045,16,280,12,86,0,0,12,86,0.0166055223016026,0.13953488372093
2016,72001,NA,NA,NA,NA,NA,NA,NA,NA,NA,NA
2016,72003,NA,NA,NA,NA,NA,NA,NA,NA,NA,NA
2016,72005,NA,NA,NA,NA,NA,NA,NA,NA,NA,NA
2016,72007,NA,NA,NA,NA,NA,NA,NA,NA,NA,NA
2016,72009,NA,NA,NA,NA,NA,NA,NA,NA,NA,NA
2016,72011,NA,NA,NA,NA,NA,NA,NA,NA,NA,NA
2016,72013,NA,NA,NA,NA,NA,NA,NA,NA,NA,NA
2016,72015,NA,NA,NA,NA,NA,NA,NA,NA,NA,NA
2016,72017,NA,NA,NA,NA,NA,NA,NA,NA,NA,NA
2016,72019,NA,NA,NA,NA,NA,NA,NA,NA,NA,NA
2016,72021,NA,NA,NA,NA,NA,NA,NA,NA,NA,NA
2016,72023,NA,NA,NA,NA,NA,NA,NA,NA,NA,NA
2016,72025,NA,NA,NA,NA,NA,NA,NA,NA,NA,NA
2016,72027,NA,NA,NA,NA,NA,NA,NA,NA,NA,NA
2016,72029,NA,NA,NA,NA,NA,NA,NA,NA,NA,NA
2016,72031,NA,NA,NA,NA,NA,NA,NA,NA,NA,NA
2016,72033,NA,NA,NA,NA,NA,NA,NA,NA,NA,NA
2016,72035,NA,NA,NA,NA,NA,NA,NA,NA,NA,NA
2016,72037,NA,NA,NA,NA,NA,NA,NA,NA,NA,NA
2016,72039,NA,NA,NA,NA,NA,NA,NA,NA,NA,NA
2016,72041,NA,NA,NA,NA,NA,NA,NA,NA,NA,NA
2016,72043,NA,NA,NA,NA,NA,NA,NA,NA,NA,NA
2016,72045,NA,NA,NA,NA,NA,NA,NA,NA,NA,NA
2016,72047,NA,NA,NA,NA,NA,NA,NA,NA,NA,NA
2016,72049,NA,NA,NA,NA,NA,NA,NA,NA,NA,NA
2016,72051,NA,NA,NA,NA,NA,NA,NA,NA,NA,NA
2016,72053,NA,NA,NA,NA,NA,NA,NA,NA,NA,NA
2016,72054,NA,NA,NA,NA,NA,NA,NA,NA,NA,NA
2016,72055,NA,NA,NA,NA,NA,NA,NA,NA,NA,NA
2016,72057,NA,NA,NA,NA,NA,NA,NA,NA,NA,NA
2016,72059,NA,NA,NA,NA,NA,NA,NA,NA,NA,NA
2016,72061,NA,NA,NA,NA,NA,NA,NA,NA,NA,NA
2016,72063,NA,NA,NA,NA,NA,NA,NA,NA,NA,NA
2016,72065,NA,NA,NA,NA,NA,NA,NA,NA,NA,NA
2016,72067,NA,NA,NA,NA,NA,NA,NA,NA,NA,NA
2016,72069,NA,NA,NA,NA,NA,NA,NA,NA,NA,NA
2016,72071,NA,NA,NA,NA,NA,NA,NA,NA,NA,NA
2016,72073,NA,NA,NA,NA,NA,NA,NA,NA,NA,NA
2016,72075,NA,NA,NA,NA,NA,NA,NA,NA,NA,NA
2016,72077,NA,NA,NA,NA,NA,NA,NA,NA,NA,NA
2016,72079,NA,NA,NA,NA,NA,NA,NA,NA,NA,NA
2016,72081,NA,NA,NA,NA,NA,NA,NA,NA,NA,NA
2016,72083,NA,NA,NA,NA,NA,NA,NA,NA,NA,NA
2016,72085,NA,NA,NA,NA,NA,NA,NA,NA,NA,NA
2016,72087,NA,NA,NA,NA,NA,NA,NA,NA,NA,NA
2016,72089,NA,NA,NA,NA,NA,NA,NA,NA,NA,NA
2016,72091,NA,NA,NA,NA,NA,NA,NA,NA,NA,NA
2016,72093,NA,NA,NA,NA,NA,NA,NA,NA,NA,NA
2016,72095,NA,NA,NA,NA,NA,NA,NA,NA,NA,NA
2016,72097,NA,NA,NA,NA,NA,NA,NA,NA,NA,NA
2016,72099,NA,NA,NA,NA,NA,NA,NA,NA,NA,NA
2016,72101,NA,NA,NA,NA,NA,NA,NA,NA,NA,NA
2016,72103,NA,NA,NA,NA,NA,NA,NA,NA,NA,NA
2016,72105,NA,NA,NA,NA,NA,NA,NA,NA,NA,NA
2016,72107,NA,NA,NA,NA,NA,NA,NA,NA,NA,NA
2016,72109,NA,NA,NA,NA,NA,NA,NA,NA,NA,NA
2016,72111,NA,NA,NA,NA,NA,NA,NA,NA,NA,NA
2016,72113,NA,NA,NA,NA,NA,NA,NA,NA,NA,NA
2016,72115,NA,NA,NA,NA,NA,NA,NA,NA,NA,NA
2016,72117,NA,NA,NA,NA,NA,NA,NA,NA,NA,NA
2016,72119,NA,NA,NA,NA,NA,NA,NA,NA,NA,NA
2016,72121,NA,NA,NA,NA,NA,NA,NA,NA,NA,NA
2016,72123,NA,NA,NA,NA,NA,NA,NA,NA,NA,NA
2016,72125,NA,NA,NA,NA,NA,NA,NA,NA,NA,NA
2016,72127,NA,NA,NA,NA,NA,NA,NA,NA,NA,NA
2016,72129,NA,NA,NA,NA,NA,NA,NA,NA,NA,NA
2016,72131,NA,NA,NA,NA,NA,NA,NA,NA,NA,NA
2016,72133,NA,NA,NA,NA,NA,NA,NA,NA,NA,NA
2016,72135,NA,NA,NA,NA,NA,NA,NA,NA,NA,NA
2016,72137,NA,NA,NA,NA,NA,NA,NA,NA,NA,NA
2016,72139,NA,NA,NA,NA,NA,NA,NA,NA,NA,NA
2016,72141,NA,NA,NA,NA,NA,NA,NA,NA,NA,NA
2016,72143,NA,NA,NA,NA,NA,NA,NA,NA,NA,NA
2016,72145,NA,NA,NA,NA,NA,NA,NA,NA,NA,NA
2016,72147,NA,NA,NA,NA,NA,NA,NA,NA,NA,NA
2016,72149,NA,NA,NA,NA,NA,NA,NA,NA,NA,NA
2016,72151,NA,NA,NA,NA,NA,NA,NA,NA,NA,NA
2016,72153,NA,NA,NA,NA,NA,NA,NA,NA,NA,NA
2017,01001,726,1775,488,885,20,60,508,945,0.025709388687869,0.537566137566138
2017,01003,986,2591,1344,4111,87,255,1431,4366,0.0305267721049908,0.327759963353184
2017,01005,39,594,31,183,0,31,31,214,0.0116089834002387,0.144859813084112
2017,01007,71,1314,15,58,29,80,44,138,0.00870168358660697,0.318840579710145
2017,01009,203,1081,127,396,6,65,133,461,0.0116782773907536,0.288503253796095
2017,01011,0,153,0,89,0,37,0,126,0.0170801138674258,0
2017,01013,43,240,25,91,9,100,34,191,0.0136839088694655,0.178010471204188
2017,01015,371,2357,345,1091,22,126,367,1217,0.0154099398543843,0.301561216105177
2017,01017,98,645,124,334,13,22,137,356,0.0150223647565195,0.384831460674157
2017,01019,62,401,11,321,3,28,14,349,0.018566792573283,0.0401146131805158
2017,01021,131,684,70,389,15,68,85,457,0.015388759807388,0.185995623632385
2017,01023,11,155,56,171,5,17,61,188,0.019896285321198,0.324468085106383
2017,01025,23,131,36,168,0,49,36,217,0.0128243011642338,0.165898617511521
2017,01027,3,162,0,50,9,25,9,75,0.00793231094658911,0.12
2017,01029,66,326,8,334,0,26,8,360,0.0346587080003851,0.0222222222222222
2017,01031,281,1440,308,1250,106,188,414,1438,0.0413979732842008,0.287899860917942
2017,01033,262,1003,101,346,14,156,115,502,0.0130650912214038,0.229083665338645
2017,01035,0,105,0,25,0,7,0,32,0.00364797081623347,0
2017,01037,0,387,5,16,0,30,5,46,0.00566711839349513,0.108695652173913
2017,01039,60,608,20,333,0,9,20,342,0.012946698970321,0.0584795321637427
2017,01041,41,241,0,91,0,7,0,98,0.0102211097204839,0
2017,01043,111,1099,189,499,0,39,189,538,0.0094851904090268,0.351301115241636
2017,01045,87,1001,584,1968,22,243,606,2211,0.0664203316510454,0.274084124830393
2017,01047,26,608,15,321,25,75,40,396,0.0147491526686283,0.101010101010101
2017,01049,226,1248,8,793,28,73,36,866,0.0181574202205728,0.0415704387990762
2017,01051,469,3476,324,820,104,164,428,984,0.0178009334635841,0.434959349593496
2017,01053,17,418,71,397,0,0,71,397,0.0153305529811554,0.178841309823678
2017,01055,419,1965,205,1071,20,190,225,1261,0.0175761377099449,0.178429817605075
2017,01057,100,307,0,98,0,23,0,121,0.0103286384976526,0
2017,01059,32,763,15,283,2,83,17,366,0.0176521655252243,0.046448087431694
2017,01061,17,325,5,210,0,10,5,220,0.011786135219115,0.0227272727272727
2017,01063,20,108,32,42,0,0,32,42,0.0072041166380789,0.761904761904762
2017,01065,46,219,0,105,0,14,0,119,0.0117114457238461,0
2017,01067,54,305,36,191,4,28,40,219,0.0180648354367731,0.182648401826484
2017,01069,275,1277,560,1783,30,109,590,1892,0.0265588590359078,0.31183932346723
2017,01071,61,459,65,424,1,14,66,438,0.0118327209855198,0.150684931506849
2017,01073,3625,10305,3607,7738,428,1087,4035,8825,0.0197406095094934,0.457223796033994
2017,01075,12,252,3,130,0,19,3,149,0.0149929563292413,0.0201342281879195
2017,01077,378,1793,213,1363,67,253,280,1616,0.0255825734549139,0.173267326732673
2017,01079,163,573,37,131,5,20,42,151,0.00646127513906718,0.278145695364238
2017,01081,1049,2776,1752,3472,249,503,2001,3975,0.0429952840392853,0.503396226415094
2017,01083,555,2743,312,1234,46,67,358,1301,0.0206422746168248,0.275172943889316
2017,01085,1,179,8,33,0,7,8,40,0.0056617126680821,0.2
2017,01087,79,275,48,123,40,61,88,184,0.0149837133550489,0.478260869565217
2017,01089,1564,4173,3048,6217,532,1082,3580,7299,0.0304434508416891,0.490478147691465
2017,01091,36,248,5,66,1,68,6,134,0.00988419266799439,0.0447761194029851
2017,01093,100,927,85,295,0,67,85,362,0.0169111464075493,0.234806629834254
2017,01095,312,2082,137,994,11,77,148,1071,0.0169333417657475,0.138188608776844
2017,01097,469,2074,1550,4443,247,722,1797,5165,0.0187220438019704,0.347918683446273
2017,01099,0,252,12,100,4,7,16,107,0.00723266188995539,0.149532710280374
2017,01101,1303,4526,1700,3853,577,945,2277,4798,0.0321327636319801,0.4745727386411
2017,01103,424,2484,251,923,10,91,261,1014,0.0123516943991035,0.257396449704142
2017,01105,4,156,0,0,0,0,0,0,0,NA
2017,01107,13,253,67,387,7,33,74,420,0.029492310933221,0.176190476190476
2017,01109,90,291,86,209,35,74,121,283,0.0143969069542657,0.42756183745583
2017,01111,0,229,45,344,0,0,45,344,0.0220597665768885,0.130813953488372
2017,01113,60,914,519,2815,101,193,620,3008,0.0777060191165074,0.206117021276596
2017,01115,387,2838,74,672,8,23,82,695,0.0115356526357721,0.117985611510791
2017,01117,2131,5534,1708,3185,122,236,1830,3421,0.0242172401832044,0.534931306635487
2017,01119,10,59,46,60,0,0,46,60,0.00727802037845706,0.766666666666667
2017,01121,220,1607,73,641,17,105,90,746,0.0132969716414452,0.120643431635389
2017,01123,80,471,103,349,0,3,103,352,0.012303820476074,0.292613636363636
2017,01125,836,2928,1189,2281,162,450,1351,2731,0.0218226856846059,0.494690589527646
2017,01127,180,1248,35,445,0,57,35,502,0.0111069318760095,0.0697211155378486
2017,01129,28,300,17,74,2,4,19,78,0.00672008270871026,0.243589743589744
2017,01131,31,206,1,20,0,32,1,52,0.00718033692350179,0.0192307692307692
2017,01133,58,449,29,119,0,17,29,136,0.00788177339901478,0.213235294117647
2017,02013,11,86,4,173,18,50,22,223,0.087279843444227,0.0986547085201794
2017,02016,28,91,65,340,16,162,81,502,0.121051362430673,0.161354581673307
2017,02020,807,3258,2910,6852,625,1677,3535,8529,0.0443502677967864,0.414468284675812
2017,02050,37,268,8,79,3,3,11,82,0.00856128628106076,0.134146341463415
2017,02060,5,45,13,28,0,0,13,28,0.0430769230769231,0.464285714285714
2017,02068,74,103,170,281,39,42,209,323,0.20314465408805,0.647058823529412
2017,02070,50,122,24,34,4,4,28,38,0.0132127955493741,0.736842105263158
2017,02090,162,1021,1275,3555,283,854,1558,4409,0.0712819103357962,0.353368110682694
2017,02100,43,87,6,23,0,19,6,42,0.0224959828602035,0.142857142857143
2017,02105,15,69,15,53,12,12,27,65,0.0393700787401575,0.415384615384615
2017,02110,125,406,300,972,41,124,341,1096,0.049046809272353,0.311131386861314
2017,02122,277,1100,395,1271,21,75,416,1346,0.0336836836836837,0.309063893016345
2017,02130,32,115,88,402,52,91,140,493,0.0518183729241118,0.283975659229209
2017,02150,91,300,190,419,101,130,291,549,0.0612176628010705,0.530054644808743
2017,02158,30,131,30,69,0,0,30,69,0.0175885801682386,0.434782608695652
2017,02164,0,33,4,8,2,2,6,10,0.0126742712294043,0.6
2017,02170,359,2312,461,1852,49,259,510,2111,0.0327013043343557,0.24159166271909
2017,02180,42,167,101,190,14,18,115,208,0.03821422009921,0.552884615384615
2017,02185,63,254,24,219,0,17,24,236,0.0363636363636364,0.101694915254237
2017,02188,9,62,65,123,0,0,65,123,0.03003663003663,0.528455284552846
2017,02195,25,42,20,58,4,8,24,66,0.0302891234511244,0.363636363636364
2017,02198,11,88,40,158,0,0,40,158,0.0354657687991021,0.253164556962025
2017,02220,39,341,129,277,4,30,133,307,0.0497730220492866,0.433224755700326
2017,02230,2,51,12,67,5,11,17,78,0.0940892641737033,0.217948717948718
2017,02240,48,260,31,121,16,34,47,155,0.0346523585960206,0.303225806451613
2017,02261,62,213,201,546,6,8,207,554,0.0866708385481852,0.373646209386282
2017,02275,25,43,21,38,0,8,21,46,0.0247711362412493,0.456521739130435
2017,02282,4,13,22,39,0,0,22,39,0.08125,0.564102564102564
2017,02290,19,88,39,91,6,45,45,136,0.0394202898550725,0.330882352941176
2017,04001,95,1105,132,336,83,144,215,480,0.0109674176301238,0.447916666666667
2017,04003,358,3803,1403,3638,326,940,1729,4578,0.052314619067753,0.377675840978593
2017,04005,702,2555,1222,2426,237,325,1459,2751,0.0340377619954963,0.530352599054889
2017,04007,359,1886,211,903,49,122,260,1025,0.0265324083661213,0.253658536585366
2017,04009,167,1597,164,750,56,178,220,928,0.0397430406852248,0.237068965517241
2017,04011,66,264,14,147,0,10,14,157,0.0269112101474117,0.089171974522293
2017,04012,48,191,79,592,0,64,79,656,0.0422245108135942,0.120426829268293
2017,04013,6157,21475,39006,94978,7669,18085,46675,113063,0.0414057209864598,0.412822939423153
2017,04015,237,2294,1806,10994,191,548,1997,11542,0.0749821347365686,0.173020273782707
2017,04017,385,3443,264,1024,18,144,282,1168,0.0171170643062313,0.241438356164384
2017,04019,2092,8540,10297,22608,1970,4795,12267,27403,0.0410846355786977,0.447651716965296
2017,04021,2494,14802,3015,12672,448,2987,3463,15659,0.0566607807094991,0.221150775911616
2017,04023,86,432,101,493,66,474,167,967,0.0334868580531219,0.172699069286453
2017,04025,1372,5509,2039,6849,221,546,2260,7395,0.0439827756432369,0.305611899932387
2017,04027,424,1933,1099,4811,275,2184,1374,6995,0.054827053761081,0.196426018584703
2017,05001,39,299,17,97,0,17,17,114,0.00896085521144474,0.149122807017544
2017,05003,48,141,4,91,0,22,4,113,0.00797684596922208,0.0353982300884956
2017,05005,83,886,225,812,0,102,225,914,0.0289332067109845,0.24617067833698
2017,05007,1067,3207,2585,6067,851,1379,3436,7446,0.0455677610844221,0.461455815202793
2017,05009,81,708,60,731,0,2,60,733,0.0283044368073522,0.0818553888130969
2017,05011,44,136,4,45,0,10,4,55,0.00730411686586985,0.0727272727272727
2017,05013,5,148,0,16,0,0,0,16,0.0043022317827373,0
2017,05015,54,391,186,598,16,52,202,650,0.0332497825975753,0.310769230769231
2017,05017,46,396,8,137,5,5,13,142,0.0184152509402153,0.0915492957746479
2017,05019,57,577,81,139,0,16,81,155,0.0117548915516457,0.52258064516129
2017,05021,12,312,2,158,0,0,2,158,0.0148120371238399,0.0126582278481013
2017,05023,42,451,43,448,0,16,43,464,0.024678225720668,0.0926724137931035
2017,05025,26,106,4,41,0,0,4,41,0.00714908456843941,0.0975609756097561
2017,05027,59,372,24,173,0,11,24,184,0.0123797349121981,0.130434782608696
2017,05029,130,302,70,231,10,15,80,246,0.0169701986754967,0.32520325203252
2017,05031,425,2890,324,1073,105,378,429,1451,0.0217887497372136,0.29565816678153
2017,05033,203,820,113,738,35,35,148,773,0.0185456203066145,0.191461836998706
2017,05035,104,599,116,784,27,74,143,858,0.0275848765432099,0.166666666666667
2017,05037,74,374,0,81,0,0,0,81,0.0070117728531856,0
2017,05039,51,216,0,167,0,0,0,167,0.0313262052147815,0
2017,05041,13,135,3,74,8,14,11,88,0.0110261871945871,0.125
2017,05043,9,300,96,148,0,14,96,162,0.0139091611573796,0.592592592592593
2017,05045,652,2466,399,1287,17,30,416,1317,0.0178590800607507,0.31586940015186
2017,05047,50,454,49,296,0,2,49,298,0.0245732662653583,0.164429530201342
2017,05049,55,370,5,241,0,0,5,241,0.0272995015858632,0.020746887966805
2017,05051,475,1763,504,2074,20,55,524,2129,0.0301455595831445,0.246124941286989
2017,05053,16,388,63,292,0,0,63,292,0.0234349919743178,0.215753424657534
2017,05055,99,744,142,746,48,49,190,795,0.0270187601957586,0.238993710691824
2017,05057,54,375,52,202,0,0,52,202,0.0139879509729243,0.257425742574257
2017,05059,79,1209,22,184,10,10,32,194,0.00816601422738561,0.164948453608247
2017,05061,42,158,16,71,0,48,16,119,0.0133139404788543,0.134453781512605
2017,05063,42,784,63,380,0,23,63,403,0.0160576961389808,0.156327543424318
2017,05065,18,537,74,254,20,25,94,279,0.027487684729064,0.336917562724014
2017,05067,35,1748,4,227,0,9,4,236,0.0189497350248916,0.0169491525423729
2017,05069,85,1867,105,459,20,108,125,567,0.0118773304285894,0.220458553791887
2017,05071,67,431,17,170,2,25,19,195,0.0113815443880231,0.0974358974358974
2017,05073,54,135,13,63,0,8,13,71,0.0139544025157233,0.183098591549296
2017,05075,38,463,44,207,0,8,44,215,0.018882838573687,0.204651162790698
2017,05077,42,271,1,31,0,0,1,31,0.00449731611780067,0.032258064516129
2017,05079,37,530,17,172,0,4,17,176,0.0171406310868718,0.0965909090909091
2017,05081,32,294,12,281,0,0,12,281,0.0313756141134435,0.0427046263345196
2017,05083,64,626,32,196,0,39,32,235,0.0154260207430747,0.136170212765957
2017,05085,231,1811,219,853,71,322,290,1175,0.0250688058714344,0.246808510638298
2017,05087,27,110,0,86,0,18,0,104,0.009529045262965,0
2017,05089,31,449,91,575,0,7,91,582,0.0465525515917453,0.156357388316151
2017,05091,33,904,63,1357,0,0,63,1357,0.0456994679059743,0.0464259395725866
2017,05093,77,764,77,672,15,88,92,760,0.027237214636419,0.121052631578947
2017,05095,16,179,2,71,0,3,2,74,0.0142499518582707,0.027027027027027
2017,05097,19,268,21,201,0,8,21,209,0.0309080153800651,0.100478468899522
2017,05099,6,144,7,119,17,34,24,153,0.026131511528608,0.156862745098039
2017,05101,74,230,6,92,0,0,6,92,0.0158757549611734,0.0652173913043478
2017,05103,84,332,50,255,0,7,50,262,0.015563740049899,0.190839694656489
2017,05105,38,208,9,61,0,1,9,62,0.00860871980005554,0.145161290322581
2017,05107,6,157,0,146,0,0,0,146,0.0116968434545746,0
2017,05109,62,375,7,83,0,23,7,106,0.0139308713365751,0.0660377358490566
2017,05111,33,902,47,206,0,41,47,247,0.0151236835660054,0.190283400809717
2017,05113,13,199,88,398,14,40,102,438,0.0310726447219069,0.232876712328767
2017,05115,145,1391,214,561,31,205,245,766,0.0191672505254729,0.319843342036554
2017,05117,65,265,0,71,0,0,0,71,0.0118156099184556,0
2017,05119,1706,6322,2306,4871,410,1001,2716,5872,0.0221773203663488,0.462534059945504
2017,05121,62,354,91,303,0,0,91,303,0.0249095692206511,0.3003300330033
2017,05123,16,358,22,628,31,65,53,693,0.037491884873404,0.0764790764790765
2017,05125,721,2621,638,1327,46,163,684,1490,0.0186147618809655,0.459060402684564
2017,05127,9,167,27,137,0,0,27,137,0.0191796164076718,0.197080291970803
2017,05129,0,103,0,76,0,21,0,97,0.0166067454203047,0
2017,05131,515,2356,694,2375,97,259,791,2634,0.0312488877816137,0.300303720577069
2017,05133,33,172,0,159,5,29,5,188,0.0176691729323308,0.0265957446808511
2017,05135,60,654,30,311,0,0,30,311,0.0252496549484452,0.0964630225080386
2017,05137,115,319,29,173,0,37,29,210,0.0230086556371206,0.138095238095238
2017,05139,140,503,113,419,28,57,141,476,0.0174589201877934,0.296218487394958
2017,05141,56,476,47,201,8,35,55,236,0.0191542894245597,0.233050847457627
2017,05143,1096,3809,1330,4081,189,588,1519,4669,0.034684099097426,0.325337331334333
2017,05145,329,1706,333,994,0,113,333,1107,0.0218403503926133,0.300813008130081
2017,05147,10,81,6,27,0,19,6,46,0.00952972860990263,0.130434782608696
2017,05149,96,369,19,178,0,26,19,204,0.0140244740822219,0.0931372549019608
2017,06001,23420,38194,10974,15535,8010,13776,18984,29311,0.0257306111843139,0.647674934324997
2017,06003,9,16,0,50,0,3,0,53,0.0653514180024661,0
2017,06005,386,2008,115,231,0,37,115,268,0.00925638103132663,0.42910447761194
2017,06007,1132,4957,644,2016,63,211,707,2227,0.0152619964637673,0.317467444993264
2017,06009,299,1379,17,223,17,26,34,249,0.00727007299270073,0.136546184738956
2017,06011,32,331,6,99,0,0,6,99,0.00732844770153231,0.0606060606060606
2017,06013,14908,29275,4788,8430,3228,6133,8016,14563,0.0189836951137483,0.550436036530935
2017,06015,131,1343,102,265,0,3,102,268,0.0137973640856672,0.380597014925373
2017,06017,2457,6675,516,1694,226,467,742,2161,0.0162794551919484,0.343359555761222
2017,06019,2403,12673,1404,4206,904,2852,2308,7058,0.0119933864748994,0.327004817228677
2017,06021,92,597,25,60,0,2,25,62,0.00345847046354661,0.403225806451613
2017,06023,801,2527,580,1738,58,173,638,1911,0.0209174793944767,0.333856619570905
2017,06025,355,2240,140,719,222,930,362,1649,0.015195075652863,0.219526986052153
2017,06027,233,561,77,278,2,36,79,314,0.0237339380196523,0.251592356687898
2017,06029,2533,19433,1859,5758,685,2295,2544,8053,0.0153015660686395,0.315907115360735
2017,06031,558,6792,505,1489,124,531,629,2020,0.0219830447605263,0.311386138613861
2017,06033,541,3101,80,638,52,71,132,709,0.01528478420213,0.186177715091678
2017,06035,129,3594,89,443,0,76,89,519,0.0231469092855231,0.171483622350674
2017,06037,30836,66280,37843,63981,25191,48399,63034,112380,0.0165219732099395,0.560900516106069
2017,06039,606,4998,80,442,62,298,142,740,0.0077006327006327,0.191891891891892
2017,06041,4381,9428,1866,2578,975,1264,2841,3842,0.0201093925832875,0.739458615304529
2017,06043,111,484,24,214,0,23,24,237,0.0173550087873462,0.10126582278481
2017,06045,390,1721,382,1194,53,140,435,1334,0.0216302109513077,0.326086956521739
2017,06047,757,4545,254,989,119,494,373,1483,0.0094722857398347,0.251517194875253
2017,06049,39,286,37,207,0,0,37,207,0.0302101576182137,0.178743961352657
2017,06051,125,416,9,63,5,42,14,105,0.0108336772595955,0.133333333333333
2017,06053,2403,8637,2615,4545,969,1969,3584,6514,0.0238119608129844,0.550199570156586
2017,06055,1771,3379,709,1242,198,430,907,1672,0.0170744659123402,0.542464114832536
2017,06057,1146,2661,428,941,104,257,532,1198,0.0159707780088519,0.444073455759599
2017,06059,24084,47970,12664,22591,9197,16755,21861,39346,0.0184536042826095,0.555609210593199
2017,06061,4845,12655,1629,3218,515,1044,2144,4262,0.0163418992185643,0.503050211168465
2017,06063,145,446,121,340,19,53,140,393,0.0271408839779006,0.356234096692112
2017,06065,13195,55733,6122,17854,2920,8010,9042,25864,0.0172364845142209,0.34959789669038
2017,06067,11438,34696,5577,12735,2808,6452,8385,19187,0.0192602853858933,0.437014645332777
2017,06069,276,1424,32,217,81,192,113,409,0.0109484166287443,0.276283618581907
2017,06071,10597,53348,3982,13662,2115,6607,6097,20269,0.0154336639513652,0.300804183728847
2017,06073,13212,28060,23965,42559,10803,21971,34768,64530,0.0293712691364993,0.538788160545483
2017,06075,13338,19478,13036,15681,6998,9264,20034,24945,0.0365187373549571,0.803126879134095
2017,06077,3469,16891,1057,4061,427,2427,1484,6488,0.0143903721135526,0.228729963008631
2017,06079,2703,7023,1120,2399,249,592,1369,2991,0.0160976948703735,0.457706452691408
2017,06081,12835,20304,5734,6975,3719,6014,9453,12989,0.0238620998794862,0.72776965124336
2017,06083,2869,7093,2104,4311,932,1879,3036,6190,0.0226891187531614,0.490468497576737
2017,06085,17717,28363,17067,21443,17737,24916,34804,46359,0.035371727796628,0.750749584762398
2017,06087,2753,5941,1088,1689,340,624,1428,2313,0.0130216690030232,0.617380025940337
2017,06089,1056,3740,423,1724,212,354,635,2078,0.0166116409391413,0.3055822906641
2017,06091,26,88,1,8,0,0,1,8,0.00345871162991786,0.125
2017,06093,240,893,118,549,6,36,124,585,0.0184257771898328,0.211965811965812
2017,06095,3736,13818,1537,4133,626,1820,2163,5953,0.0201638033817472,0.363346211993953
2017,06097,4996,11671,2118,4726,558,1231,2676,5957,0.0167659715791873,0.449219405741145
2017,06099,1611,9816,694,2262,233,1701,927,3963,0.0117916247627095,0.233913701741105
2017,06101,422,2369,122,663,76,525,198,1188,0.0192332599404222,0.166666666666667
2017,06103,230,2164,18,262,0,54,18,316,0.00732957576601025,0.0569620253164557
2017,06105,62,336,3,155,0,0,3,155,0.0153495741731036,0.0193548387096774
2017,06107,988,5246,440,2109,119,685,559,2794,0.0104808276627829,0.200071581961346
2017,06109,340,2795,51,436,4,49,55,485,0.0118480517894223,0.11340206185567
2017,06111,5448,13205,3487,6584,1151,2972,4638,9556,0.0169918881337729,0.485349518627041
2017,06113,2330,6204,1055,1649,970,1787,2025,3436,0.0276579303239101,0.589348079161816
2017,06115,244,2232,125,1083,69,313,194,1396,0.0299686574213215,0.138968481375358
2017,08001,5232,16063,2656,6931,368,1479,3024,8410,0.027077497665733,0.359571938168847
2017,08003,176,640,100,167,3,18,103,185,0.019657847200085,0.556756756756757
2017,08005,9534,24550,6663,13085,1562,3062,8225,16147,0.0383037876793081,0.509382547841704
2017,08007,187,347,247,404,9,31,256,435,0.0458425545368321,0.588505747126437
2017,08009,16,71,21,63,0,4,21,67,0.0256901840490798,0.313432835820896
2017,08011,43,357,9,51,0,10,9,61,0.01334208223972,0.147540983606557
2017,08013,3915,7312,6428,9677,1186,1716,7614,11393,0.0553711416865526,0.668305099622575
2017,08014,2189,4632,1325,2313,126,208,1451,2521,0.057223924639655,0.575565251884173
2017,08015,327,458,103,373,31,86,134,459,0.0307909036023345,0.291938997821351
2017,08017,18,77,9,48,0,5,9,53,0.04,0.169811320754717
2017,08019,191,406,158,237,3,3,161,240,0.0337742752603434,0.670833333333333
2017,08021,46,186,11,17,4,9,15,26,0.00492610837438424,0.576923076923077
2017,08023,17,56,0,46,0,0,0,46,0.0173584905660377,0
2017,08025,34,193,1,87,0,0,1,87,0.022159959246052,0.0114942528735632
2017,08027,68,217,5,50,0,0,5,50,0.0141003948110547,0.1
2017,08029,145,718,80,388,0,0,80,388,0.0176500022744848,0.206185567010309
2017,08031,12884,29549,14099,20594,1576,2973,15675,23567,0.0487800334486927,0.665124962871812
2017,08033,27,40,3,56,0,3,3,59,0.0449695121951219,0.0508474576271186
2017,08035,5451,10506,5036,8198,835,1096,5871,9294,0.0444620919285086,0.631697869593286
2017,08037,559,1217,551,927,72,271,623,1198,0.0319304885524668,0.520033388981636
2017,08039,407,1227,140,263,11,19,151,282,0.0162930436792235,0.535460992907801
2017,08041,2816,7956,9432,23817,1616,4276,11048,28093,0.0650036096405168,0.393265226212936
2017,08043,176,973,139,1178,16,70,155,1248,0.0343272087138299,0.124198717948718
2017,08045,653,1302,248,1141,172,241,420,1382,0.0360958027528926,0.303907380607815
2017,08047,114,398,117,213,0,0,117,213,0.0474176313446126,0.549295774647887
2017,08049,227,413,180,348,20,52,200,400,0.0359098662357483,0.5
2017,08051,111,187,168,243,7,28,175,271,0.0261734595325478,0.645756457564576
2017,08053,9,13,25,45,0,0,25,45,0.0677710843373494,0.555555555555556
2017,08055,42,197,94,193,0,4,94,197,0.0383119408790354,0.477157360406091
2017,08057,5,25,0,0,0,9,0,9,0.00906344410876133,0
2017,08059,8617,19387,5828,11306,954,1486,6782,12792,0.0317898964194119,0.530175109443402
2017,08061,2,17,8,11,0,0,8,11,0.0120746432491767,0.727272727272727
2017,08063,37,155,20,78,10,10,30,88,0.0157932519741565,0.340909090909091
2017,08065,136,248,263,360,0,0,263,360,0.0664206642066421,0.730555555555556
2017,08067,382,789,1008,1600,22,77,1030,1677,0.0435629675810474,0.614192009540847
2017,08069,2763,6430,3979,7592,449,798,4428,8390,0.0389750355374281,0.52777115613826
2017,08071,89,414,71,269,15,15,86,284,0.0275140476651812,0.302816901408451
2017,08073,8,169,17,23,0,0,17,23,0.00566921370470791,0.739130434782609
2017,08075,18,675,68,400,0,113,68,513,0.03515625,0.132553606237817
2017,08077,692,2770,952,2981,54,267,1006,3248,0.0320426182607409,0.309729064039409
2017,08079,16,34,5,30,0,5,5,35,0.0482093663911846,0.142857142857143
2017,08081,176,436,15,248,10,32,25,280,0.0316276968259347,0.0892857142857143
2017,08083,52,294,226,814,0,11,226,825,0.0455750745773948,0.273939393939394
2017,08085,393,1103,362,971,0,18,362,989,0.0341529111126459,0.366026289180991
2017,08087,113,894,51,392,11,155,62,547,0.0300830446021009,0.113345521023766
2017,08089,54,454,25,259,2,22,27,281,0.0228771472767239,0.096085409252669
2017,08091,54,86,73,146,0,6,73,152,0.0405549626467449,0.480263157894737
2017,08093,297,897,113,308,0,27,113,335,0.0252658571536315,0.337313432835821
2017,08095,46,199,32,100,0,4,32,104,0.0357388316151203,0.307692307692308
2017,08097,436,734,301,382,109,177,410,559,0.0411665071065616,0.73345259391771
2017,08099,55,216,15,239,2,2,17,241,0.0307751245051718,0.0705394190871369
2017,08101,697,2863,661,2468,54,277,715,2745,0.0248546748519585,0.260473588342441
2017,08103,59,160,22,172,6,7,28,179,0.042018779342723,0.156424581005587
2017,08105,56,338,42,346,3,3,45,349,0.0447206560738083,0.128939828080229
2017,08107,562,962,345,634,8,13,353,647,0.0362647833641612,0.545595054095827
2017,08109,32,78,28,84,0,0,28,84,0.018457481872116,0.333333333333333
2017,08111,4,13,0,0,0,0,0,0,0,NA
2017,08113,26,133,324,466,15,15,339,481,0.0823207256546295,0.704781704781705
2017,08115,13,77,21,115,0,3,21,118,0.071256038647343,0.177966101694915
2017,08117,147,556,524,744,85,116,609,860,0.0384288842218151,0.708139534883721
2017,08119,386,1168,249,661,0,5,249,666,0.037146522393887,0.373873873873874
2017,08121,57,273,26,131,10,13,36,144,0.0426413976902576,0.25
2017,08123,2439,8352,1325,4510,233,652,1558,5162,0.028388842447974,0.301820999612553
2017,08125,132,337,40,118,21,25,61,143,0.0215069935328621,0.426573426573427
2017,09001,2222,4828,10273,16371,2801,5225,13074,21596,0.0336176313548702,0.605389887016114
2017,09003,3203,9926,5361,10111,2537,4465,7898,14576,0.0234016148013287,0.541849615806806
2017,09005,1251,3073,1018,1941,91,310,1109,2251,0.0166235876227753,0.49266992447801
2017,09007,1787,4295,677,1649,175,323,852,1972,0.0166019817984358,0.432048681541582
2017,09009,3545,9746,5344,9624,1806,4021,7150,13645,0.0229027877786897,0.524001465738366
2017,09011,1207,4055,1887,4188,367,711,2254,4899,0.0259717539283669,0.460093896713615
2017,09013,1453,4289,761,1481,195,283,956,1764,0.0184366475402126,0.541950113378685
2017,09015,389,1922,434,1583,19,208,453,1791,0.0221779186685819,0.252931323283082
2017,10001,443,2152,981,3457,127,301,1108,3758,0.0329187105816398,0.294837679616817
2017,10003,601,2418,5397,11972,1462,2756,6859,14728,0.0389671895628891,0.465711569799022
2017,10005,310,1662,2444,6675,65,371,2509,7046,0.0441974394841332,0.356088560885609
2017,11001,0,0,23882,31067,5940,6973,29822,38040,0.0796077372693542,0.783964248159832
2017,12001,1983,4794,2362,3749,1028,1588,3390,5337,0.0341388839137221,0.635188308038224
2017,12003,56,1354,74,255,15,39,89,294,0.016074357572444,0.302721088435374
2017,12005,713,2671,1273,4715,129,698,1402,5413,0.043082384215595,0.25900609643451
2017,12007,109,1742,35,243,0,0,35,243,0.0125574905689628,0.1440329218107
2017,12009,2357,8070,4523,14759,731,1766,5254,16525,0.0394478023814298,0.317942511346445
2017,12011,10154,30418,10009,25599,9005,21670,19014,47269,0.0356163062389003,0.40225094670926
2017,12013,41,697,19,172,0,0,19,172,0.0167298900885128,0.11046511627907
2017,12015,882,5706,2074,7270,165,802,2239,8072,0.0570786103706008,0.277378592666006
2017,12017,483,3265,839,4033,77,219,916,4252,0.0379531031035498,0.215428033866416
2017,12019,1936,7909,1388,4815,137,585,1525,5400,0.0393144720940053,0.282407407407407
2017,12021,2160,5549,5556,12232,957,3110,6513,15342,0.0571792750285114,0.42452092295659
2017,12023,364,3020,175,833,12,145,187,978,0.0207146336814013,0.19120654396728
2017,12027,136,1357,200,661,16,415,216,1076,0.0427102766641527,0.200743494423792
2017,12029,23,843,28,294,0,0,28,294,0.0238849622227638,0.0952380952380952
2017,12031,4745,13960,6514,17950,1667,4166,8181,22116,0.0357986882231445,0.369913185024417
2017,12033,1217,4311,2810,8059,287,873,3097,8932,0.0433583813906526,0.346730855351545
2017,12035,598,2063,955,3312,118,511,1073,3823,0.0482294018948617,0.280669631179702
2017,12037,81,1012,124,255,0,15,124,270,0.030367787650433,0.459259259259259
2017,12039,179,2457,25,192,37,66,62,258,0.00807385385698639,0.24031007751938
2017,12041,73,585,12,137,8,26,20,163,0.0140493018445096,0.122699386503067
2017,12043,13,581,52,233,25,37,77,270,0.0272892662219527,0.285185185185185
2017,12045,90,1256,109,446,0,0,109,446,0.0367774387729859,0.244394618834081
2017,12047,25,1330,11,77,0,1,11,78,0.00788276907529055,0.141025641025641
2017,12049,23,499,7,118,0,26,7,144,0.00832947709393799,0.0486111111111111
2017,12051,91,916,108,713,39,712,147,1425,0.0584088207566504,0.103157894736842
2017,12053,753,5182,685,4127,215,570,900,4697,0.0352085753907275,0.191611667021503
2017,12055,300,2119,562,2642,125,1119,687,3761,0.0493757466752439,0.182664185057166
2017,12057,8142,22062,9423,24415,3939,9191,13362,33606,0.0368249418138306,0.397607570076772
2017,12059,84,1137,83,356,0,2,83,358,0.0257054642062181,0.231843575418994
2017,12061,788,4059,1321,4238,191,626,1512,4864,0.0432029133543545,0.310855263157895
2017,12063,138,2522,130,757,16,20,146,777,0.0219621809548037,0.187902187902188
2017,12065,46,1142,73,200,4,15,77,215,0.0196670325649469,0.358139534883721
2017,12067,22,671,0,37,0,16,0,53,0.00860529306705634,0
2017,12069,3231,11521,2063,7719,317,1103,2380,8822,0.0368538462181153,0.269780095216504
2017,12071,1879,8705,7685,22122,1092,4381,8777,26503,0.0508139862606865,0.331170056220051
2017,12073,1930,6184,2186,4514,701,1018,2887,5532,0.0330300207781042,0.521872740419378
2017,12075,197,1368,40,666,3,28,43,694,0.0240546254895844,0.0619596541786743
2017,12077,28,618,11,60,0,0,11,60,0.0106100795755968,0.183333333333333
2017,12079,100,1219,0,172,0,33,0,205,0.0153512056312715,0
2017,12081,2701,8503,4824,12039,771,1822,5595,13861,0.0515679468434583,0.403650530264772
2017,12083,1757,8856,1671,7895,381,879,2052,8774,0.034380338866162,0.23387280601778
2017,12085,1761,6061,1757,4507,193,591,1950,5098,0.0426835905121528,0.382502942330326
2017,12086,5346,17074,8559,16908,14625,35404,23184,52312,0.0274416552702383,0.443187031656217
2017,12087,712,1943,1092,2677,194,753,1286,3430,0.057425079524527,0.374927113702624
2017,12089,363,2197,748,1943,223,272,971,2215,0.0389183680640967,0.438374717832957
2017,12091,843,3265,2250,6859,279,938,2529,7797,0.0578687210545066,0.324355521354367
2017,12093,26,718,39,428,30,40,69,468,0.0167838186773777,0.147435897435897
2017,12095,9340,26973,9036,21902,5343,12175,14379,34077,0.0399111757616643,0.42195615811251
2017,12097,1719,8077,1493,4663,1633,4836,3126,9499,0.0446870868949555,0.329087272344457
2017,12099,8501,21551,12823,28437,4819,12262,17642,40699,0.0392411897989683,0.433475023956363
2017,12101,3088,12205,2871,9933,451,1600,3322,11533,0.031985999711563,0.288043007023324
2017,12103,4973,14822,9249,23791,1439,4757,10688,28548,0.0394891366143197,0.374386997337817
2017,12105,2224,11558,2494,12718,842,3404,3336,16122,0.0359320673976999,0.206922218087086
2017,12107,187,1502,103,846,0,102,103,948,0.0185080338142559,0.108649789029536
2017,12109,3611,8656,3138,6288,570,928,3708,7216,0.0451833067217683,0.513858093126386
2017,12111,1984,8905,1456,6170,419,1848,1875,8018,0.0373869253007554,0.233848840109753
2017,12113,862,5045,2155,5703,162,415,2317,6118,0.0531039511145059,0.378718535469108
2017,12115,2778,8095,5291,12571,823,2374,6114,14945,0.0465393646107758,0.409100033456005
2017,12117,4857,14941,3284,6905,1162,2563,4446,9468,0.0302350980054032,0.46958174904943
2017,12119,577,3128,2503,6061,112,585,2615,6646,0.06375426883082,0.393469756244357
2017,12121,234,1847,145,366,0,25,145,391,0.0127848804891606,0.370843989769821
2017,12123,74,1716,15,128,8,66,23,194,0.0120086660476633,0.118556701030928
2017,12125,56,2109,17,138,0,3,17,141,0.0124734607218684,0.120567375886525
2017,12127,2532,11171,3120,11629,483,2160,3603,13789,0.0361667304897944,0.261295235332511
2017,12129,274,1770,50,182,0,38,50,220,0.00964743027539028,0.227272727272727
2017,12131,432,2129,783,1766,67,86,850,1852,0.0399861818809914,0.458963282937365
2017,12133,135,1565,65,145,0,2,65,147,0.00841731562070545,0.442176870748299
2017,13001,86,342,5,89,0,0,5,89,0.00719715348536309,0.0561797752808989
2017,13003,9,126,14,47,0,9,14,56,0.0106829454406715,0.25
2017,13005,38,451,11,43,0,0,11,43,0.00576871478400859,0.255813953488372
2017,13007,9,91,0,14,0,0,0,14,0.00606585788561525,0
2017,13009,185,1220,77,225,23,45,100,270,0.00962189515697944,0.37037037037037
2017,13011,31,469,0,113,0,103,0,216,0.0171292624900872,0
2017,13013,307,1947,104,516,4,54,108,570,0.0116774563631894,0.189473684210526
2017,13015,245,2638,90,830,28,101,118,931,0.0136384278452456,0.126745435016112
2017,13017,73,304,0,112,0,28,0,140,0.0122677882930249,0
2017,13019,0,319,0,107,14,24,14,131,0.0101369651009827,0.106870229007634
2017,13021,821,3968,275,975,31,340,306,1315,0.0131951273354874,0.232699619771863
2017,13023,100,446,11,44,0,0,11,44,0.00547604231487243,0.25
2017,13025,13,502,14,401,0,41,14,442,0.0356537872065822,0.0316742081447964
2017,13027,43,360,15,136,0,21,15,157,0.0142287475077035,0.0955414012738854
2017,13029,605,1631,447,1071,78,135,525,1206,0.0548431105047749,0.435323383084577
2017,13031,174,1119,200,748,46,52,246,800,0.0197545497197323,0.3075
2017,13033,29,339,0,125,0,0,0,125,0.00852485848734911,0
2017,13035,167,1697,36,156,0,25,36,181,0.0110003646529719,0.198895027624309
2017,13037,90,763,11,22,13,15,24,37,0.00760690789473684,0.648648648648649
2017,13039,214,924,548,1892,36,140,584,2032,0.0627121782606012,0.28740157480315
2017,13043,61,293,22,152,0,0,22,152,0.0210293303818484,0.144736842105263
2017,13045,691,3371,396,1169,69,339,465,1508,0.0210177145326067,0.308355437665782
2017,13047,137,1129,439,1664,1,1,440,1665,0.0369335196646037,0.264264264264264
2017,13049,0,138,74,512,2,36,76,548,0.061058495821727,0.138686131386861
2017,13051,1462,5466,3765,9194,623,1491,4388,10685,0.056335577617614,0.410669162377164
2017,13053,66,271,642,1208,108,213,750,1421,0.287186742118027,0.527797325826882
2017,13055,8,253,8,154,0,18,8,172,0.0100058173356603,0.0465116279069767
2017,13057,2474,6853,1255,3606,174,323,1429,3929,0.0251401295078191,0.36370577755154
2017,13059,1125,3128,1403,1996,405,552,1808,2548,0.0373738559023703,0.709576138147567
2017,13061,1,37,0,84,0,0,0,84,0.0407174018419777,0
2017,13063,1358,10579,1037,4329,75,710,1112,5039,0.02990291492594,0.220678706092479
2017,13065,61,262,0,91,0,10,0,101,0.0225698324022346,0
2017,13067,9390,19904,7121,13725,2277,3882,9398,17607,0.0358680174298152,0.533764979837565
2017,13069,81,869,224,474,0,96,224,570,0.0204675212754497,0.392982456140351
2017,13071,123,883,114,982,15,97,129,1079,0.036521797996209,0.119555143651529
2017,13073,768,2400,1925,3584,271,1251,2196,4835,0.0511445375306761,0.454188210961737
2017,13075,106,394,12,97,0,53,12,150,0.0133368898372899,0.08
2017,13077,674,3706,751,1919,241,401,992,2320,0.0253868207384063,0.427586206896552
2017,13079,27,386,0,95,0,0,0,95,0.0108188133469992,0
2017,13081,71,701,0,152,19,41,19,193,0.0127409559017692,0.0984455958549223
2017,13083,3,225,22,431,46,57,68,488,0.0437943103293548,0.139344262295082
2017,13085,367,1158,125,281,13,13,138,294,0.0176640230713771,0.469387755102041
2017,13087,76,563,28,293,0,18,28,311,0.0174102894250686,0.090032154340836
2017,13089,11075,24691,7104,13116,2615,4869,9719,17985,0.0361685654241787,0.540394773422296
2017,13091,59,556,4,58,0,1,4,59,0.00396665322038456,0.0677966101694915
2017,13093,17,720,14,33,0,28,14,61,0.00604139843517877,0.229508196721311
2017,13095,446,2460,327,1033,9,61,336,1094,0.0188082384898394,0.307129798903108
2017,13097,1202,4683,317,2060,66,308,383,2368,0.0262900790478728,0.161739864864865
2017,13099,19,105,13,53,0,0,13,53,0.00760947595118449,0.245283018867925
2017,13101,0,60,0,14,0,59,0,73,0.0277461041429114,0
2017,13103,235,1438,148,699,0,13,148,712,0.0193467746318135,0.207865168539326
2017,13105,0,198,21,132,0,12,21,144,0.0106912168683644,0.145833333333333
2017,13107,70,817,27,244,0,61,27,305,0.0205872426594668,0.0885245901639344
2017,13109,83,415,23,107,0,0,23,107,0.0149545772187282,0.214953271028037
2017,13111,180,659,61,530,25,63,86,593,0.0317860205831904,0.145025295109612
2017,13113,1151,2657,1376,2320,267,522,1643,2842,0.0382673327318998,0.578114004222379
2017,13115,399,1854,278,1020,28,55,306,1075,0.0168778358689338,0.284651162790698
2017,13117,3166,6111,2114,3658,555,765,2669,4423,0.0324943430603309,0.603436581505765
2017,13119,167,811,26,167,0,27,26,194,0.012717975612954,0.134020618556701
2017,13121,13729,28591,13954,22234,3778,6279,17732,28513,0.0422417318028551,0.621891768666924
2017,13123,207,874,111,583,18,96,129,679,0.0314949672990398,0.189985272459499
2017,13125,10,47,0,38,0,0,0,38,0.0183841315916788,0
2017,13127,679,2060,399,1462,78,161,477,1623,0.0281834441801101,0.293900184842884
2017,13129,262,1296,91,446,52,128,143,574,0.0152610868871637,0.249128919860627
2017,13131,39,358,63,676,0,1,63,677,0.0400947586615339,0.0930576070901034
2017,13133,85,341,122,259,0,3,122,262,0.0210560154303625,0.465648854961832
2017,13135,6527,16558,6142,14505,1787,4315,7929,18820,0.0334293108623945,0.421307120085016
2017,13137,196,1203,73,398,16,31,89,429,0.0145433588717879,0.207459207459207
2017,13139,1239,4902,657,2289,111,208,768,2497,0.0200248606600104,0.307569082899479
2017,13141,15,709,0,50,0,71,0,121,0.01803547473543,0
2017,13143,55,931,52,410,0,17,52,427,0.0219334292171769,0.121779859484778
2017,13145,176,1179,118,328,19,21,137,349,0.0151311510947323,0.392550143266476
2017,13147,58,521,48,214,0,62,48,276,0.0152713993249599,0.173913043478261
2017,13149,62,502,9,98,0,0,9,98,0.0123831185241344,0.0918367346938776
2017,13151,1880,7229,1036,3246,254,579,1290,3825,0.0275496974935177,0.337254901960784
2017,13153,1009,3102,664,2360,441,632,1105,2992,0.0306591931467686,0.369318181818182
2017,13155,9,181,0,20,0,9,0,29,0.00455974842767296,0
2017,13157,335,1534,120,561,10,125,130,686,0.0159653695773599,0.189504373177843
2017,13159,36,491,42,74,0,54,42,128,0.0135938827527613,0.328125
2017,13161,87,265,42,59,0,6,42,65,0.00668999588307946,0.646153846153846
2017,13163,47,415,14,122,0,2,14,124,0.0115822903045021,0.112903225806452
2017,13165,34,247,0,92,0,5,0,97,0.0166152792052073,0
2017,13167,12,273,0,108,22,22,22,130,0.0186513629842181,0.169230769230769
2017,13169,98,1054,14,103,0,31,14,134,0.00688521220840612,0.104477611940299
2017,13171,60,457,0,93,0,0,0,93,0.00796915167095116,0
2017,13173,91,621,40,140,84,84,124,224,0.032801288622053,0.553571428571429
2017,13175,126,691,132,539,9,65,141,604,0.0191000221357872,0.233443708609272
2017,13177,193,1025,66,289,44,44,110,333,0.0174217850789997,0.33033033033033
2017,13179,259,1409,394,2476,135,841,529,3317,0.093470848479725,0.159481459149834
2017,13181,19,161,17,74,0,0,17,74,0.0130121329347635,0.22972972972973
2017,13183,229,1144,152,619,0,24,152,643,0.059180855959503,0.236391912908243
2017,13185,338,1439,726,2442,152,568,878,3010,0.0452863117985135,0.291694352159468
2017,13187,251,902,140,448,11,125,151,573,0.0289598706155868,0.263525305410122
2017,13189,77,547,90,373,0,17,90,390,0.0276536907041055,0.230769230769231
2017,13191,83,592,0,179,0,0,0,179,0.0169539685546505,0
2017,13193,20,630,23,77,0,0,23,77,0.00797266514806378,0.298701298701299
2017,13195,164,875,40,175,0,24,40,199,0.0101344469342025,0.201005025125628
2017,13197,22,385,9,137,0,18,9,155,0.0254015077023927,0.0580645161290323
2017,13199,53,543,26,35,0,12,26,47,0.00319055053967823,0.553191489361702
2017,13201,12,76,0,37,0,0,0,37,0.00903540903540904,0
2017,13205,38,891,0,146,0,19,0,165,0.0107857236240031,0
2017,13207,252,1185,84,398,6,6,90,404,0.0213485521031494,0.222772277227723
2017,13209,61,464,13,60,0,0,13,60,0.0100569896077774,0.216666666666667
2017,13211,87,418,35,172,0,38,35,210,0.0169532574473238,0.166666666666667
2017,13213,67,595,18,171,0,0,18,171,0.00657262559095976,0.105263157894737
2017,13215,861,3614,2468,6340,571,1241,3039,7581,0.0592812123676514,0.400870597546498
2017,13217,306,3166,332,1491,160,216,492,1707,0.0255141695563793,0.288224956063269
2017,13219,357,1030,230,430,17,60,247,490,0.0208555011704618,0.504081632653061
2017,13221,83,541,44,131,0,4,44,135,0.0129100124318638,0.325925925925926
2017,13223,949,4867,421,1524,0,201,421,1725,0.0177308609489351,0.244057971014493
2017,13225,181,835,0,237,0,24,0,261,0.0151700087183958,0
2017,13227,180,925,128,358,0,17,128,375,0.0169783130348169,0.341333333333333
2017,13229,9,235,56,86,0,0,56,86,0.00663119747089213,0.651162790697674
2017,13231,64,768,11,63,2,7,13,70,0.00576273977113691,0.185714285714286
2017,13233,131,1143,59,320,0,28,59,348,0.0127706422018349,0.169540229885057
2017,13235,34,480,6,74,0,38,6,112,0.0132293881407985,0.0535714285714286
2017,13237,232,709,84,308,47,147,131,455,0.0290493519759944,0.287912087912088
2017,13239,0,7,9,65,0,0,9,65,0.0392038600723764,0.138461538461538
2017,13241,47,201,97,243,28,34,125,277,0.0225166639570802,0.451263537906137
2017,13243,0,209,0,46,0,0,0,46,0.00923323966278603,0
2017,13245,1027,3486,1417,3918,191,659,1608,4577,0.035060707035888,0.351321826523924
2017,13247,650,2919,370,1551,30,142,400,1693,0.0293571936395637,0.236266981689309
2017,13249,29,214,4,9,0,0,4,9,0.00268977884040646,0.444444444444444
2017,13251,22,255,10,36,0,32,10,68,0.00703133078275256,0.147058823529412
2017,13253,39,127,15,39,0,10,15,49,0.00824915824915825,0.306122448979592
2017,13255,369,1894,124,421,0,0,124,421,0.00974694973722594,0.294536817102138
2017,13257,107,615,12,236,61,155,73,391,0.0227378460107002,0.186700767263427
2017,13259,43,485,18,310,37,414,55,724,0.167747914735867,0.0759668508287293
2017,13261,46,629,26,124,0,27,26,151,0.00786089853714405,0.172185430463576
2017,13263,24,108,0,11,0,0,0,11,0.00230366492146597,0
2017,13265,1,23,0,5,0,0,0,5,0.00367376928728876,0
2017,13267,111,2539,51,209,0,61,51,270,0.0151693915388505,0.188888888888889
2017,13269,40,406,2,77,0,32,2,109,0.018986239331127,0.018348623853211
2017,13271,10,125,18,53,0,75,18,128,0.0103912972885209,0.140625
2017,13273,10,285,0,32,0,0,0,32,0.00527269731421981,0
2017,13275,149,953,184,841,5,119,189,960,0.0315260582575285,0.196875
2017,13277,84,492,30,219,16,165,46,384,0.0149474503697937,0.119791666666667
2017,13279,66,484,98,242,0,43,98,285,0.0162996854446669,0.343859649122807
2017,13281,52,131,108,224,0,29,108,253,0.0311078322882085,0.426877470355731
2017,13283,16,335,0,53,0,9,0,62,0.0130142737195634,0
2017,13285,334,1556,151,948,55,221,206,1169,0.0260681473552761,0.176218990590248
2017,13287,38,291,0,33,0,59,0,92,0.0165616561656166,0
2017,13289,18,148,6,6,0,0,6,6,0.000998834692858332,1
2017,13291,79,527,137,468,0,0,137,468,0.0269166618738138,0.292735042735043
2017,13293,83,504,19,206,0,0,19,206,0.0114304738652758,0.0922330097087379
2017,13295,152,1561,416,1381,0,13,416,1394,0.0290295710120783,0.298421807747489
2017,13297,487,2005,181,791,0,129,181,920,0.0157588215142172,0.196739130434783
2017,13299,157,1028,152,489,0,11,152,500,0.0206492112001322,0.304
2017,13301,34,99,0,2,0,0,0,2,0.000504795557799091,0
2017,13303,35,877,8,55,0,10,8,65,0.00462008671547374,0.123076923076923
2017,13305,90,524,150,691,0,81,150,772,0.0383335816078256,0.194300518134715
2017,13307,0,22,0,65,0,0,0,65,0.0360310421286031,0
2017,13309,0,79,10,14,0,0,10,14,0.00258016955399926,0.714285714285714
2017,13311,369,1014,28,150,16,16,44,166,0.00827270008970398,0.265060240963855
2017,13313,145,1551,250,1249,31,145,281,1394,0.0210494526236316,0.201578192252511
2017,13315,15,425,2,21,0,2,2,23,0.00359937402190923,0.0869565217391304
2017,13317,18,196,67,166,0,0,67,166,0.0237856426422124,0.403614457831325
2017,13319,6,134,0,21,0,4,0,25,0.00399808092115784,0
2017,13321,10,406,0,133,0,0,0,133,0.00940793662021645,0
2017,15001,316,926,1838,4050,340,691,2178,4741,0.0343222424926882,0.459396751740139
2017,15003,622,2036,9591,22593,3243,8048,12834,30641,0.0450648005977068,0.418850559707581
2017,15005,0,4,3,3,0,0,3,3,0.0379746835443038,1
2017,15007,234,635,583,1182,174,431,757,1613,0.0320835405271009,0.469311841289523
2017,15009,329,1569,1114,2880,378,1165,1492,4045,0.034900174285172,0.36885043263288
2017,16001,1375,5348,4491,10820,694,1212,5185,12032,0.041579409345691,0.430934175531915
2017,16003,34,181,29,74,0,0,29,74,0.0243341006247945,0.391891891891892
2017,16005,355,1686,536,1565,67,181,603,1746,0.033194547424856,0.345360824742268
2017,16007,40,103,39,112,0,5,39,117,0.029969262295082,0.333333333333333
2017,16009,14,132,33,171,0,12,33,183,0.0284957957022734,0.180327868852459
2017,16011,81,702,198,622,7,85,205,707,0.0260385975250442,0.28995756718529
2017,16013,40,218,128,311,1,5,129,316,0.0208484528600647,0.408227848101266
2017,16015,38,366,57,145,5,5,62,150,0.0280373831775701,0.413333333333333
2017,16017,155,709,322,1463,0,11,322,1474,0.0478074727555786,0.218453188602442
2017,16019,392,1698,900,1957,147,319,1047,2276,0.0342312262178706,0.460017574692443
2017,16021,59,234,76,391,0,34,76,425,0.0540094039903418,0.178823529411765
2017,16023,9,30,16,68,0,1,16,69,0.0363732208750659,0.231884057971014
2017,16025,0,0,10,28,0,5,10,33,0.0540098199672668,0.303030303030303
2017,16027,908,5100,1181,4387,41,367,1222,4754,0.0377493329945369,0.25704669751788
2017,16029,20,82,15,90,0,25,15,115,0.0260593700430546,0.130434782608696
2017,16031,129,627,64,270,1,30,65,300,0.0218372397728927,0.216666666666667
2017,16033,0,23,8,41,0,0,8,41,0.0698466780238501,0.195121951219512
2017,16035,78,461,51,199,0,0,51,199,0.0298843670220754,0.256281407035176
2017,16037,24,107,8,24,4,4,12,28,0.00865533230293663,0.428571428571429
2017,16039,96,463,105,648,44,405,149,1053,0.0656524720992581,0.141500474833808
2017,16041,8,102,114,451,4,33,118,484,0.0635253970337315,0.243801652892562
2017,16043,76,313,48,177,0,54,48,231,0.028136419001218,0.207792207792208
2017,16045,96,357,70,355,0,14,70,369,0.0315492476060192,0.18970189701897
2017,16047,91,360,7,213,9,24,16,237,0.0245876128229069,0.0675105485232067
2017,16049,161,619,65,349,0,6,65,355,0.0297295033916757,0.183098591549296
2017,16051,201,685,226,464,6,29,232,493,0.0314293000127502,0.470588235294118
2017,16053,92,614,56,248,0,188,56,436,0.0315097203150972,0.128440366972477
2017,16055,173,1142,1517,4377,85,159,1602,4536,0.0441537203597711,0.353174603174603
2017,16057,152,593,468,991,162,190,630,1181,0.0550223630264629,0.533446232006774
2017,16059,36,102,103,274,0,0,103,274,0.0460504201680672,0.375912408759124
2017,16061,10,102,14,48,0,0,14,48,0.0178306092124814,0.291666666666667
2017,16063,13,148,3,30,0,37,3,67,0.0206981773246833,0.0447761194029851
2017,16065,123,408,461,919,28,99,489,1018,0.0629638792676893,0.480353634577603
2017,16067,37,498,48,237,0,140,48,377,0.0296500196618168,0.127320954907162
2017,16069,80,482,141,836,3,9,144,845,0.0304592314901593,0.170414201183432
2017,16071,0,9,24,161,0,0,24,161,0.0609156261823685,0.149068322981366
2017,16073,25,400,35,279,0,15,35,294,0.0400872647941096,0.119047619047619
2017,16075,50,439,38,690,25,32,63,722,0.0485312899106003,0.0872576177285319
2017,16077,12,289,5,96,5,11,10,107,0.0229466009007077,0.0934579439252336
2017,16079,40,206,32,165,2,6,34,171,0.0187726424415413,0.198830409356725
2017,16081,4,41,244,486,117,135,361,621,0.0880351573575276,0.581320450885668
2017,16083,339,1769,464,1451,0,122,464,1573,0.0301462274094942,0.294977749523204
2017,16085,31,677,155,540,0,0,155,540,0.0696954052658751,0.287037037037037
2017,16087,13,197,11,195,2,9,13,204,0.0288379983036472,0.0637254901960784
2017,17001,93,427,131,499,14,53,145,552,0.0119581464872945,0.26268115942029
2017,17003,4,131,17,40,0,0,17,40,0.00864864864864865,0.425
2017,17005,135,562,95,244,0,0,95,244,0.020497311827957,0.389344262295082
2017,17007,335,1678,152,477,0,92,152,569,0.0163585659661329,0.26713532513181
2017,17009,46,769,0,32,0,7,0,39,0.0077273627897761,0
2017,17011,130,566,28,234,6,12,34,246,0.0104157845710898,0.138211382113821
2017,17013,0,54,3,44,0,0,3,44,0.0124858115777526,0.0681818181818182
2017,17015,16,190,27,165,4,16,31,181,0.0168434766424716,0.171270718232044
2017,17017,35,212,3,62,0,74,3,136,0.0155802497422385,0.0220588235294118
2017,17019,1081,2418,2132,3342,985,1536,3117,4878,0.0406635545181727,0.638991389913899
2017,17021,114,1048,82,238,13,71,95,309,0.0129072681704261,0.307443365695793
2017,17023,53,217,43,217,7,7,50,224,0.020276998280076,0.223214285714286
2017,17025,36,220,0,49,0,2,0,51,0.0053996823716252,0
2017,17027,97,1043,168,318,18,50,186,368,0.0138205580801442,0.505434782608696
2017,17029,269,1165,217,722,47,107,264,829,0.0251899118808873,0.318455971049457
2017,17031,15683,31035,34113,51222,14827,24755,48940,75977,0.0212298485909452,0.644142306224252
2017,17033,12,795,30,172,0,4,30,176,0.0126182965299685,0.170454545454545
2017,17035,34,322,33,108,8,17,41,125,0.0163826998689384,0.328
2017,17037,828,2731,435,969,254,254,689,1223,0.0199432522340356,0.563368765331153
2017,17039,36,324,15,23,0,0,15,23,0.00200645555264765,0.652173913043478
2017,17041,27,246,76,111,0,25,76,136,0.0103038108947648,0.558823529411765
2017,17043,11721,22299,5409,8214,2719,4476,8128,12690,0.0200501807518265,0.640504334121355
2017,17045,64,367,65,316,0,0,65,316,0.025001978004589,0.205696202531646
2017,17047,21,165,15,37,0,0,15,37,0.00809982486865149,0.405405405405405
2017,17049,188,669,126,305,14,85,140,390,0.0168875032475968,0.358974358974359
2017,17051,85,1057,36,198,0,17,36,215,0.0139149569607145,0.167441860465116
2017,17053,58,438,68,104,0,15,68,119,0.0126690088363675,0.571428571428571
2017,17055,121,816,90,407,12,58,102,465,0.0168313606254751,0.219354838709677
2017,17057,66,1169,75,316,0,36,75,352,0.0136794652572672,0.213068181818182
2017,17059,1,35,0,41,0,11,0,52,0.0138629698747001,0
2017,17061,32,351,0,64,0,3,0,67,0.00714438046491789,0
2017,17063,238,1182,85,251,9,11,94,262,0.00788420450783907,0.358778625954198
2017,17065,18,117,0,26,0,0,0,26,0.00446888965280165,0
2017,17067,36,120,68,204,6,6,74,210,0.015993907083016,0.352380952380952
2017,17069,11,76,0,5,0,0,0,5,0.00159795461808885,0
2017,17071,59,138,37,110,0,2,37,112,0.0219006648416113,0.330357142857143
2017,17073,133,644,143,288,20,68,163,356,0.0102988399340411,0.457865168539326
2017,17075,58,569,11,286,2,2,13,288,0.014334776765716,0.0451388888888889
2017,17077,277,1324,355,918,207,303,562,1221,0.034603939350999,0.46027846027846
2017,17079,14,104,4,25,0,1,4,26,0.00388059701492537,0.153846153846154
2017,17081,52,1092,33,267,6,23,39,290,0.0108370702541106,0.13448275862069
2017,17083,109,455,123,198,0,12,123,210,0.0137551581843191,0.585714285714286
2017,17085,73,396,38,311,3,13,41,324,0.0198626777832271,0.126543209876543
2017,17087,28,1067,35,67,10,12,45,79,0.00840068056146321,0.569620253164557
2017,17089,4297,12412,1239,3999,423,1330,1662,5329,0.0156461945894525,0.311878401200976
2017,17091,264,1662,198,804,38,202,236,1006,0.0138052174390361,0.234592445328032
2017,17093,1191,3668,71,888,208,269,279,1157,0.0150201220303778,0.24114088159032
2017,17095,135,1160,70,231,8,24,78,255,0.00713167020919566,0.305882352941176
2017,17097,5138,10156,4315,9309,1602,2738,5917,12047,0.0264319596993247,0.491159624802855
2017,17099,349,2557,301,793,0,57,301,850,0.0109555847704483,0.354117647058824
2017,17101,9,788,0,187,0,10,0,197,0.0165671516272811,0
2017,17103,201,1597,96,209,1,72,97,281,0.0112422484496899,0.345195729537367
2017,17105,102,1151,47,174,6,13,53,187,0.00728732317524648,0.283422459893048
2017,17107,127,1802,92,169,0,27,92,196,0.00940318556898868,0.469387755102041
2017,17109,93,449,173,235,1,52,174,287,0.0156343629133301,0.606271777003484
2017,17111,2610,5972,769,2257,33,358,802,2615,0.0127079314014686,0.306692160611855
2017,17113,1365,2780,726,1380,393,570,1119,1950,0.018662787359072,0.573846153846154
2017,17115,306,1651,423,937,51,134,474,1071,0.0145362251961237,0.442577030812325
2017,17117,90,948,57,330,0,17,57,347,0.0107026093393375,0.164265129682997
2017,17119,1050,4209,921,3148,98,175,1019,3323,0.0180081071707275,0.306650616912429
2017,17121,85,510,89,319,3,56,92,375,0.0141338760741746,0.245333333333333
2017,17123,65,272,7,38,2,16,9,54,0.00629150646627053,0.166666666666667
2017,17125,18,337,12,63,0,3,12,66,0.00658551187387747,0.181818181818182
2017,17127,25,107,15,242,0,13,15,255,0.0246424429841515,0.0588235294117647
2017,17129,44,328,11,81,0,2,11,83,0.00949656750572082,0.132530120481928
2017,17131,44,238,75,149,0,6,75,155,0.0137826782856127,0.483870967741935
2017,17133,67,478,214,421,28,51,242,472,0.0199906823090932,0.51271186440678
2017,17135,42,1858,19,186,16,29,35,215,0.0102605707740765,0.162790697674419
2017,17137,112,1046,34,331,8,18,42,349,0.0146527836090352,0.120343839541547
2017,17139,91,401,33,49,4,38,37,87,0.00876044708488571,0.425287356321839
2017,17141,183,1066,149,403,13,140,162,543,0.0151964625545729,0.298342541436464
2017,17143,1211,3387,782,1904,171,368,953,2272,0.0182754182754183,0.419454225352113
2017,17145,28,964,50,78,10,13,60,91,0.00596956179480451,0.659340659340659
2017,17147,150,586,89,127,0,1,89,128,0.0110928156686021,0.6953125
2017,17149,50,341,29,107,0,0,29,107,0.00962663067926226,0.271028037383178
2017,17151,10,89,37,84,0,0,37,84,0.0246841022627094,0.44047619047619
2017,17153,15,83,0,41,0,10,0,51,0.0125523012552301,0
2017,17155,10,101,0,52,4,6,4,58,0.0136953955135773,0.0689655172413793
2017,17157,49,1269,53,203,0,30,53,233,0.00975181015360147,0.227467811158798
2017,17159,82,284,28,117,13,69,41,186,0.016674137158225,0.220430107526882
2017,17161,296,1836,720,2197,116,266,836,2463,0.0245448294418368,0.339423467316281
2017,17163,1054,3216,1437,4011,490,915,1927,4926,0.0276992110841829,0.391189606171336
2017,17165,87,403,10,237,12,18,22,255,0.01487747957993,0.0862745098039216
2017,17167,1074,2920,876,1799,168,308,1044,2107,0.0154469875808273,0.495491219743711
2017,17169,28,226,0,11,5,13,5,24,0.00443704936217415,0.208333333333333
2017,17171,17,164,0,18,0,0,0,18,0.00499306518723994,0
2017,17173,74,337,24,134,0,12,24,146,0.00937339496661531,0.164383561643836
2017,17175,17,64,41,52,0,0,41,52,0.0132686909926002,0.788461538461538
2017,17177,145,699,118,339,0,26,118,365,0.0113234472916796,0.323287671232877
2017,17179,832,3086,374,901,38,111,412,1012,0.0107997353424541,0.407114624505929
2017,17181,19,210,29,105,0,0,29,105,0.0084958329961971,0.276190476190476
2017,17183,160,1150,91,673,0,95,91,768,0.0142684626103112,0.118489583333333
2017,17185,4,81,15,131,0,0,15,131,0.0162975864642946,0.114503816793893
2017,17187,87,320,75,156,0,0,75,156,0.0136794107330761,0.480769230769231
2017,17189,25,241,14,90,0,2,14,92,0.00905155450609996,0.152173913043478
2017,17191,53,285,8,176,0,45,8,221,0.0190009457484309,0.0361990950226244
2017,17193,17,239,11,105,0,1,11,106,0.01050753370341,0.10377358490566
2017,17195,130,767,112,477,56,127,168,604,0.0152452106312628,0.278145695364238
2017,17197,5387,15692,1428,3978,626,1148,2054,5126,0.0115200589711954,0.400702301989856
2017,17199,265,1305,179,788,0,47,179,835,0.0175656344665096,0.21437125748503
2017,17201,1249,4382,749,2744,354,720,1103,3464,0.0177792377100506,0.318418013856813
2017,17203,326,993,43,206,2,20,45,226,0.00871174157736489,0.199115044247788
2017,18001,40,413,22,300,7,39,29,339,0.0161029830894927,0.0855457227138643
2017,18003,1282,3794,1684,4730,132,427,1816,5157,0.0217128614073572,0.352142718634865
2017,18005,403,1495,457,826,523,772,980,1598,0.0291302841934484,0.613266583229036
2017,18007,28,399,25,111,0,4,25,115,0.019688409518918,0.217391304347826
2017,18009,16,245,25,83,0,14,25,97,0.0112659698025552,0.257731958762887
2017,18011,1018,1943,570,1104,25,66,595,1170,0.0282465416093286,0.508547008547009
2017,18013,129,581,12,195,0,0,12,195,0.0173271725608672,0.0615384615384615
2017,18015,89,620,10,85,0,8,10,93,0.00668631821123014,0.10752688172043
2017,18017,132,722,24,131,6,87,30,218,0.00840562945826104,0.137614678899083
2017,18019,492,2254,436,1982,14,123,450,2105,0.0266169311500285,0.213776722090261
2017,18021,106,361,29,142,0,2,29,144,0.00790340285400659,0.201388888888889
2017,18023,101,574,76,260,0,33,76,293,0.0137707383559712,0.25938566552901
2017,18025,8,138,20,110,0,12,20,122,0.0163254382443463,0.163934426229508
2017,18027,86,539,68,197,9,16,77,213,0.0105252754854969,0.36150234741784
2017,18029,101,479,384,1229,7,7,391,1236,0.0363540104120709,0.316343042071197
2017,18031,104,411,123,337,8,8,131,345,0.0194289575941882,0.379710144927536
2017,18033,130,808,59,297,41,86,100,383,0.0134712110020752,0.261096605744125
2017,18035,545,1880,253,827,27,116,280,943,0.0132453121707985,0.296924708377519
2017,18037,127,417,11,291,1,3,12,294,0.0103310141260805,0.0408163265306122
2017,18039,463,2761,437,1674,69,232,506,1906,0.0148729633560147,0.265477439664218
2017,18041,48,414,20,118,0,17,20,135,0.00825284264580022,0.148148148148148
2017,18043,324,1568,411,1020,8,81,419,1101,0.0211563959186026,0.380563124432334
2017,18045,112,410,15,108,0,37,15,145,0.0125595495885665,0.103448275862069
2017,18047,45,328,90,234,5,31,95,265,0.0170868527951512,0.358490566037736
2017,18049,33,474,50,151,0,10,50,161,0.0114876917588298,0.31055900621118
2017,18051,130,497,47,266,2,26,49,292,0.0127918692776098,0.167808219178082
2017,18053,114,883,79,582,20,93,99,675,0.0151528756790733,0.146666666666667
2017,18055,26,703,28,265,0,4,28,269,0.0118418735692904,0.104089219330855
2017,18057,4573,8106,4135,5638,326,931,4461,6569,0.0328773842234601,0.679098797381641
2017,18059,569,1857,176,377,15,60,191,437,0.00882685626565404,0.437070938215103
2017,18061,195,564,46,494,0,55,46,549,0.0198632367307066,0.0837887067395264
2017,18063,1168,5888,1050,2130,36,172,1086,2302,0.0220514981990957,0.471763683753258
2017,18065,203,1649,43,235,0,44,43,279,0.00809751850239443,0.154121863799283
2017,18067,344,1732,208,890,61,217,269,1107,0.0194278694278694,0.242999096657633
2017,18069,114,770,38,341,0,37,38,378,0.0151886527102503,0.100529100529101
2017,18071,120,689,53,274,59,151,112,425,0.0143683018357619,0.263529411764706
2017,18073,147,719,28,305,0,12,28,317,0.0142420702668703,0.0883280757097792
2017,18075,36,296,9,73,0,0,9,73,0.00526277845865475,0.123287671232877
2017,18077,98,999,66,454,31,65,97,519,0.0234873512241481,0.186897880539499
2017,18079,72,531,24,202,0,25,24,227,0.012152034261242,0.105726872246696
2017,18081,1321,4855,807,2075,184,317,991,2392,0.0241713823767179,0.414297658862876
2017,18083,91,610,182,485,10,20,192,505,0.0203966234500586,0.38019801980198
2017,18085,428,2074,450,938,0,35,450,973,0.0186967967564036,0.462487153134635
2017,18087,61,605,85,407,0,14,85,421,0.0188392177920974,0.201900237529691
2017,18089,716,3004,1783,8896,199,737,1982,9633,0.0295039188481435,0.205751064050659
2017,18091,289,3774,322,1509,16,80,338,1589,0.020582101731798,0.212712397734424
2017,18093,89,761,30,209,30,62,60,271,0.00846081798314081,0.22140221402214
2017,18095,674,3053,175,834,52,166,227,1000,0.0111358574610245,0.227
2017,18097,5469,14458,4693,10403,1118,3012,5811,13415,0.0217862270119983,0.433171822586657
2017,18099,218,889,86,336,10,32,96,368,0.0119360384029062,0.260869565217391
2017,18101,29,220,16,89,0,0,16,89,0.0125246270757107,0.179775280898876
2017,18103,169,1697,58,288,0,8,58,296,0.0119009327758122,0.195945945945946
2017,18105,968,2725,1537,2572,835,1048,2372,3620,0.0442121204719216,0.65524861878453
2017,18107,197,692,81,466,16,29,97,495,0.0191972076788831,0.195959595959596
2017,18109,294,2844,70,337,12,12,82,349,0.0073354772263909,0.234957020057307
2017,18111,38,476,52,160,27,27,79,187,0.0189674409169287,0.422459893048128
2017,18113,191,1433,89,267,0,110,89,377,0.0120328109540072,0.236074270557029
2017,18115,4,108,10,146,0,18,10,164,0.0373746581586144,0.0609756097560976
2017,18117,54,436,17,103,0,44,17,147,0.0109204368174727,0.115646258503401
2017,18119,71,709,42,167,0,15,42,182,0.0121975738891495,0.230769230769231
2017,18121,70,942,15,187,0,38,15,225,0.0186706497386109,0.0666666666666667
2017,18123,36,664,51,297,0,13,51,310,0.0227356068940227,0.164516129032258
2017,18125,0,247,9,47,0,0,9,47,0.0053439454235361,0.191489361702128
2017,18127,894,3207,966,2334,103,232,1069,2566,0.0225709410129655,0.416601714731099
2017,18129,53,504,107,303,0,0,107,303,0.0169947837792361,0.353135313531353
2017,18131,41,469,0,28,12,21,12,49,0.0055155335434489,0.244897959183673
2017,18133,107,1813,50,253,20,43,70,296,0.011956697366295,0.236486486486486
2017,18135,48,278,31,221,11,23,42,244,0.0140197655711331,0.172131147540984
2017,18137,93,486,59,215,0,67,59,282,0.0146997497914929,0.209219858156028
2017,18139,33,375,14,102,16,34,30,136,0.0117861166478898,0.220588235294118
2017,18141,671,3034,1975,3982,458,769,2433,4751,0.0272333839672122,0.512102715217849
2017,18143,64,527,23,87,8,12,31,99,0.00609418282548476,0.313131313131313
2017,18145,142,876,76,230,25,52,101,282,0.00921960309935593,0.358156028368794
2017,18147,28,183,82,177,8,8,90,185,0.0128677749182722,0.486486486486487
2017,18149,74,493,4,95,1,11,5,106,0.00671395996959716,0.0471698113207547
2017,18151,186,831,84,475,0,0,84,475,0.020168994947136,0.176842105263158
2017,18153,72,825,0,99,0,28,0,127,0.00849384697699304,0
2017,18155,23,241,2,74,1,1,3,75,0.01047632350887,0.04
2017,18157,749,2941,1222,2522,788,1143,2010,3665,0.0357348309786371,0.548431105047749
2017,18159,116,568,0,33,0,16,0,49,0.0045169616519174,0
2017,18161,6,112,40,432,0,0,40,432,0.0868690931027549,0.0925925925925926
2017,18163,836,2326,1107,2462,18,260,1125,2722,0.0220839384375735,0.413299044819985
2017,18165,37,209,13,92,0,11,13,103,0.0094072518038177,0.12621359223301
2017,18167,382,2015,707,1784,25,264,732,2048,0.0296549427317878,0.357421875
2017,18169,154,702,71,241,7,43,78,284,0.0130215497478221,0.274647887323944
2017,18171,16,186,15,37,0,0,15,37,0.00630323679727428,0.405405405405405
2017,18173,589,1637,287,608,31,80,318,688,0.0163860242455998,0.462209302325581
2017,18175,45,593,11,160,5,13,16,173,0.00907707644682302,0.092485549132948
2017,18177,219,804,346,1395,15,36,361,1431,0.0311717167316531,0.252271139063592
2017,18179,181,653,23,150,0,34,23,184,0.0098390460403187,0.125
2017,18181,66,480,11,194,11,96,22,290,0.0173351664773746,0.0758620689655172
2017,18183,182,995,86,349,0,14,86,363,0.0157279029462738,0.236914600550964
2017,19001,76,306,2,46,0,2,2,48,0.0092897232436617,0.0416666666666667
2017,19003,0,59,4,6,0,9,4,15,0.00547645125958379,0.266666666666667
2017,19005,7,115,19,132,0,8,19,140,0.014344262295082,0.135714285714286
2017,19007,66,324,15,88,0,2,15,90,0.0100581135449262,0.166666666666667
2017,19009,21,181,1,34,0,2,1,36,0.00868097419821558,0.0277777777777778
2017,19011,215,733,40,167,0,14,40,181,0.0103133903133903,0.220994475138122
2017,19013,407,1735,542,1436,46,240,588,1676,0.0200824386503067,0.350835322195704
2017,19015,226,586,137,379,0,21,137,400,0.0218531468531469,0.3425
2017,19017,154,571,109,220,30,59,139,279,0.0171555063641395,0.498207885304659
2017,19019,66,470,32,181,9,22,41,203,0.0145072536268134,0.201970443349754
2017,19021,89,223,132,315,1,17,133,332,0.0259659002033474,0.400602409638554
2017,19023,109,307,10,63,0,4,10,67,0.00641946919612916,0.149253731343284
2017,19025,79,613,0,51,0,2,0,53,0.00758226037195994,0
2017,19027,68,389,48,91,0,16,48,107,0.00771838707350501,0.448598130841121
2017,19029,45,304,17,90,0,5,17,95,0.0101010101010101,0.178947368421053
2017,19031,103,426,19,117,0,6,19,123,0.00950394065832174,0.154471544715447
2017,19033,307,785,148,406,1,25,149,431,0.0140221882421837,0.345707656612529
2017,19035,18,179,24,102,0,19,24,121,0.0145485150895756,0.198347107438017
2017,19037,52,138,3,55,0,32,3,87,0.0104179140222728,0.0344827586206897
2017,19039,32,298,21,57,62,62,83,119,0.0186989314896292,0.697478991596639
2017,19041,99,449,109,295,0,1,109,296,0.0258357336126386,0.368243243243243
2017,19043,25,265,62,200,3,3,65,203,0.0161008883248731,0.320197044334975
2017,19045,120,354,69,613,65,127,134,740,0.0224937686181531,0.181081081081081
2017,19047,25,133,7,46,0,3,7,49,0.00439737952077537,0.142857142857143
2017,19049,1621,3419,1109,1559,108,218,1217,1777,0.0337588814164672,0.684862127180642
2017,19051,33,170,26,96,0,11,26,107,0.0191756272401434,0.242990654205607
2017,19053,0,110,44,99,0,0,44,99,0.0201711491442543,0.444444444444444
2017,19055,28,192,4,49,0,0,4,49,0.0041514869101076,0.0816326530612245
2017,19057,79,664,179,760,65,93,244,853,0.0308064574379718,0.286049237983587
2017,19059,46,237,87,246,4,26,91,272,0.0215530903328051,0.334558823529412
2017,19061,287,925,652,1792,175,280,827,2072,0.0323068527325173,0.399131274131274
2017,19063,26,93,24,135,7,27,31,162,0.0248771498771499,0.191358024691358
2017,19065,45,412,29,110,0,17,29,127,0.00914524375315043,0.228346456692913
2017,19067,33,160,98,263,0,10,98,273,0.0247148288973384,0.358974358974359
2017,19069,67,156,39,67,0,5,39,72,0.00999583506872137,0.541666666666667
2017,19071,12,78,36,147,8,15,44,162,0.0325890162945081,0.271604938271605
2017,19073,47,250,7,92,0,0,7,92,0.0144585887160145,0.0760869565217391
2017,19075,71,162,36,58,0,25,36,83,0.00965116279069767,0.433734939759036
2017,19077,75,255,38,94,1,7,39,101,0.0134290652838718,0.386138613861386
2017,19079,124,300,72,106,3,3,75,109,0.0102424356323999,0.688073394495413
2017,19081,33,147,10,62,0,9,10,71,0.00912831061969658,0.140845070422535
2017,19083,78,361,36,157,0,10,36,167,0.0138393967017486,0.215568862275449
2017,19085,25,163,34,114,0,5,34,119,0.0120056497175141,0.285714285714286
2017,19087,55,465,59,256,9,12,68,268,0.0197058823529412,0.253731343283582
2017,19089,53,131,23,118,0,0,23,118,0.0185447116140185,0.194915254237288
2017,19091,46,202,17,59,0,3,17,62,0.00926479378362224,0.274193548387097
2017,19093,32,103,9,63,0,1,9,64,0.013136288998358,0.140625
2017,19095,48,374,29,129,0,3,29,132,0.0117552765161635,0.21969696969697
2017,19097,84,291,37,146,0,17,37,163,0.011950146627566,0.226993865030675
2017,19099,127,1376,57,273,3,20,60,293,0.0113306779071116,0.204778156996587
2017,19101,53,324,173,317,315,344,488,661,0.0524978159002462,0.738275340393343
2017,19103,806,2686,1599,2716,674,1010,2273,3726,0.0440665137072167,0.61003757380569
2017,19105,163,433,2,118,10,94,12,212,0.0145714482094989,0.0566037735849057
2017,19107,84,237,17,37,0,1,17,38,0.00529764394256239,0.447368421052632
2017,19109,43,226,43,170,0,9,43,179,0.0167461876695668,0.240223463687151
2017,19111,25,397,21,456,0,37,21,493,0.0201495892426534,0.0425963488843813
2017,19113,816,2847,1068,2802,281,377,1349,3179,0.0216368895695083,0.424347279018559
2017,19115,68,268,1,40,0,6,1,46,0.00597868468936834,0.0217391304347826
2017,19117,16,233,51,145,8,13,59,158,0.0265145158583655,0.373417721518987
2017,19119,44,141,39,114,0,6,39,120,0.015770797739519,0.325
2017,19121,99,455,0,166,0,13,0,179,0.0168328004513824,0
2017,19123,112,357,19,276,8,8,27,284,0.0189560806300894,0.0950704225352113
2017,19125,246,819,138,261,0,19,138,280,0.0129515703779083,0.492857142857143
2017,19127,124,807,97,391,0,96,97,487,0.018194044906041,0.19917864476386
2017,19129,80,360,99,323,0,0,99,323,0.0313988529211626,0.306501547987616
2017,19131,27,98,22,60,0,6,22,66,0.00908590308370044,0.333333333333333
2017,19133,5,322,21,74,0,11,21,85,0.0131031293355943,0.247058823529412
2017,19135,35,236,57,101,0,0,57,101,0.0187872023809524,0.564356435643564
2017,19137,37,176,36,167,0,12,36,179,0.0250594988100238,0.201117318435754
2017,19139,91,406,80,241,58,125,138,366,0.0128973148213405,0.377049180327869
2017,19141,94,389,7,163,18,18,25,181,0.0187022112006613,0.138121546961326
2017,19143,11,127,32,132,0,4,32,136,0.0317534438477703,0.235294117647059
2017,19145,47,554,106,265,0,2,106,267,0.0240151106314085,0.397003745318352
2017,19147,85,250,25,60,3,3,28,63,0.0100398406374502,0.444444444444444
2017,19149,80,292,69,223,0,17,69,240,0.0143575017946877,0.2875
2017,19151,29,127,9,39,2,10,11,49,0.00984331056649257,0.224489795918367
2017,19153,3124,8626,3084,7413,213,860,3297,8273,0.0268388662338968,0.398525323340989
2017,19155,260,971,439,1922,20,200,459,2122,0.0337677630846104,0.216305372290292
2017,19157,93,518,44,120,5,25,49,145,0.0120994659546061,0.337931034482759
2017,19159,27,82,14,47,1,10,15,57,0.0162903686767648,0.263157894736842
2017,19161,21,189,42,87,1,19,43,106,0.0150675195451315,0.405660377358491
2017,19163,419,1183,1475,3069,302,472,1777,3541,0.0306394393008566,0.501835639649816
2017,19165,111,227,39,149,0,19,39,168,0.0202312138728324,0.232142857142857
2017,19167,52,264,126,459,0,125,126,584,0.0284406350443167,0.215753424657534
2017,19169,840,1884,744,1258,756,847,1500,2105,0.0427645612823274,0.712589073634204
2017,19171,58,302,17,65,0,7,17,72,0.00613967766692249,0.236111111111111
2017,19173,14,146,14,76,1,31,15,107,0.0245581822354831,0.14018691588785
2017,19175,0,280,20,84,12,17,32,101,0.0118600281822452,0.316831683168317
2017,19177,7,79,26,90,0,0,26,90,0.0177374852187623,0.288888888888889
2017,19179,176,585,96,424,25,70,121,494,0.0205055829978,0.244939271255061
2017,19181,507,1630,70,343,11,13,81,356,0.0112115390671748,0.22752808988764
2017,19183,118,448,81,296,4,14,85,310,0.0207205400708509,0.274193548387097
2017,19185,4,69,17,95,0,8,17,103,0.0234998859228839,0.16504854368932
2017,19187,128,1021,97,447,72,98,169,545,0.0220638840532772,0.310091743119266
2017,19189,77,318,17,136,0,0,17,136,0.0186173853524983,0.125
2017,19191,28,230,114,189,31,31,145,220,0.0163422968355371,0.659090909090909
2017,19193,138,736,508,1628,6,115,514,1743,0.0267335388579579,0.294893861158921
2017,19195,8,173,11,63,1,2,12,65,0.0123951182303585,0.184615384615385
2017,19197,46,252,19,155,32,57,51,212,0.0236765691311146,0.240566037735849
2017,20001,34,196,26,56,0,0,26,56,0.00649275362318841,0.464285714285714
2017,20003,39,185,17,92,0,27,17,119,0.0221973512404402,0.142857142857143
2017,20005,21,162,39,86,0,14,39,100,0.00987459267305224,0.39
2017,20007,3,46,3,140,0,1,3,141,0.0413368513632366,0.0212765957446809
2017,20009,86,609,65,300,5,94,70,394,0.0215854927957048,0.177664974619289
2017,20011,0,91,37,161,0,3,37,164,0.0171458442237324,0.225609756097561
2017,20013,45,188,15,97,0,0,15,97,0.0147775746496039,0.154639175257732
2017,20015,601,1913,198,758,11,95,209,853,0.0196897650154656,0.245017584994138
2017,20017,17,95,7,13,0,3,7,16,0.00862533692722372,0.4375
2017,20019,24,102,0,19,0,0,0,19,0.00763052208835341,0
2017,20021,66,206,38,262,0,8,38,270,0.0192691978304311,0.140740740740741
2017,20023,7,23,5,32,0,0,5,32,0.0169043845747491,0.15625
2017,20025,6,38,25,40,0,5,25,45,0.0314026517794836,0.555555555555556
2017,20027,21,206,73,206,0,22,73,228,0.0397905759162304,0.320175438596491
2017,20029,57,232,22,75,0,16,22,91,0.0146916370681304,0.241758241758242
2017,20031,27,171,31,162,0,13,31,175,0.029817686147555,0.177142857142857
2017,20033,0,17,0,0,0,0,0,0,0,NA
2017,20035,69,756,113,555,6,175,119,730,0.0313937986496366,0.163013698630137
2017,20037,140,435,334,583,39,43,373,626,0.0267876246309213,0.595846645367412
2017,20039,10,63,15,78,0,0,15,78,0.036027713625866,0.192307692307692
2017,20041,104,470,78,334,0,30,78,364,0.0276134122287968,0.214285714285714
2017,20043,10,31,13,145,0,4,13,149,0.0291414042636417,0.087248322147651
2017,20045,1097,2128,1305,2047,330,452,1635,2499,0.0372102026534046,0.654261704681873
2017,20047,15,64,10,35,0,0,10,35,0.0169738118331717,0.285714285714286
2017,20049,3,59,0,24,0,0,0,24,0.0124159337816865,0
2017,20051,167,447,109,294,10,54,119,348,0.0202078857209221,0.341954022988506
2017,20053,24,284,5,59,0,10,5,69,0.0149609713790113,0.072463768115942
2017,20055,108,332,101,458,0,90,101,548,0.0253386969991215,0.184306569343066
2017,20057,125,332,114,541,10,204,124,745,0.0364856261325236,0.166442953020134
2017,20059,58,436,68,274,0,14,68,288,0.0169591331998587,0.236111111111111
2017,20061,160,957,537,1823,46,536,583,2359,0.122960646338285,0.247138618058499
2017,20063,8,54,10,20,12,12,22,32,0.0165460186142709,0.6875
2017,20065,18,44,3,16,0,0,3,16,0.00827300930713547,0.1875
2017,20067,4,74,29,60,0,0,29,60,0.0130067201387383,0.483333333333333
2017,20069,40,109,18,77,0,3,18,80,0.0213732300293882,0.225
2017,20071,0,12,0,8,0,9,0,17,0.0204572803850782,0
2017,20073,37,183,2,25,0,2,2,27,0.0059721300597213,0.0740740740740741
2017,20075,0,40,11,51,2,2,13,53,0.0328173374613003,0.245283018867925
2017,20077,3,67,14,87,0,3,14,90,0.02256204562547,0.155555555555556
2017,20079,117,438,63,221,0,124,63,345,0.0151249451994739,0.182608695652174
2017,20081,5,46,7,40,0,0,7,40,0.0159808230123851,0.175
2017,20083,15,52,5,13,13,13,18,26,0.0194319880418535,0.692307692307692
2017,20085,113,364,93,189,0,0,93,189,0.0211598746081505,0.492063492063492
2017,20087,201,625,0,65,0,0,0,65,0.00493358633776091,0
2017,20089,15,41,0,22,0,6,0,28,0.0126353790613718,0
2017,20091,2887,6851,8367,15064,987,1757,9354,16821,0.0433269626050269,0.556090601034421
2017,20093,26,130,0,66,0,67,0,133,0.0543078807676603,0
2017,20095,62,149,17,39,0,0,17,39,0.00730337078651685,0.435897435897436
2017,20097,8,31,9,16,4,7,13,23,0.0140073081607795,0.565217391304348
2017,20099,32,478,48,273,0,13,48,286,0.0204227363610397,0.167832167832168
2017,20101,4,32,3,13,0,0,3,13,0.0111779879621668,0.230769230769231
2017,20103,327,1911,1898,3321,262,345,2160,3666,0.0683228656093334,0.589198036006547
2017,20105,23,92,4,24,0,7,4,31,0.014052583862194,0.129032258064516
2017,20107,17,199,48,94,1,3,49,97,0.0142941349837902,0.505154639175258
2017,20109,11,52,0,14,0,0,0,14,0.00729546638874414,0
2017,20111,113,394,55,519,3,3,58,522,0.0262192978050128,0.111111111111111
2017,20113,216,576,102,279,0,72,102,351,0.0180806675938804,0.290598290598291
2017,20115,50,223,43,79,10,27,53,106,0.0127266178412775,0.5
2017,20117,31,165,8,74,0,0,8,74,0.0106920965178442,0.108108108108108
2017,20119,15,107,0,18,0,4,0,22,0.00798548094373866,0
2017,20121,149,939,64,290,28,28,92,318,0.0142428449858915,0.289308176100629
2017,20123,56,129,10,54,0,1,10,55,0.0130146710837672,0.181818181818182
2017,20125,168,602,132,501,29,33,161,534,0.0237080447522643,0.301498127340824
2017,20127,10,74,7,187,3,27,10,214,0.0522333414693678,0.0467289719626168
2017,20129,0,35,4,11,0,0,4,11,0.00593952483801296,0.363636363636364
2017,20131,63,201,36,55,0,4,36,59,0.00886151997596876,0.610169491525424
2017,20133,124,391,19,52,8,26,27,78,0.00723763570566948,0.346153846153846
2017,20135,17,34,0,24,0,1,0,25,0.0114468864468864,0
2017,20137,35,375,24,90,0,0,24,90,0.0226586102719033,0.266666666666667
2017,20139,44,420,13,113,0,2,13,115,0.0104659628685839,0.11304347826087
2017,20141,29,116,14,57,0,0,14,57,0.0215745647236942,0.245614035087719
2017,20143,21,162,9,43,2,2,11,45,0.0109515697249939,0.244444444444444
2017,20145,81,502,67,241,0,3,67,244,0.0484319174275506,0.274590163934426
2017,20147,25,121,13,25,0,0,13,25,0.00663305916688777,0.52
2017,20149,177,641,190,431,5,20,195,451,0.0307346326836582,0.432372505543237
2017,20151,53,176,93,122,12,47,105,169,0.026975259377494,0.621301775147929
2017,20153,7,36,27,39,0,8,27,47,0.0250934329951949,0.574468085106383
2017,20155,408,1770,90,635,0,86,90,721,0.016675532530009,0.124826629680999
2017,20157,13,50,8,69,0,0,8,69,0.0195855804711893,0.115942028985507
2017,20159,66,337,13,63,0,0,13,63,0.00991501416430595,0.206349206349206
2017,20161,495,1741,645,1782,383,1029,1028,2811,0.0746653208669783,0.365706154393454
2017,20163,12,131,8,22,0,11,8,33,0.00914634146341463,0.242424242424242
2017,20165,17,76,7,49,0,0,7,49,0.0213600697471665,0.142857142857143
2017,20167,101,322,5,163,0,1,5,164,0.0319439033891702,0.0304878048780488
2017,20169,202,1037,160,457,0,119,160,576,0.0155385901966603,0.277777777777778
2017,20171,42,236,0,0,0,0,0,0,0,NA
2017,20173,1215,4735,2211,6193,435,1247,2646,7440,0.0226607496931357,0.355645161290323
2017,20175,22,281,69,336,0,66,69,402,0.0303053147380324,0.171641791044776
2017,20177,626,2652,570,2000,62,402,632,2402,0.0199948389674605,0.263114071606994
2017,20179,1,70,0,16,3,27,3,43,0.023783185840708,0.0697674418604651
2017,20181,47,162,76,105,0,0,76,105,0.0258366141732283,0.723809523809524
2017,20183,0,31,8,54,0,0,8,54,0.0197224251278305,0.148148148148148
2017,20185,24,103,4,32,0,0,4,32,0.0108806528391704,0.125
2017,20187,12,13,15,30,0,8,15,38,0.0277777777777778,0.394736842105263
2017,20189,5,79,12,194,0,6,12,200,0.0562587904360056,0.06
2017,20191,134,630,28,253,2,18,30,271,0.0173262579118982,0.11070110701107
2017,20193,65,136,15,36,0,0,15,36,0.00715705765407555,0.416666666666667
2017,20195,27,79,8,43,0,0,8,43,0.0202734559170203,0.186046511627907
2017,20197,19,253,9,67,3,11,12,78,0.0164522252689306,0.153846153846154
2017,20199,15,23,0,15,0,0,0,15,0.0137994480220791,0
2017,20201,0,91,18,65,0,0,18,65,0.0166197903349527,0.276923076923077
2017,20203,0,14,3,22,0,0,3,22,0.0150581793292266,0.136363636363636
2017,20205,23,224,11,65,0,0,11,65,0.0105691056910569,0.169230769230769
2017,20207,20,85,1,26,0,0,1,26,0.0110732538330494,0.0384615384615385
2017,20209,790,2528,813,2824,162,619,975,3443,0.0334853775007051,0.283183270403718
2017,21001,60,268,61,351,0,12,61,363,0.0282248658735713,0.168044077134986
2017,21003,40,436,0,309,10,39,10,348,0.0247282029418035,0.028735632183908
2017,21005,165,910,9,41,4,12,13,53,0.00351086380498145,0.245283018867925
2017,21007,30,154,0,65,0,0,0,65,0.0113835376532399,0
2017,21009,245,892,84,517,15,32,99,549,0.0185906335715011,0.180327868852459
2017,21011,26,410,0,55,0,31,0,86,0.0105963528831937,0
2017,21013,11,749,72,239,0,0,72,239,0.0123482304314131,0.301255230125523
2017,21015,868,3384,896,2782,407,481,1303,3263,0.039127984363196,0.399325773827766
2017,21017,78,523,64,195,0,8,64,203,0.0145917193789534,0.315270935960591
2017,21019,186,1043,252,1063,13,91,265,1154,0.033380579098088,0.229636048526863
2017,21021,212,1006,164,512,14,14,178,526,0.0266140457397288,0.338403041825095
2017,21023,51,203,0,57,0,9,0,66,0.0116731517509728,0
2017,21025,3,198,40,149,0,11,40,160,0.0172080017208002,0.25
2017,21027,20,382,20,216,0,51,20,267,0.0192863334296446,0.0749063670411985
2017,21029,325,2536,91,422,7,83,98,505,0.0093309436263188,0.194059405940594
2017,21031,49,239,3,36,0,0,3,36,0.00401293055400736,0.0833333333333333
2017,21033,72,222,18,119,0,3,18,122,0.0135480288728484,0.147540983606557
2017,21035,151,491,158,331,143,274,301,605,0.0254973027646662,0.497520661157025
2017,21037,516,1545,855,1903,46,94,901,1997,0.0319024873396489,0.451176765147722
2017,21039,23,72,1,19,0,0,1,19,0.00553129548762737,0.0526315789473684
2017,21041,8,247,44,257,0,8,44,265,0.037208649255827,0.166037735849057
2017,21043,52,720,69,200,0,110,69,310,0.0166246581219499,0.22258064516129
2017,21045,34,294,39,269,0,15,39,284,0.0258158349240978,0.137323943661972
2017,21047,175,1307,368,2735,196,397,564,3132,0.0759935944096666,0.18007662835249
2017,21049,131,1118,85,568,28,58,113,626,0.0250771141289108,0.180511182108626
2017,21051,31,298,37,233,0,24,37,257,0.0174367324784585,0.143968871595331
2017,21053,9,201,0,61,0,0,0,61,0.00855659980361902,0
2017,21055,0,107,0,55,0,0,0,55,0.00855631611698818,0
2017,21057,50,160,41,97,0,0,41,97,0.0204555040067482,0.422680412371134
2017,21059,188,1465,223,948,89,320,312,1268,0.0189811834797838,0.246056782334385
2017,21061,24,338,25,135,0,0,25,135,0.0156758012076173,0.185185185185185
2017,21063,3,604,0,3,0,0,0,3,0.000541711809317443,0
2017,21065,64,388,0,43,0,13,0,56,0.00546821599453178,0
2017,21067,1930,6689,3102,6280,916,2074,4018,8354,0.0409793043230861,0.480967201340675
2017,21069,37,315,4,62,0,17,4,79,0.00802193338748985,0.0506329113924051
2017,21071,111,945,0,198,0,0,0,198,0.00756620428751576,0
2017,21073,442,1662,226,620,105,364,331,984,0.0282093916633221,0.336382113821138
2017,21075,10,294,0,135,0,0,0,135,0.0306261343012704,0
2017,21077,62,277,26,132,8,15,34,147,0.0253886010362694,0.231292517006803
2017,21079,50,507,0,85,6,21,6,106,0.0086949388893446,0.0566037735849057
2017,21081,93,849,53,200,0,3,53,203,0.0127608750314307,0.261083743842365
2017,21083,80,405,20,154,23,141,43,295,0.0116947472745292,0.145762711864407
2017,21085,86,538,0,170,5,60,5,230,0.0130024308892532,0.0217391304347826
2017,21087,32,308,0,24,0,14,0,38,0.00479132517967469,0
2017,21089,102,718,109,519,0,21,109,540,0.021131721061282,0.201851851851852
2017,21091,38,202,7,102,0,0,7,102,0.0175771152851973,0.0686274509803922
2017,21093,598,2804,1087,3233,223,736,1310,3969,0.0565030465235465,0.330057949105568
2017,21095,22,387,13,79,0,0,13,79,0.00413850908900414,0.164556962025316
2017,21097,36,477,11,133,0,0,11,133,0.0104240144211929,0.0827067669172932
2017,21099,94,400,14,121,0,19,14,140,0.0112053785817192,0.1
2017,21101,51,936,107,548,0,86,107,634,0.0198795936284962,0.168769716088328
2017,21103,59,690,8,95,0,0,8,95,0.00888597886072397,0.0842105263157895
2017,21105,8,94,16,75,0,0,16,75,0.0227479526842584,0.213333333333333
2017,21107,147,986,78,159,14,37,92,196,0.00613823557044878,0.469387755102041
2017,21109,22,262,0,94,0,0,0,94,0.0102474653875504,0
2017,21111,2380,8174,4852,9693,1078,2283,5930,11976,0.0228155136348222,0.495156980627923
2017,21113,683,2081,214,447,106,159,320,606,0.0180965747902171,0.528052805280528
2017,21115,70,435,42,248,21,56,63,304,0.0189019461543244,0.207236842105263
2017,21117,1082,3996,1652,3994,190,338,1842,4332,0.0390608093486258,0.425207756232687
2017,21119,20,332,36,143,0,0,36,143,0.0132591562355123,0.251748251748252
2017,21121,4,542,46,243,0,0,46,243,0.0115461370331654,0.189300411522634
2017,21123,90,485,99,164,0,28,99,192,0.01947261663286,0.515625
2017,21125,116,1572,72,627,7,20,79,647,0.0157905012935032,0.12210200927357
2017,21127,14,114,9,168,0,7,9,175,0.0159700675305713,0.0514285714285714
2017,21129,5,348,2,102,0,0,2,102,0.0206352417560186,0.0196078431372549
2017,21131,0,166,0,98,9,9,9,107,0.0142022829838067,0.0841121495327103
2017,21133,14,144,9,52,16,25,25,77,0.00469942020140372,0.324675324675325
2017,21135,50,254,15,199,0,0,15,199,0.0209077537297752,0.0753768844221105
2017,21137,162,977,7,36,0,18,7,54,0.00320607967701716,0.12962962962963
2017,21139,22,147,10,82,0,10,10,92,0.0136437787335014,0.108695652173913
2017,21141,70,481,37,213,0,17,37,230,0.0125607558298291,0.160869565217391
2017,21143,43,572,42,135,0,66,42,201,0.0307010844661677,0.208955223880597
2017,21145,173,1026,226,856,0,42,226,898,0.0195344790080487,0.251670378619154
2017,21147,74,258,0,240,0,0,0,240,0.0196174595389897,0
2017,21149,26,214,4,23,2,2,6,25,0.0038604076590488,0.24
2017,21151,394,2111,359,1081,76,145,435,1226,0.0227796358231141,0.354812398042414
2017,21153,5,273,0,15,0,7,0,22,0.00249858035207269,0
2017,21155,98,793,40,72,0,37,40,109,0.00829717591535358,0.36697247706422
2017,21157,63,653,96,366,19,19,115,385,0.0170105598020589,0.298701298701299
2017,21159,2,393,18,241,0,0,18,241,0.0281970281970282,0.0746887966804979
2017,21161,113,467,24,182,0,57,24,239,0.0204465737017709,0.100418410041841
2017,21163,113,1052,370,929,5,67,375,996,0.0517806082661814,0.376506024096386
2017,21165,0,159,4,30,8,8,12,38,0.00814053127677806,0.315789473684211
2017,21167,177,807,68,164,0,51,68,215,0.0143870449678801,0.316279069767442
2017,21169,0,220,62,140,0,0,62,140,0.0202166064981949,0.442857142857143
2017,21171,20,229,12,47,6,14,18,61,0.00822767736714324,0.295081967213115
2017,21173,129,1163,8,371,0,0,8,371,0.0198895620007505,0.0215633423180593
2017,21175,14,477,5,68,0,0,5,68,0.00691478543827537,0.0735294117647059
2017,21177,23,656,11,152,0,18,11,170,0.00788789903489235,0.0647058823529412
2017,21179,98,1194,28,206,17,52,45,258,0.00853343917443937,0.174418604651163
2017,21181,24,173,0,49,0,6,0,55,0.0114345114345114,0
2017,21183,0,687,49,294,0,5,49,299,0.0181366007521533,0.163879598662207
2017,21185,564,2869,374,775,89,105,463,880,0.0205708408331191,0.526136363636364
2017,21187,47,531,21,47,1,7,22,54,0.00729631130928253,0.407407407407407
2017,21189,4,65,0,0,0,0,0,0,0,NA
2017,21191,61,385,32,149,0,0,32,149,0.0148184982595724,0.214765100671141
2017,21193,57,468,0,69,56,98,56,167,0.00872381549391422,0.335329341317365
2017,21195,120,965,109,716,0,115,109,831,0.019199667298184,0.131167268351384
2017,21197,21,295,5,52,0,14,5,66,0.00789662598707825,0.0757575757575758
2017,21199,151,1225,95,604,0,36,95,640,0.0143055120926282,0.1484375
2017,21201,8,39,6,6,0,0,6,6,0.00388852883992223,1
2017,21203,22,478,0,31,0,10,0,41,0.00347634390367984,0
2017,21205,182,1003,61,236,0,0,61,236,0.0169540229885057,0.258474576271186
2017,21207,24,295,1,47,0,7,1,54,0.00433178244825926,0.0185185185185185
2017,21209,341,1252,208,748,36,143,244,891,0.0262421582776191,0.27384960718294
2017,21211,311,1525,172,503,18,145,190,648,0.0208682210485637,0.29320987654321
2017,21213,38,408,27,102,0,0,27,102,0.00842835894893406,0.264705882352941
2017,21215,107,711,90,116,0,105,90,221,0.0175927400095526,0.407239819004525
2017,21217,107,782,0,250,28,88,28,338,0.0204699612403101,0.0828402366863905
2017,21219,27,214,24,136,5,29,29,165,0.0204334365325077,0.175757575757576
2017,21221,27,313,18,125,3,3,21,128,0.0125158893126039,0.1640625
2017,21223,9,156,4,53,0,0,4,53,0.00876902713434811,0.0754716981132075
2017,21225,6,237,45,139,0,0,45,139,0.0142974696564493,0.323741007194245
2017,21227,316,1966,712,2027,104,396,816,2423,0.0323441859223366,0.336772595955427
2017,21229,38,358,55,109,0,0,55,109,0.0136540147814105,0.504587155963303
2017,21231,64,178,30,125,0,8,30,133,0.00920670081683511,0.225563909774436
2017,21233,29,271,0,35,0,0,0,35,0.00386057798367527,0
2017,21235,205,813,134,308,0,54,134,362,0.0156371490280778,0.370165745856354
2017,21237,11,286,0,50,0,0,0,50,0.00991080277502478,0
2017,21239,171,556,92,168,3,108,95,276,0.015471719266775,0.344202898550725
2017,22001,225,1359,60,386,37,105,97,491,0.0122160575224542,0.19755600814664
2017,22003,53,789,70,458,0,110,70,568,0.0317353894289865,0.123239436619718
2017,22005,761,1946,600,1569,53,131,653,1700,0.022176419943124,0.384117647058824
2017,22007,45,420,35,285,0,11,35,296,0.0190084767531467,0.118243243243243
2017,22009,21,1070,7,83,0,47,7,130,0.00466568567634497,0.0538461538461538
2017,22011,180,1082,68,478,106,145,174,623,0.0256357501440211,0.279293739967897
2017,22013,49,379,44,134,0,13,44,147,0.0152902017890576,0.299319727891156
2017,22015,900,3066,972,2487,107,448,1079,2935,0.0357673840454313,0.36763202725724
2017,22017,803,3273,806,2026,101,416,907,2442,0.014571275135748,0.371416871416871
2017,22019,408,2117,962,2972,94,254,1056,3226,0.0246790801572851,0.327340359578425
2017,22021,2,388,0,66,8,31,8,97,0.0142563198118754,0.0824742268041237
2017,22023,10,68,0,38,0,5,0,43,0.00911403136922425,0
2017,22025,29,513,104,135,0,6,104,141,0.0205779334500876,0.737588652482269
2017,22027,35,497,0,83,14,31,14,114,0.00955734406438632,0.12280701754386
2017,22029,46,728,22,170,0,10,22,180,0.013271400132714,0.122222222222222
2017,22031,42,451,3,201,0,34,3,235,0.0128261106866063,0.0127659574468085
2017,22033,2762,6945,2689,5093,576,1067,3265,6160,0.0220122639756436,0.530032467532468
2017,22035,9,776,0,171,0,0,0,171,0.0354845403610708,0
2017,22037,11,980,46,127,0,0,46,127,0.00899752036840241,0.362204724409449
2017,22039,18,493,9,194,0,187,9,381,0.0175802879291251,0.0236220472440945
2017,22041,56,547,38,88,0,17,38,105,0.0077846975088968,0.361904761904762
2017,22043,5,389,0,562,0,86,0,648,0.041305456399796,0
2017,22045,171,1646,92,555,0,235,92,790,0.0167217001100669,0.116455696202532
2017,22047,103,1509,7,324,0,7,7,331,0.0144000696075872,0.0211480362537764
2017,22049,36,847,33,145,0,0,33,145,0.0129325722440243,0.227586206896552
2017,22051,2343,7987,1446,4208,409,1030,1855,5238,0.0171581874821883,0.354142802596411
2017,22053,160,750,39,216,0,0,39,216,0.0104262200125501,0.180555555555556
2017,22055,1633,5504,1329,3317,232,639,1561,3956,0.0251412447331126,0.394590495449949
2017,22057,449,1939,180,539,50,197,230,736,0.0112000486958639,0.3125
2017,22059,15,425,8,134,0,11,8,145,0.0144523073856274,0.0551724137931034
2017,22061,209,688,119,414,16,29,135,443,0.0172588436964314,0.304740406320542
2017,22063,777,2733,79,984,14,227,93,1211,0.0135261923377639,0.0767960363336086
2017,22065,8,479,11,126,0,29,11,155,0.020153426082434,0.0709677419354839
2017,22067,27,289,68,158,0,0,68,158,0.00903373356203545,0.430379746835443
2017,22069,96,484,87,234,3,22,90,256,0.01105449520684,0.3515625
2017,22071,2167,6432,4830,8085,859,1386,5689,9471,0.0348749861914055,0.60067574701721
2017,22073,553,2852,508,1185,85,169,593,1354,0.0134943889652973,0.437961595273264
2017,22075,74,243,112,517,0,72,112,589,0.0386660539617935,0.190152801358234
2017,22077,44,292,6,102,0,87,6,189,0.0122599896211728,0.0317460317460317
2017,22079,223,1690,337,1145,14,83,351,1228,0.0141469764869878,0.285830618892508
2017,22081,9,210,0,3,0,18,0,21,0.00362694300518135,0
2017,22083,123,566,64,149,0,9,64,158,0.0113890290492323,0.40506329113924
2017,22085,54,310,44,129,6,10,50,139,0.00842679599878751,0.359712230215827
2017,22087,155,1269,30,323,56,131,86,454,0.0156497759393313,0.18942731277533
2017,22089,174,999,108,364,40,143,148,507,0.0145643618396484,0.291913214990138
2017,22091,0,283,0,94,0,0,0,94,0.0130338325013866,0
2017,22093,9,326,14,49,0,2,14,51,0.00350949628406276,0.274509803921569
2017,22095,137,877,28,334,16,28,44,362,0.0126229165213753,0.121546961325967
2017,22097,145,1229,38,273,1,32,39,305,0.00568520727706531,0.127868852459016
2017,22099,244,991,0,174,22,206,22,380,0.0106582896249965,0.0578947368421053
2017,22101,81,830,68,233,46,185,114,418,0.0119027279457828,0.272727272727273
2017,22103,1449,4783,1742,3415,121,485,1863,3900,0.0230621851124725,0.477692307692308
2017,22105,666,3042,159,1040,0,126,159,1166,0.0140498855283769,0.136363636363636
2017,22107,0,11,0,26,0,0,0,26,0.00795837159473523,0
2017,22109,376,2121,254,1226,3,196,257,1422,0.019289464045904,0.180731364275668
2017,22111,31,304,37,67,0,0,37,67,0.00429872962915437,0.552238805970149
2017,22113,180,1370,76,475,0,90,76,565,0.0143791515028122,0.134513274336283
2017,22115,179,559,570,2260,169,505,739,2765,0.0888381956046781,0.267269439421338
2017,22117,125,977,57,690,23,70,80,760,0.0241661102101816,0.105263157894737
2017,22119,93,659,4,136,10,36,14,172,0.00626023657870792,0.0813953488372093
2017,22121,91,1015,98,455,0,25,98,480,0.0281557954012201,0.204166666666667
2017,22123,6,179,12,97,0,0,12,97,0.0125468891475876,0.123711340206186
2017,22125,106,424,14,73,8,8,22,81,0.00771502047814078,0.271604938271605
2017,22127,7,532,52,129,0,10,52,139,0.0135609756097561,0.37410071942446
2017,23001,648,2276,365,1030,31,76,396,1106,0.014895422283875,0.358047016274864
2017,23003,53,366,213,814,20,56,233,870,0.017188920061643,0.267816091954023
2017,23005,1639,4169,3456,6104,349,969,3805,7073,0.0341530780262389,0.537961261133889
2017,23007,173,792,153,413,2,15,155,428,0.0199014228587371,0.36214953271028
2017,23009,152,788,212,606,54,251,266,857,0.0208475235963803,0.310385064177363
2017,23011,898,2645,534,1388,32,60,566,1448,0.0166563139853222,0.390883977900552
2017,23013,162,770,283,725,45,55,328,780,0.0261490495826209,0.420512820512821
2017,23015,180,690,181,388,14,79,195,467,0.0179491121531248,0.417558886509636
2017,23017,147,1001,282,856,8,75,290,931,0.0221983786361469,0.311493018259936
2017,23019,445,2113,803,2097,195,261,998,2358,0.0220483043002609,0.423240033927057
2017,23021,35,304,43,129,0,3,43,132,0.0102064486198098,0.325757575757576
2017,23023,295,1051,184,401,17,33,201,434,0.0167729468599034,0.463133640552995
2017,23025,250,1277,151,629,30,41,181,670,0.0178900429895063,0.270149253731343
2017,23027,288,825,260,663,75,173,335,836,0.0290519877675841,0.400717703349282
2017,23029,82,433,153,380,24,59,177,439,0.0187318655060591,0.403189066059225
2017,23031,844,2821,2309,4705,87,293,2396,4998,0.0341461081771662,0.479391756702681
2017,24001,72,965,184,989,49,101,233,1090,0.0215888609400067,0.213761467889908
2017,24003,3786,9801,5376,9904,819,1847,6195,11751,0.0303403510402627,0.527189175389329
2017,24005,5439,15568,4566,8387,1565,3682,6131,12069,0.0210531640800121,0.507995691440882
2017,24009,594,2051,573,1276,123,226,696,1502,0.0245148443748062,0.463382157123835
2017,24011,142,828,9,210,0,0,9,210,0.0094526467410875,0.0428571428571429
2017,24013,1565,3155,310,1105,67,102,377,1207,0.0104762483400311,0.312344656172328
2017,24015,268,1218,772,2229,49,120,821,2349,0.0335720104617759,0.3495104299702
2017,24017,813,3143,954,2361,49,264,1003,2625,0.0254069958768075,0.382095238095238
2017,24019,280,689,25,232,0,25,25,257,0.0111106307552635,0.0972762645914397
2017,24021,1969,4325,1838,3495,552,868,2390,4363,0.0262481876537862,0.547788219115288
2017,24023,57,227,79,436,0,25,79,461,0.021564224904107,0.171366594360087
2017,24025,1604,4101,1398,3217,215,588,1613,3805,0.0221181066203184,0.423915900131406
2017,24027,4965,8442,3392,4835,801,1626,4193,6461,0.0307172265591572,0.648970747562297
2017,24029,143,290,144,391,22,41,166,432,0.0310077519379845,0.384259259259259
2017,24031,4184,9897,18138,23844,6569,10826,24707,34670,0.0485945835330659,0.712633400634554
2017,24033,3391,9907,7638,19429,2131,4602,9769,24031,0.0395748556146034,0.406516582747285
2017,24035,487,1809,333,482,159,256,492,738,0.0214211076280042,0.666666666666667
2017,24037,502,2174,992,2550,131,378,1123,2928,0.0400925634319672,0.38353825136612
2017,24039,48,1460,117,319,0,7,117,326,0.0190978324545987,0.358895705521472
2017,24041,265,864,349,698,9,75,358,773,0.0275314314207358,0.463130659767141
2017,24043,511,3232,612,2097,61,143,673,2240,0.0215558720505023,0.300446428571429
2017,24045,360,1764,355,1595,197,318,552,1913,0.0299097859566285,0.28855201254574
2017,24047,585,1477,264,833,5,107,269,940,0.0241459029026458,0.286170212765957
2017,24510,5450,13962,5875,9253,1548,2761,7423,12014,0.0282526132609028,0.617862493757283
2017,25001,1783,3368,1215,2261,194,816,1409,3077,0.0186370766985058,0.457913552161196
2017,25003,297,898,756,1699,73,300,829,1999,0.0215184559243033,0.414707353676838
2017,25005,2332,7834,1886,4820,567,1291,2453,6111,0.0157737012056776,0.401407298314515
2017,25007,119,119,278,444,0,3,278,447,0.0351221811895969,0.621923937360179
2017,25009,5174,10878,3111,6530,1055,3367,4166,9897,0.0185237175455934,0.420935637061736
2017,25011,660,1478,513,805,88,222,601,1027,0.0194279444591578,0.585199610516066
2017,25013,1349,4657,1151,4002,239,1612,1390,5614,0.0178330352690044,0.247595297470609
2017,25015,1057,2709,1172,1717,348,649,1520,2366,0.0238821035631372,0.642434488588335
2017,25017,15797,25003,17149,22820,8994,13537,26143,36357,0.0328563824451467,0.719063729130566
2017,25019,46,322,92,112,35,38,127,150,0.0189131257092422,0.846666666666667
2017,25021,11261,19113,5646,7692,3329,4767,8975,12459,0.0256772241640836,0.720362789951039
2017,25023,3672,9379,1540,3726,336,1757,1876,5483,0.015575155879387,0.34214845887288
2017,25025,12534,20707,11577,14382,4770,8300,16347,22682,0.0422892343489561,0.720703641654175
2017,25027,3721,9736,3062,6794,1363,3497,4425,10291,0.0184002460279714,0.42998736760276
2017,26001,44,330,30,117,3,32,33,149,0.0175088131609871,0.221476510067114
2017,26003,75,626,7,81,0,16,7,97,0.0136025802832702,0.0721649484536082
2017,26005,720,2597,201,536,3,70,204,606,0.00789679437060203,0.336633663366337
2017,26007,168,647,66,196,12,45,78,241,0.0114190950011846,0.323651452282158
2017,26009,166,708,70,221,6,21,76,242,0.0140273591467656,0.31404958677686
2017,26011,34,478,3,42,4,17,7,59,0.00517952769730489,0.11864406779661
2017,26013,43,248,31,76,0,3,31,79,0.0126480947806596,0.392405063291139
2017,26015,338,1395,151,417,14,48,165,465,0.0112061694180022,0.354838709677419
2017,26017,472,1859,123,489,65,116,188,605,0.0080913723234944,0.310743801652893
2017,26019,105,432,105,311,21,30,126,341,0.0262106072252114,0.36950146627566
2017,26021,342,1405,1380,2949,459,548,1839,3497,0.0326294869043509,0.525879325135831
2017,26023,153,1034,87,387,4,74,91,461,0.0153508041690253,0.197396963123644
2017,26025,448,2381,358,1055,70,270,428,1325,0.0145848009862628,0.323018867924528
2017,26027,47,758,237,951,6,57,243,1008,0.0277326877046249,0.241071428571429
2017,26029,289,816,86,231,16,44,102,275,0.0143805888197459,0.370909090909091
2017,26031,170,665,97,286,0,17,97,303,0.0157631880137343,0.32013201320132
2017,26033,66,1279,219,482,25,64,244,546,0.0208819367422649,0.446886446886447
2017,26035,124,1041,16,248,7,22,23,270,0.0121011115095016,0.0851851851851852
2017,26037,941,2317,231,633,34,99,265,732,0.013950031444743,0.362021857923497
2017,26039,50,500,13,56,6,25,19,81,0.00786713286713287,0.234567901234568
2017,26041,145,544,87,352,11,45,98,397,0.0150139928900991,0.246851385390428
2017,26043,112,254,90,377,10,12,100,389,0.0208758183964796,0.25706940874036
2017,26045,1076,4379,348,871,119,304,467,1175,0.015578182589558,0.397446808510638
2017,26047,311,866,214,357,8,36,222,393,0.0165438854977899,0.564885496183206
2017,26049,1168,5928,576,2933,136,429,712,3362,0.0120835714465422,0.211778703152885
2017,26051,160,757,34,90,0,18,34,108,0.00576461168935148,0.314814814814815
2017,26053,23,411,52,189,17,22,69,211,0.0178465702444388,0.327014218009479
2017,26055,834,2979,559,1223,42,69,601,1292,0.0197619994493561,0.465170278637771
2017,26057,102,1228,60,174,4,35,64,209,0.00744063512406992,0.30622009569378
2017,26059,87,776,197,560,0,74,197,634,0.0203003426083058,0.310725552050473
2017,26061,139,415,261,500,96,203,357,703,0.0331697650278381,0.507823613086771
2017,26063,121,611,39,100,0,21,39,121,0.00519179610400755,0.322314049586777
2017,26065,2574,7125,1927,3696,985,1334,2912,5030,0.0292790826275503,0.578926441351889
2017,26067,415,2317,36,327,0,62,36,389,0.00900608894959831,0.0925449871465296
2017,26069,188,776,97,571,18,43,115,614,0.0315746168877918,0.187296416938111
2017,26071,11,54,17,199,2,8,19,207,0.0235093696763203,0.0917874396135266
2017,26073,303,1470,163,457,164,375,327,832,0.021954823728098,0.393028846153846
2017,26075,979,4740,366,1084,109,273,475,1357,0.012416165719671,0.350036845983788
2017,26077,1839,4527,1433,3343,350,466,1783,3809,0.0236181901608443,0.468101864006301
2017,26079,133,735,38,197,10,29,48,226,0.0181075234356221,0.212389380530973
2017,26081,4919,11832,3337,6351,714,1675,4051,8026,0.0193164396716253,0.504734612509345
2017,26083,18,50,9,16,0,2,9,18,0.0109024833434282,0.5
2017,26085,43,499,26,92,4,6,30,98,0.0109582914010958,0.306122448979592
2017,26087,619,2690,88,424,43,163,131,587,0.00952798337878198,0.223168654173765
2017,26089,327,765,148,359,8,16,156,375,0.022792195952106,0.416
2017,26091,337,2185,188,645,24,112,212,757,0.0111551553911672,0.28005284015852
2017,26093,2161,4950,491,1109,120,233,611,1342,0.0103812920144503,0.455290611028316
2017,26095,91,356,5,40,0,4,5,44,0.00915712799167534,0.113636363636364
2017,26097,113,303,21,105,6,31,27,136,0.0163756773028296,0.198529411764706
2017,26099,5454,19949,1485,4553,1182,2742,2667,7295,0.0120911268200917,0.365592871830021
2017,26101,78,717,119,337,16,34,135,371,0.0204250165161859,0.363881401617251
2017,26103,242,1293,349,931,49,87,398,1018,0.0228579126998383,0.390962671905697
2017,26105,182,887,76,327,8,61,84,388,0.018772982388233,0.216494845360825
2017,26107,303,1101,61,204,0,21,61,225,0.00844784861455283,0.271111111111111
2017,26109,67,323,75,457,6,34,81,491,0.0284802784222738,0.164969450101833
2017,26111,394,1434,535,803,238,417,773,1220,0.0211116494774002,0.633606557377049
2017,26113,51,462,21,128,0,9,21,137,0.0132022742603835,0.153284671532847
2017,26115,424,2305,392,1574,51,183,443,1757,0.0168934185856449,0.252134319863404
2017,26117,318,2209,88,422,13,75,101,497,0.0114629702239546,0.203219315895372
2017,26119,54,305,32,111,3,5,35,116,0.0156777942965266,0.301724137931034
2017,26121,601,4444,162,918,54,229,216,1147,0.00982356971565605,0.188317349607672
2017,26123,174,1350,77,408,11,60,88,468,0.014138545663273,0.188034188034188
2017,26125,11410,26559,7637,11832,5497,7471,13134,19303,0.0222347905416613,0.680412371134021
2017,26127,114,697,57,235,7,50,64,285,0.0158315742695256,0.224561403508772
2017,26129,49,594,12,104,4,16,16,120,0.0076844262295082,0.133333333333333
2017,26131,10,46,11,65,0,9,11,74,0.0147704590818363,0.148648648648649
2017,26133,60,496,32,197,0,17,32,214,0.0132877988202422,0.149532710280374
2017,26135,23,247,23,59,0,26,23,85,0.0137384839178924,0.270588235294118
2017,26137,229,728,46,139,7,10,53,149,0.0087395155141064,0.355704697986577
2017,26139,2162,6028,1130,2256,232,496,1362,2752,0.0159453038994148,0.494912790697674
2017,26141,70,374,45,95,0,8,45,103,0.0102907383354981,0.436893203883495
2017,26143,132,879,54,319,0,23,54,342,0.0180246653315063,0.157894736842105
2017,26145,690,3225,390,1165,130,374,520,1539,0.011671912327936,0.337881741390513
2017,26147,816,3555,366,1461,70,213,436,1674,0.0149461616756844,0.260454002389486
2017,26149,185,1082,116,650,9,20,125,670,0.0164643436378827,0.186567164179104
2017,26151,109,980,49,228,7,43,56,271,0.00927034515786953,0.206642066420664
2017,26153,52,197,18,68,0,21,18,89,0.014662273476112,0.202247191011236
2017,26155,273,1312,98,322,3,33,101,355,0.00745234696448064,0.284507042253521
2017,26157,147,1164,75,338,4,34,79,372,0.00980702309395761,0.212365591397849
2017,26159,333,1573,173,681,122,257,295,938,0.0183637111141565,0.314498933901919
2017,26161,3157,7391,4309,6218,2211,2962,6520,9180,0.0409843384467025,0.710239651416122
2017,26163,6937,21271,4340,12093,2180,5305,6520,17398,0.0148287424292272,0.374755719048166
2017,26165,113,1040,56,216,0,19,56,235,0.0103410341034103,0.238297872340426
2017,27001,58,447,13,79,2,23,15,102,0.00826714216242503,0.147058823529412
2017,27003,2874,10237,990,2676,109,489,1099,3165,0.0135616896194157,0.347235387045814
2017,27005,174,673,147,357,17,80,164,437,0.0190663176265271,0.375286041189931
2017,27007,281,851,161,403,26,67,187,470,0.0168803649032073,0.397872340425532
2017,27009,367,1681,37,426,0,59,37,485,0.018436157676664,0.0762886597938144
2017,27011,25,119,6,48,0,5,6,53,0.0144335511982571,0.113207547169811
2017,27013,575,1330,258,681,54,99,312,780,0.020495033895633,0.4
2017,27015,68,230,32,148,5,19,37,167,0.00966155626265548,0.221556886227545
2017,27017,278,1138,42,189,2,11,44,200,0.00811886011204027,0.22
2017,27019,1627,3599,556,895,120,198,676,1093,0.0171625971578865,0.618481244281793
2017,27021,183,775,59,190,3,30,62,220,0.0105374077976818,0.281818181818182
2017,27023,90,367,30,95,8,10,38,105,0.0126689189189189,0.361904761904762
2017,27025,457,2245,73,298,30,44,103,342,0.00914585227576617,0.301169590643275
2017,27027,195,628,510,1335,65,71,575,1406,0.0375313651166515,0.408961593172119
2017,27029,31,164,10,83,0,25,10,108,0.017901541521631,0.0925925925925926
2017,27031,41,78,26,64,4,16,30,80,0.0190748688602766,0.375
2017,27033,67,277,53,132,3,23,56,155,0.0196501014198783,0.361290322580645
2017,27035,454,1486,162,818,7,47,169,865,0.019226494776617,0.195375722543353
2017,27037,4573,10877,2097,4177,585,1466,2682,5643,0.0202683045094553,0.475279106858054
2017,27039,140,636,36,106,4,21,40,127,0.00949745737361651,0.31496062992126
2017,27041,169,938,146,301,0,16,146,317,0.012051399026764,0.460567823343849
2017,27043,65,333,28,55,0,15,28,70,0.00697419547673608,0.4
2017,27045,76,336,45,147,3,15,48,162,0.0113010115102895,0.296296296296296
2017,27047,176,609,41,165,14,66,55,231,0.0105614484272129,0.238095238095238
2017,27049,315,1196,55,394,23,106,78,500,0.0154822727976467,0.156
2017,27051,17,116,10,56,2,3,12,59,0.013990988854636,0.203389830508475
2017,27053,10907,23011,11692,19618,3850,6323,15542,25941,0.03068462882375,0.599128792259358
2017,27055,34,186,86,281,0,7,86,288,0.0216021602160216,0.298611111111111
2017,27057,186,675,60,249,2,9,62,258,0.0170917522358397,0.24031007751938
2017,27059,296,1508,64,189,0,58,64,247,0.00941454490013722,0.259109311740891
2017,27061,255,1002,59,316,6,23,65,339,0.010428523087335,0.191740412979351
2017,27063,80,170,9,84,6,19,15,103,0.0145009151062931,0.145631067961165
2017,27065,88,483,23,94,0,11,23,105,0.00929779509430621,0.219047619047619
2017,27067,174,577,113,343,23,63,136,406,0.01416015625,0.334975369458128
2017,27069,10,68,17,47,3,14,20,61,0.0195075151902782,0.327868852459016
2017,27071,11,126,73,155,1,18,74,173,0.0183710311139429,0.427745664739884
2017,27073,28,89,13,47,4,17,17,64,0.0127439267224213,0.265625
2017,27075,91,214,65,104,0,7,65,111,0.0138403990024938,0.585585585585586
2017,27077,13,86,1,27,0,0,1,27,0.0095103909827404,0.037037037037037
2017,27079,221,807,61,272,8,48,69,320,0.0168456517161508,0.215625
2017,27081,10,135,22,105,0,0,22,105,0.0259387351778656,0.20952380952381
2017,27083,104,354,132,281,3,11,135,292,0.0176317855201981,0.462328767123288
2017,27085,165,717,54,104,1,13,55,117,0.00473320118127756,0.47008547008547
2017,27087,7,110,4,27,0,0,4,27,0.00805729632945389,0.148148148148148
2017,27089,35,138,24,108,0,15,24,123,0.0187786259541985,0.195121951219512
2017,27091,97,350,19,234,2,50,21,284,0.01997467998312,0.073943661971831
2017,27093,143,683,21,67,11,80,32,147,0.00929673665570453,0.217687074829932
2017,27095,100,964,21,91,0,21,21,112,0.00638504076164415,0.1875
2017,27097,129,704,41,120,3,46,44,166,0.00729766562623643,0.265060240963855
2017,27099,144,920,109,493,105,228,214,721,0.0271430184843579,0.296809986130374
2017,27101,39,195,26,65,1,12,27,77,0.0126853377265239,0.350649350649351
2017,27103,315,1278,103,296,11,25,114,321,0.014711274060495,0.355140186915888
2017,27105,40,160,52,185,2,49,54,234,0.0167381974248927,0.230769230769231
2017,27107,26,85,34,84,0,0,34,84,0.0183887915936953,0.404761904761905
2017,27109,798,2152,1294,2099,638,1003,1932,3102,0.030275524844084,0.622823984526112
2017,27111,256,1069,283,676,7,37,290,713,0.0173529984423676,0.406732117812062
2017,27113,62,311,56,211,0,10,56,221,0.0226829518628759,0.253393665158371
2017,27115,130,1002,70,359,0,27,70,386,0.0183442638532459,0.181347150259067
2017,27117,16,157,11,205,0,47,11,252,0.0401146131805158,0.0436507936507936
2017,27119,113,441,196,505,44,53,240,558,0.0264067010553216,0.43010752688172
2017,27121,65,374,12,80,2,7,14,87,0.0109917877447884,0.160919540229885
2017,27123,7614,17464,3723,7017,1417,2737,5140,9754,0.0274100406064268,0.526963297108878
2017,27125,20,106,5,12,0,0,5,12,0.00431965442764579,0.416666666666667
2017,27127,61,221,33,64,8,15,41,79,0.00749596735933201,0.518987341772152
2017,27129,41,301,35,70,4,12,39,82,0.00791353020652384,0.475609756097561
2017,27131,441,2350,185,465,31,137,216,602,0.0146017269816629,0.358803986710963
2017,27133,19,117,73,274,9,9,82,283,0.04421875,0.289752650176678
2017,27135,40,171,22,103,0,23,22,126,0.0120458891013384,0.174603174603175
2017,27137,694,2389,850,2008,87,176,937,2184,0.016030534351145,0.429029304029304
2017,27139,1734,4683,370,1196,47,296,417,1492,0.0165002267122303,0.279490616621984
2017,27141,735,3886,261,841,42,42,303,883,0.0148931505000928,0.343148357870895
2017,27143,51,314,1,130,2,47,3,177,0.0173325499412456,0.0169491525423729
2017,27145,796,3342,490,1212,66,355,556,1567,0.0164040827008636,0.354818123803446
2017,27147,157,836,209,459,53,59,262,518,0.0211644535240041,0.505791505791506
2017,27149,45,260,40,62,36,42,76,104,0.0180712423979149,0.730769230769231
2017,27151,60,204,33,80,0,19,33,99,0.0148648648648649,0.333333333333333
2017,27153,159,720,78,185,10,42,88,227,0.0135562854583458,0.387665198237885
2017,27155,4,55,12,36,0,3,12,39,0.0161023947151115,0.307692307692308
2017,27157,128,513,48,116,0,28,48,144,0.00941299516276638,0.333333333333333
2017,27159,51,325,17,71,0,32,17,103,0.0111351351351351,0.16504854368932
2017,27161,77,494,24,208,0,19,24,227,0.0174696013544713,0.105726872246696
2017,27163,3690,8152,1262,2553,261,622,1523,3175,0.0188724106161025,0.479685039370079
2017,27165,52,197,14,25,0,6,14,31,0.00422631220177232,0.451612903225806
2017,27167,15,74,36,174,0,3,36,177,0.0393683274021352,0.203389830508475
2017,27169,124,347,252,710,21,86,273,796,0.0254923939151321,0.342964824120603
2017,27171,936,3334,223,678,18,149,241,827,0.00983212859045083,0.291414752116082
2017,27173,40,236,22,68,0,13,22,81,0.0116984402079723,0.271604938271605
2017,28001,18,69,20,272,52,612,72,884,0.0404965871088918,0.081447963800905
2017,28003,14,757,71,785,0,0,71,785,0.0311162200729348,0.0904458598726115
2017,28005,57,144,6,12,0,0,6,12,0.00128976784178848,0.5
2017,28007,45,535,27,288,3,8,30,296,0.0238210204410108,0.101351351351351
2017,28009,2,197,8,124,0,0,8,124,0.0218733462691833,0.0645161290322581
2017,28011,138,534,143,276,17,19,160,295,0.0139572293716881,0.542372881355932
2017,28013,11,253,0,18,0,0,0,18,0.00181671376665321,0
2017,28015,14,160,45,69,19,19,64,88,0.0123249299719888,0.727272727272727
2017,28017,50,377,0,68,0,13,0,81,0.00715168638530814,0
2017,28019,45,217,0,39,0,0,0,39,0.00672993960310613,0
2017,28021,15,67,0,11,0,12,0,23,0.00432981927710843,0
2017,28023,19,132,8,141,0,26,8,167,0.015034209578682,0.0479041916167665
2017,28025,71,192,60,156,0,6,60,162,0.0120679380214541,0.37037037037037
2017,28027,36,173,50,323,0,0,50,323,0.0216851292379993,0.154798761609907
2017,28029,40,394,43,118,12,44,55,162,0.00857324301439458,0.339506172839506
2017,28031,144,425,8,34,0,37,8,71,0.00563671006668784,0.112676056338028
2017,28033,226,2354,1353,4771,67,353,1420,5124,0.0456046352252196,0.277127244340359
2017,28035,644,2727,332,916,70,168,402,1084,0.0232722900878078,0.370848708487085
2017,28037,38,86,0,39,0,41,0,80,0.0147683219494185,0
2017,28039,30,547,6,312,0,8,6,320,0.0210304942166141,0.01875
2017,28041,12,1095,2,109,0,0,2,109,0.0109879032258065,0.018348623853211
2017,28043,83,333,22,74,0,14,22,88,0.00614310645724258,0.25
2017,28045,136,788,231,1047,35,69,266,1116,0.0342793955031331,0.238351254480287
2017,28047,721,3830,1395,5305,175,566,1570,5871,0.044642314009368,0.26741611309828
2017,28049,1337,4392,714,2082,111,400,825,2482,0.0160804410783355,0.332393231265109
2017,28051,17,124,3,49,0,35,3,84,0.00752620732909237,0.0357142857142857
2017,28053,0,94,5,5,0,0,5,5,0.000903832248734635,1
2017,28055,0,149,0,10,0,0,0,10,0.00971817298347911,0
2017,28057,97,528,40,144,0,26,40,170,0.0108570698684379,0.235294117647059
2017,28059,376,1575,431,1687,47,164,478,1851,0.0194104508132255,0.258238789843328
2017,28061,50,362,0,73,0,3,0,76,0.00676096432701717,0
2017,28063,0,113,0,23,0,0,0,23,0.00464552615633205,0
2017,28065,0,202,34,66,0,0,34,66,0.00813008130081301,0.515151515151515
2017,28067,164,702,27,102,0,0,27,102,0.0022772431961778,0.264705882352941
2017,28069,22,249,4,59,0,0,4,59,0.00853341047150709,0.0677966101694915
2017,28071,350,1013,521,977,84,105,605,1082,0.0359958747796001,0.559149722735675
2017,28073,690,2906,507,1003,14,41,521,1044,0.0265669135048477,0.49904214559387
2017,28075,246,1386,395,1286,0,30,395,1316,0.0253057457118683,0.300151975683891
2017,28077,8,114,20,94,0,7,20,101,0.0119924008549038,0.198019801980198
2017,28079,30,516,87,222,9,35,96,257,0.0175882836025185,0.373540856031128
2017,28081,580,2096,280,744,71,128,351,872,0.0156264000143361,0.402522935779817
2017,28083,0,143,17,73,0,52,17,125,0.00689845474613687,0.136
2017,28085,96,356,39,145,0,14,39,159,0.00689954436971143,0.245283018867925
2017,28087,164,848,383,936,60,90,443,1026,0.0261581215103383,0.4317738791423
2017,28089,1620,3383,842,1318,67,203,909,1521,0.0226585427622268,0.597633136094675
2017,28091,102,584,28,279,6,20,34,299,0.0173867535035181,0.11371237458194
2017,28093,63,754,41,196,0,38,41,234,0.00956390239914988,0.175213675213675
2017,28095,146,626,39,92,0,33,39,125,0.00505909017322325,0.312
2017,28097,19,159,47,68,0,31,47,99,0.0138849929873773,0.474747474747475
2017,28099,83,522,23,197,0,0,23,197,0.0105857066093498,0.116751269035533
2017,28101,73,438,0,77,0,0,0,77,0.00563730873416795,0
2017,28103,0,89,16,113,0,46,16,159,0.0222036028487641,0.10062893081761
2017,28105,269,694,385,606,112,148,497,754,0.0300757877941763,0.659151193633952
2017,28107,32,583,8,82,0,14,8,96,0.00429953421712648,0.0833333333333333
2017,28109,66,484,90,1166,0,0,90,1166,0.0313188289014236,0.0771869639794168
2017,28111,33,256,96,237,0,26,96,263,0.0319756838905775,0.365019011406844
2017,28113,22,348,54,411,0,32,54,443,0.0175154198956192,0.121896162528217
2017,28115,50,795,29,361,0,10,29,371,0.018499127399651,0.078167115902965
2017,28117,149,596,42,103,0,1,42,104,0.00614693539807317,0.403846153846154
2017,28119,0,128,0,60,0,1,0,61,0.0122024404880976,0
2017,28121,1309,4879,845,1953,87,236,932,2189,0.0214664666137115,0.425765189584285
2017,28123,66,533,68,272,0,43,68,315,0.0170805769439323,0.215873015873016
2017,28125,48,80,0,3,0,0,0,3,0.000956022944550669,0
2017,28127,116,555,0,205,8,17,8,222,0.0122233234225306,0.036036036036036
2017,28129,14,124,0,9,0,25,0,34,0.00314727390539665,0
2017,28131,36,287,10,124,0,19,10,143,0.0122379118528027,0.0699300699300699
2017,28133,74,1219,28,126,6,23,34,149,0.00843428053888826,0.228187919463087
2017,28135,6,96,10,811,0,0,10,811,0.078055822906641,0.0123304562268804
2017,28137,114,788,97,324,0,12,97,336,0.0182658331068225,0.288690476190476
2017,28139,0,152,14,164,0,7,14,171,0.0118981352630114,0.0818713450292398
2017,28141,42,391,14,113,0,59,14,172,0.0126275603847001,0.0813953488372093
2017,28143,191,541,25,174,0,8,25,182,0.0272945410917816,0.137362637362637
2017,28145,74,460,31,257,0,0,31,257,0.0137337679687917,0.120622568093385
2017,28147,15,150,20,265,0,0,20,265,0.0273308580858086,0.0754716981132075
2017,28149,122,394,109,521,17,87,126,608,0.0191731575793889,0.207236842105263
2017,28151,130,469,106,587,9,65,115,652,0.0212329436284886,0.17638036809816
2017,28153,11,286,0,29,21,21,21,50,0.00366488309022942,0.42
2017,28155,12,164,40,154,0,0,40,154,0.0229473997913873,0.25974025974026
2017,28157,9,453,61,83,0,12,61,95,0.0150602409638554,0.642105263157895
2017,28159,39,496,10,47,0,6,10,53,0.004140625,0.188679245283019
2017,28161,26,137,48,207,0,12,48,219,0.0256470312682984,0.219178082191781
2017,28163,55,379,185,945,28,244,213,1189,0.0652687050557172,0.179142136248949
2017,29001,50,162,216,455,0,90,216,545,0.0405928794875614,0.396330275229358
2017,29003,125,427,68,246,3,11,71,257,0.0213579323526967,0.276264591439689
2017,29005,13,61,8,96,0,10,8,106,0.0269103833460269,0.0754716981132075
2017,29007,92,1197,20,180,0,37,20,217,0.0123379576984307,0.0921658986175115
2017,29009,127,881,90,746,0,96,90,842,0.0344813464924854,0.106888361045131
2017,29011,35,182,47,131,0,3,47,134,0.0165616116672846,0.350746268656716
2017,29013,26,306,34,236,0,2,34,238,0.0212159030130148,0.142857142857143
2017,29015,66,642,20,362,0,14,20,376,0.025827723588405,0.0531914893617021
2017,29017,50,410,0,19,0,0,0,19,0.00218717624035916,0
2017,29019,1083,2993,1419,2707,471,696,1890,3403,0.0328620816192518,0.555392300910961
2017,29021,223,2375,237,982,37,106,274,1088,0.0180332488024796,0.251838235294118
2017,29023,200,933,45,522,0,31,45,553,0.0188460620931738,0.081374321880651
2017,29025,59,343,12,61,5,5,17,66,0.0106331561140648,0.257575757575758
2017,29027,246,2370,60,477,0,42,60,519,0.0171326709140726,0.115606936416185
2017,29029,377,1296,318,1130,21,22,339,1152,0.0342245989304813,0.294270833333333
2017,29031,487,1901,313,982,80,167,393,1149,0.0229405422673002,0.342036553524804
2017,29033,47,192,0,60,0,22,0,82,0.0132793522267206,0
2017,29035,6,75,18,75,0,21,18,96,0.0226148409893993,0.1875
2017,29037,462,2169,265,1372,0,31,265,1403,0.0204650212964584,0.18888096935139
2017,29039,87,378,45,239,0,16,45,255,0.0264990127818768,0.176470588235294
2017,29041,33,161,0,2,0,6,0,8,0.00149476831091181,0
2017,29043,791,3139,360,1024,15,51,375,1075,0.0194937076125195,0.348837209302326
2017,29045,14,77,18,95,0,25,18,120,0.0253378378378378,0.15
2017,29047,1713,6805,1919,4571,298,480,2217,5051,0.0318960835575089,0.438922985547416
2017,29049,201,770,40,200,0,12,40,212,0.0150205469746351,0.188679245283019
2017,29051,667,3072,322,700,92,152,414,852,0.0162906309751434,0.485915492957746
2017,29053,62,935,43,160,0,12,43,172,0.0141435737192665,0.25
2017,29055,72,685,16,239,7,32,23,271,0.016073546856465,0.0848708487084871
2017,29057,87,365,16,109,13,27,29,136,0.0250414288344688,0.213235294117647
2017,29059,48,627,0,140,0,0,0,140,0.0123337150911814,0
2017,29061,49,217,64,139,0,4,64,143,0.0259057971014493,0.447552447552448
2017,29063,32,999,4,155,0,2,4,157,0.0166826054616938,0.0254777070063694
2017,29065,73,399,31,199,6,33,37,232,0.0211814114854378,0.15948275862069
2017,29067,10,266,20,297,0,69,20,366,0.0379825653798257,0.0546448087431694
2017,29069,98,566,10,432,16,45,26,477,0.0234501745243597,0.0545073375262055
2017,29071,410,2194,130,488,13,83,143,571,0.00812475988559883,0.250437828371278
2017,29073,107,499,74,105,0,0,74,105,0.0099131419939577,0.704761904761905
2017,29075,13,125,7,21,3,9,10,30,0.00664599025254763,0.333333333333333
2017,29077,1726,6503,1421,4590,224,668,1645,5258,0.0281871351299192,0.312856599467478
2017,29079,58,210,8,76,0,18,8,94,0.0137951276783094,0.0851063829787234
2017,29081,24,156,13,155,0,16,13,171,0.0289095519864751,0.0760233918128655
2017,29083,132,843,32,140,14,79,46,219,0.0141026466610857,0.210045662100457
2017,29085,24,318,12,116,0,0,12,116,0.0159450171821306,0.103448275862069
2017,29087,27,86,20,65,0,5,20,70,0.0208643815201192,0.285714285714286
2017,29089,72,199,21,58,0,10,21,68,0.0103453521983873,0.308823529411765
2017,29091,69,808,25,257,0,34,25,291,0.0107289016701692,0.0859106529209622
2017,29093,43,372,7,94,0,0,7,94,0.0127250575335048,0.074468085106383
2017,29095,2591,7721,5410,12479,616,1300,6026,13779,0.0296592384039675,0.437332172146019
2017,29097,243,1650,461,1757,26,66,487,1823,0.0236054280830787,0.267142073505211
2017,29099,1395,5567,225,1316,67,186,292,1502,0.00987488741181962,0.194407456724368
2017,29101,265,1502,269,894,86,491,355,1385,0.0447988096778367,0.256317689530686
2017,29103,22,80,11,62,0,2,11,64,0.0237124861059652,0.171875
2017,29105,119,725,93,396,38,61,131,457,0.0189721022915975,0.286652078774617
2017,29107,172,898,69,430,55,84,124,514,0.0227867180919449,0.24124513618677
2017,29109,198,1170,83,596,0,49,83,645,0.0252921339502784,0.128682170542636
2017,29111,11,194,0,83,0,6,0,89,0.0135960892147877,0
2017,29113,296,1349,13,123,0,4,13,127,0.00354095801037194,0.102362204724409
2017,29115,28,112,0,27,0,14,0,41,0.00487920980602166,0
2017,29117,52,722,28,141,0,5,28,146,0.0137024870952604,0.191780821917808
2017,29119,42,325,18,502,0,8,18,510,0.0341868883228315,0.0352941176470588
2017,29121,53,335,5,66,8,8,13,74,0.0070095671118689,0.175675675675676
2017,29123,42,242,26,191,0,0,26,191,0.0223391812865497,0.136125654450262
2017,29125,52,456,17,96,2,15,19,111,0.0175023651844844,0.171171171171171
2017,29127,127,575,104,338,0,0,104,338,0.017491202649555,0.307692307692308
2017,29129,16,61,12,40,0,0,12,40,0.0161030595813204,0.3
2017,29131,117,642,12,169,0,0,12,169,0.00991784037558685,0.0710059171597633
2017,29133,13,437,9,35,0,2,9,37,0.00377204608013049,0.243243243243243
2017,29135,58,1032,0,119,0,0,0,119,0.0110471593018938,0
2017,29137,65,245,13,106,0,10,13,116,0.0188036958988491,0.112068965517241
2017,29139,11,325,12,50,8,18,20,68,0.0083210964268233,0.294117647058824
2017,29141,101,755,37,328,19,46,56,374,0.0260155815247635,0.149732620320856
2017,29143,36,311,8,57,0,17,8,74,0.00594998793921364,0.108108108108108
2017,29145,429,1748,197,898,8,24,205,922,0.0236119647613194,0.22234273318872
2017,29147,75,870,128,232,18,23,146,255,0.0202831689468661,0.572549019607843
2017,29149,16,146,47,197,0,3,47,200,0.0262777558796479,0.235
2017,29151,40,190,2,49,0,6,2,55,0.00596788194444444,0.0363636363636364
2017,29153,26,270,8,85,0,0,8,85,0.0122091353059466,0.0941176470588235
2017,29155,31,212,2,309,0,42,2,351,0.0313057438458794,0.0056980056980057
2017,29157,10,241,54,339,14,29,68,368,0.0282468529321461,0.184782608695652
2017,29159,171,939,89,464,27,106,116,570,0.0203042068891818,0.203508771929825
2017,29161,223,1193,346,639,104,155,450,794,0.0285047567761623,0.566750629722922
2017,29163,93,933,42,221,1,21,43,242,0.0189670036836743,0.177685950413223
2017,29165,1117,3837,1194,2684,236,520,1430,3204,0.0487648965800648,0.446317103620474
2017,29167,122,777,147,581,0,25,147,606,0.0303257769103738,0.242574257425743
2017,29169,205,728,1906,4158,535,1024,2441,5182,0.177326078773569,0.471053647240448
2017,29171,17,40,17,98,0,0,17,98,0.0285049447353112,0.173469387755102
2017,29173,82,251,35,41,8,8,43,49,0.00676141851800745,0.877551020408163
2017,29175,81,1161,17,397,32,94,49,491,0.0286631640396964,0.09979633401222
2017,29177,99,564,62,247,0,16,62,263,0.0166920538207667,0.23574144486692
2017,29179,0,97,3,58,0,0,3,58,0.0125324114088159,0.0517241379310345
2017,29181,28,252,41,131,0,12,41,143,0.0148509710250286,0.286713286713287
2017,29183,3102,8380,1777,3382,329,507,2106,3889,0.0150247256992737,0.541527384931859
2017,29185,63,393,28,262,2,9,30,271,0.0387364208118925,0.11070110701107
2017,29186,89,472,4,108,0,0,4,108,0.00859667276924301,0.037037037037037
2017,29187,206,2529,32,1068,0,37,32,1105,0.023828520906562,0.0289592760180995
2017,29189,5900,17499,7812,13966,1546,2950,9358,16916,0.0245651791924974,0.553204067155356
2017,29195,93,387,40,249,12,86,52,335,0.0221238938053097,0.155223880597015
2017,29197,15,98,2,47,0,0,2,47,0.0161234991423671,0.0425531914893617
2017,29199,14,82,1,72,0,0,1,72,0.0231362467866324,0.0138888888888889
2017,29201,125,1097,48,602,8,54,56,656,0.0249154924228038,0.0853658536585366
2017,29203,12,201,0,102,0,0,0,102,0.0175197526623154,0
2017,29205,19,107,7,35,2,2,9,37,0.00883476599808978,0.243243243243243
2017,29207,63,764,24,252,0,37,24,289,0.0139999031148573,0.0830449826989619
2017,29209,278,1099,176,715,0,15,176,730,0.030223988738459,0.241095890410959
2017,29211,9,143,0,116,0,0,0,116,0.0261673810060907,0
2017,29213,195,1243,175,1879,13,128,188,2007,0.0538286174064637,0.0936721474838067
2017,29215,72,817,35,411,0,29,35,440,0.0246277846188291,0.0795454545454545
2017,29217,63,253,17,278,0,14,17,292,0.0211287988422576,0.0582191780821918
2017,29219,288,1138,58,265,0,31,58,296,0.0128160720471077,0.195945945945946
2017,29221,35,690,13,32,7,16,20,48,0.00278260869565217,0.416666666666667
2017,29223,21,296,33,100,0,0,33,100,0.0103982530934803,0.33
2017,29225,196,1764,92,469,0,2,92,471,0.0193389447752002,0.195329087048832
2017,29227,0,16,5,19,0,0,5,19,0.012751677852349,0.263157894736842
2017,29229,89,338,24,411,0,13,24,424,0.0341907910652367,0.0566037735849057
2017,29510,4127,9883,4232,7013,617,1202,4849,8215,0.0373169922913042,0.590261716372489
2017,30001,35,124,79,188,0,0,79,188,0.0294763248667294,0.420212765957447
2017,30003,15,126,29,95,0,0,29,95,0.0125462229265716,0.305263157894737
2017,30005,22,144,24,85,0,25,24,110,0.0273291925465838,0.218181818181818
2017,30007,89,207,17,79,0,13,17,92,0.0218527315914489,0.184782608695652
2017,30009,29,147,80,224,11,19,91,243,0.0304282494365139,0.374485596707819
2017,30011,2,8,9,12,2,2,11,14,0.0143884892086331,0.785714285714286
2017,30013,318,1445,523,1500,121,313,644,1813,0.0327664419583958,0.355212355212355
2017,30015,28,104,26,86,5,8,31,94,0.0241273100616016,0.329787234042553
2017,30017,46,194,100,283,0,12,100,295,0.0354184175771401,0.338983050847458
2017,30019,3,12,3,30,0,0,3,30,0.0232018561484919,0.1
2017,30021,76,295,30,265,0,0,30,265,0.0410470879801735,0.113207547169811
2017,30023,41,272,41,154,7,7,48,161,0.0236347621843805,0.298136645962733
2017,30025,4,56,19,36,0,0,19,36,0.0183579806221316,0.527777777777778
2017,30027,88,322,8,31,14,14,22,45,0.00542103361040838,0.488888888888889
2017,30029,439,1216,857,2544,96,180,953,2724,0.0402660753880266,0.34985315712188
2017,30031,460,1360,1418,2513,152,190,1570,2703,0.042354821523708,0.580836108028117
2017,30033,0,0,7,11,0,0,7,11,0.0145888594164456,0.636363636363636
2017,30035,27,191,87,153,29,35,116,188,0.0236597029952177,0.617021276595745
2017,30037,5,21,4,17,0,0,4,17,0.029616724738676,0.235294117647059
2017,30039,25,130,19,80,0,0,19,80,0.0332778702163062,0.2375
2017,30041,88,279,20,198,0,32,20,230,0.0224412137769539,0.0869565217391304
2017,30043,130,512,70,216,0,0,70,216,0.0256075874333136,0.324074074074074
2017,30045,21,57,1,20,0,0,1,20,0.0130463144161774,0.05
2017,30047,328,887,150,612,11,29,161,641,0.0318572635554893,0.251170046801872
2017,30049,630,1318,637,1407,53,100,690,1507,0.0324190599117995,0.457863304578633
2017,30051,6,49,14,34,3,6,17,40,0.0241545893719807,0.425
2017,30053,30,200,31,475,0,17,31,492,0.0337471705878318,0.0630081300813008
2017,30055,6,10,6,13,0,0,6,13,0.0105433901054339,0.461538461538462
2017,30057,79,204,23,93,2,84,25,177,0.028433734939759,0.141242937853107
2017,30059,40,60,6,46,0,0,6,46,0.0330935251798561,0.130434782608696
2017,30061,0,18,31,208,0,0,31,208,0.0673357073486565,0.149038461538462
2017,30063,714,1965,1211,2612,229,400,1440,3012,0.0398781940950616,0.47808764940239
2017,30065,10,160,18,124,0,0,18,124,0.0359837492745212,0.145161290322581
2017,30067,44,135,119,245,19,33,138,278,0.0231127369471234,0.496402877697842
2017,30069,8,35,0,0,0,0,0,0,0,NA
2017,30071,8,52,16,44,0,23,16,67,0.0235170235170235,0.238805970149254
2017,30073,58,116,33,93,0,0,33,93,0.0226112326768782,0.354838709677419
2017,30075,0,4,8,24,0,0,8,24,0.0195758564437194,0.333333333333333
2017,30077,49,572,13,58,0,0,13,58,0.0109640831758034,0.224137931034483
2017,30079,0,2,0,0,0,0,0,0,0,NA
2017,30081,152,726,351,1105,29,78,380,1183,0.038915753807691,0.321217244294167
2017,30083,35,220,124,501,11,11,135,512,0.0678055886637531,0.263671875
2017,30085,34,82,50,128,3,3,53,131,0.0203321434114543,0.404580152671756
2017,30087,22,140,12,36,0,0,12,36,0.00615805679096818,0.333333333333333
2017,30089,18,72,80,222,0,4,80,226,0.0260158858063773,0.353982300884956
2017,30091,3,41,9,47,0,3,9,50,0.0193723363037582,0.18
2017,30093,241,912,161,672,0,40,161,712,0.0306355148229422,0.226123595505618
2017,30095,46,201,37,134,5,5,42,139,0.0207030086386655,0.302158273381295
2017,30097,7,101,8,42,1,1,9,43,0.0161836657884833,0.209302325581395
2017,30099,32,195,3,82,0,0,3,82,0.0196313143404357,0.0365853658536585
2017,30101,15,308,135,213,4,11,139,224,0.061878453038674,0.620535714285714
2017,30103,0,5,0,6,0,0,0,6,0.0104166666666667,0
2017,30105,32,114,9,39,0,0,9,39,0.00732394366197183,0.230769230769231
2017,30107,3,14,1,5,0,0,1,5,0.00361271676300578,0.2
2017,30109,0,4,0,2,0,0,0,2,0.00246609124537608,0
2017,30111,489,2422,934,2624,190,286,1124,2910,0.0273416579755898,0.386254295532646
2017,31001,158,692,62,293,2,43,64,336,0.0164730107368731,0.19047619047619
2017,31003,37,123,1,48,0,10,1,58,0.0129464285714286,0.0172413793103448
2017,31005,3,16,0,0,0,0,0,0,0,NA
2017,31007,3,3,9,27,0,0,9,27,0.0522243713733075,0.333333333333333
2017,31009,0,19,0,0,0,0,0,0,0,NA
2017,31011,17,66,18,33,0,3,18,36,0.00970612024804529,0.5
2017,31013,0,57,7,62,0,0,7,62,0.00825126430662763,0.112903225806452
2017,31015,7,28,1,11,0,2,1,13,0.00857519788918206,0.0769230769230769
2017,31017,20,41,0,3,18,24,18,27,0.0117289313640313,0.666666666666667
2017,31019,388,1085,202,677,0,53,202,730,0.0244826776671027,0.276712328767123
2017,31021,22,122,13,49,0,0,13,49,0.0104857693130751,0.26530612244898
2017,31023,28,188,5,12,9,16,14,28,0.0050251256281407,0.5
2017,31025,269,979,75,195,13,55,88,250,0.0143769049399045,0.352
2017,31027,29,143,16,117,0,10,16,127,0.0219533275713051,0.125984251968504
2017,31029,0,56,0,95,0,23,0,118,0.0437523173896922,0
2017,31031,22,83,41,139,0,1,41,140,0.0338000965717045,0.292857142857143
2017,31033,27,74,140,273,10,10,150,283,0.0409314434480764,0.530035335689046
2017,31035,20,197,6,67,0,2,6,69,0.0160539785946952,0.0869565217391304
2017,31037,63,208,21,60,0,135,21,195,0.0299815498154982,0.107692307692308
2017,31039,20,147,2,35,0,0,2,35,0.00572737686139748,0.0571428571428571
2017,31041,10,94,16,114,10,18,26,132,0.017485759703272,0.196969696969697
2017,31043,5,191,35,470,0,16,35,486,0.0386081982840801,0.0720164609053498
2017,31045,77,144,97,265,0,0,97,265,0.0490377498149519,0.366037735849057
2017,31047,71,522,14,220,4,19,18,239,0.0156464811783961,0.0753138075313808
2017,31049,21,30,15,66,0,0,15,66,0.0483516483516484,0.227272727272727
2017,31051,4,86,15,22,2,2,17,24,0.00617760617760618,0.708333333333333
2017,31053,91,688,106,390,17,58,123,448,0.0182165656894238,0.274553571428571
2017,31055,2641,7195,4200,8733,1070,2071,5270,10804,0.0302771293335613,0.487782302850796
2017,31057,7,28,7,110,3,6,10,116,0.0851063829787234,0.0862068965517241
2017,31059,49,145,13,32,0,4,13,36,0.00888230940044412,0.361111111111111
2017,31061,13,72,13,52,0,0,13,52,0.0231832367365136,0.25
2017,31063,18,57,0,14,0,0,0,14,0.00782560089435439,0
2017,31065,15,103,0,15,4,4,4,19,0.00559646539027982,0.210526315789474
2017,31067,254,574,82,191,22,22,104,213,0.0138680903704668,0.488262910798122
2017,31069,12,28,25,57,1,1,26,58,0.0384360503644798,0.448275862068966
2017,31071,0,31,0,0,0,0,0,0,0,NA
2017,31073,5,54,16,18,0,0,16,18,0.0121293800539084,0.888888888888889
2017,31075,4,14,0,0,0,0,0,0,0,NA
2017,31077,24,72,7,26,0,4,7,30,0.0176782557454331,0.233333333333333
2017,31079,165,1038,188,636,111,244,299,880,0.0224713362784403,0.339772727272727
2017,31081,49,169,37,40,3,4,40,44,0.00707623029913155,0.909090909090909
2017,31083,9,52,10,31,0,0,10,31,0.0124099279423539,0.32258064516129
2017,31085,2,18,0,17,0,1,0,18,0.0257879656160458,0
2017,31087,4,33,16,40,0,2,16,42,0.0204678362573099,0.380952380952381
2017,31089,75,191,16,133,0,14,16,147,0.0205335940773851,0.108843537414966
2017,31091,0,13,3,17,0,0,3,17,0.0314814814814815,0.176470588235294
2017,31093,7,99,15,35,0,0,15,35,0.00790960451977401,0.428571428571429
2017,31095,50,218,9,97,0,0,9,97,0.018539755351682,0.0927835051546392
2017,31097,12,216,1,27,1,6,2,33,0.00881174899866489,0.0606060606060606
2017,31099,45,146,0,21,0,0,0,21,0.00468227424749164,0
2017,31101,56,196,62,228,7,14,69,242,0.0402863326119527,0.285123966942149
2017,31103,15,21,0,2,0,0,0,2,0.00375234521575985,0
2017,31105,22,51,9,110,6,18,15,128,0.0490045941807044,0.1171875
2017,31107,58,127,30,80,0,2,30,82,0.0139006611290049,0.365853658536585
2017,31109,942,4150,1926,4194,649,1289,2575,5483,0.0289766992035768,0.469633412365493
2017,31111,210,796,100,521,8,32,108,553,0.0226490825688073,0.195298372513562
2017,31113,0,24,9,30,0,0,9,30,0.05,0.3
2017,31115,4,10,0,13,0,0,0,13,0.0324189526184539,0
2017,31117,1,7,4,4,0,0,4,4,0.0124223602484472,1
2017,31119,152,934,170,404,6,33,176,437,0.0190804698074488,0.402745995423341
2017,31121,19,360,5,48,0,10,5,58,0.0105916727538349,0.0862068965517241
2017,31123,5,91,28,106,0,0,28,106,0.0311764705882353,0.264150943396226
2017,31125,18,68,4,28,0,0,4,28,0.011124354390147,0.142857142857143
2017,31127,30,121,33,120,0,4,33,124,0.0271216097987752,0.266129032258065
2017,31129,28,81,18,58,7,7,25,65,0.0205241553520682,0.384615384615385
2017,31131,124,370,45,203,0,0,45,203,0.0187632868102412,0.221674876847291
2017,31133,13,34,2,35,6,6,8,41,0.0206757438224912,0.195121951219512
2017,31135,2,63,3,64,4,4,7,68,0.0326139088729017,0.102941176470588
2017,31137,50,241,49,119,3,16,52,135,0.0215173732865795,0.385185185185185
2017,31139,42,183,25,53,0,0,25,53,0.0109008638420403,0.471698113207547
2017,31141,97,397,174,305,0,41,174,346,0.0161162606548978,0.502890173410405
2017,31143,8,68,10,24,3,3,13,27,0.0074318744838976,0.481481481481481
2017,31145,23,240,7,208,14,27,21,235,0.0319640914036997,0.0893617021276596
2017,31147,4,53,0,28,0,0,0,28,0.00477978832365995,0
2017,31149,4,51,8,9,0,1,8,10,0.0099009900990099,0.8
2017,31151,32,357,0,60,0,33,0,93,0.0105886371399294,0
2017,31153,1817,5007,1550,3958,335,707,1885,4665,0.0419450263898505,0.404072883172562
2017,31155,132,629,88,194,6,9,94,203,0.0142967814634833,0.463054187192118
2017,31157,94,320,96,466,8,13,104,479,0.0196722658014703,0.217118997912317
2017,31159,114,472,68,224,0,15,68,239,0.0220805617147081,0.284518828451883
2017,31161,8,77,26,103,0,0,26,103,0.0274593441748867,0.252427184466019
2017,31163,6,29,0,14,0,0,0,14,0.00632625395390872,0
2017,31165,9,18,0,4,0,0,0,4,0.0044004400440044,0
2017,31167,68,209,6,55,0,0,6,55,0.013603759584467,0.109090909090909
2017,31169,43,110,13,43,0,0,13,43,0.011596548004315,0.302325581395349
2017,31171,17,43,17,23,0,2,17,25,0.0544662309368192,0.68
2017,31173,20,112,20,66,11,12,31,78,0.0203655352480418,0.397435897435897
2017,31175,22,102,22,35,0,1,22,36,0.0117685518143184,0.611111111111111
2017,31177,87,504,64,374,6,7,70,381,0.0277494537509104,0.183727034120735
2017,31179,22,108,24,75,0,0,24,75,0.013937929752834,0.32
2017,31181,22,73,23,56,0,3,23,59,0.023440603893524,0.389830508474576
2017,31183,1,22,1,3,0,0,1,3,0.00461538461538462,0.333333333333333
2017,31185,126,417,23,141,0,9,23,150,0.0159931762448022,0.153333333333333
2017,32001,95,533,200,648,21,71,221,719,0.0440024479804162,0.307371349095967
2017,32003,756,3057,18775,63697,2938,9225,21713,72922,0.0510347337406482,0.297756506952634
2017,32005,232,881,403,1539,13,74,416,1613,0.0446814404432133,0.257904525728456
2017,32007,136,698,175,980,39,93,214,1073,0.0324404401983311,0.199440820130475
2017,32009,13,38,0,42,0,0,0,42,0.0513447432762836,0
2017,32011,37,37,19,19,0,0,19,19,0.0150197628458498,1
2017,32013,94,456,7,334,7,59,14,393,0.0358413132694938,0.0356234096692112
2017,32015,16,65,3,73,0,14,3,87,0.0223248652809854,0.0344827586206897
2017,32017,133,370,63,111,0,0,63,111,0.0304693933571232,0.567567567567568
2017,32019,192,1745,219,1585,51,74,270,1659,0.0444807893396252,0.162748643761302
2017,32021,12,106,16,67,0,0,16,67,0.0203647416413374,0.238805970149254
2017,32023,10,721,228,1526,32,44,260,1570,0.0470595288052275,0.165605095541401
2017,32027,24,495,14,29,0,0,14,29,0.00564531827915126,0.482758620689655
2017,32029,64,208,24,256,0,0,24,256,0.0793060718711276,0.09375
2017,32031,940,3642,4932,12722,724,1752,5656,14474,0.0474481148930172,0.39076965593478
2017,32033,20,414,38,90,0,5,38,95,0.0135289091426944,0.4
2017,32510,414,2374,509,1923,44,105,553,2028,0.0524518932340161,0.272682445759369
2017,33001,325,1093,479,975,5,28,484,1003,0.0225550383413164,0.482552342971087
2017,33003,323,927,575,1124,8,30,583,1154,0.0315524689670258,0.505199306759099
2017,33005,255,706,658,1278,74,123,732,1401,0.0266334619698496,0.522483940042827
2017,33007,76,625,152,552,10,17,162,569,0.0231979778212655,0.284710017574692
2017,33009,288,1050,2075,3170,377,591,2452,3761,0.0603662744972152,0.651954267482053
2017,33011,1710,4797,4134,9494,1005,1980,5139,11474,0.0404718065931585,0.447882168380687
2017,33013,1057,3592,978,2178,121,224,1099,2402,0.0229970894607843,0.457535387177352
2017,33015,1206,2924,3894,7791,299,557,4193,8348,0.0383398319991549,0.50227599425012
2017,33017,820,2319,877,1989,239,414,1116,2403,0.0293898218020376,0.464419475655431
2017,33019,173,690,211,600,4,17,215,617,0.0195624603677869,0.348460291734198
2017,34001,1241,4052,1218,3041,432,868,1650,3909,0.0208709301953079,0.422102839600921
2017,34003,5183,10010,6708,11185,3426,5317,10134,16502,0.0250155380720663,0.614107380923524
2017,34005,2752,7204,2270,5374,863,1861,3133,7235,0.0230785179986922,0.433033863165169
2017,34007,2334,8477,3003,5637,470,1839,3473,7476,0.0214628992713639,0.464553237025147
2017,34009,477,1349,606,1719,33,127,639,1846,0.0264050006436755,0.346153846153846
2017,34011,285,4284,253,919,65,500,318,1419,0.0135642797740243,0.224101479915433
2017,34013,4359,10278,4175,8053,1509,3624,5684,11677,0.0218459316465737,0.486768861865205
2017,34015,1293,4440,1071,2387,157,327,1228,2714,0.0136642147607755,0.45246868091378
2017,34017,4427,7829,10347,14151,5058,8566,15405,22717,0.0471458664093225,0.678126513183959
2017,34019,1214,2671,537,907,147,194,684,1101,0.0124343554125021,0.62125340599455
2017,34021,2963,7119,3065,5062,1637,2390,4702,7452,0.0298039466632538,0.630971551261406
2017,34023,6335,12162,4752,7690,4110,6562,8862,14252,0.0248762037083906,0.62180746561886
2017,34025,4626,9041,2818,5605,705,1759,3523,7364,0.0168833640171585,0.478408473655622
2017,34027,4713,7920,3274,4525,911,1773,4185,6298,0.0181318807867705,0.66449666560813
2017,34029,3801,10274,1665,5097,345,1004,2010,6101,0.015023874194446,0.329454187838059
2017,34031,2816,6084,1219,2802,686,2197,1905,4999,0.0148759838712077,0.381076215243049
2017,34033,120,922,165,719,20,102,185,821,0.0185201894879314,0.225334957369062
2017,34035,4361,7422,2061,2768,1191,1964,3252,4732,0.0205375704731193,0.687235841081995
2017,34037,946,2623,387,1021,84,179,471,1200,0.0118619271677672,0.3925
2017,34039,3713,8936,2434,4579,911,2523,3345,7102,0.0188361977509018,0.470994086172909
2017,34041,655,2322,362,1521,42,218,404,1739,0.0230850922607195,0.232317423806786
2017,35001,2170,7054,5955,12062,848,2218,6803,14280,0.0311644777331116,0.47640056022409
2017,35003,0,0,21,47,0,0,21,47,0.0158891142663962,0.446808510638298
2017,35005,303,885,328,1237,152,304,480,1541,0.0374156266692565,0.311486048020766
2017,35006,90,813,21,112,5,95,26,207,0.011502556123583,0.1256038647343
2017,35007,127,486,55,401,10,15,65,416,0.0451046297300228,0.15625
2017,35009,125,722,404,1634,48,199,452,1833,0.0600648818691221,0.246590289143481
2017,35011,9,44,10,31,0,0,10,31,0.0226112326768782,0.32258064516129
2017,35013,372,2144,984,3023,287,730,1271,3753,0.0292953656651757,0.338662403410605
2017,35015,103,505,266,1186,39,111,305,1297,0.0353617972626643,0.235158057054742
2017,35017,78,247,159,580,6,6,165,586,0.029055930186434,0.281569965870307
2017,35019,24,253,9,26,0,19,9,45,0.0131655939145699,0.2
2017,35021,1,6,0,2,2,5,2,7,0.0160183066361556,0.285714285714286
2017,35023,21,48,22,184,3,4,25,188,0.0603531300160514,0.132978723404255
2017,35025,125,566,219,1191,18,68,237,1259,0.0302520604560636,0.188244638602065
2017,35027,155,412,366,678,88,92,454,770,0.0525167098622289,0.58961038961039
2017,35028,165,273,272,388,118,157,390,545,0.0428998740554156,0.715596330275229
2017,35029,186,496,34,625,74,155,108,780,0.0501639976847386,0.138461538461538
2017,35031,117,529,329,927,10,80,339,1007,0.0232172088626565,0.336643495531281
2017,35033,0,64,3,3,0,0,3,3,0.000985545335085414,1
2017,35035,104,679,651,2227,145,1102,796,3329,0.0784974887405975,0.239110844097327
2017,35037,7,63,37,98,0,6,37,104,0.0180524214546086,0.355769230769231
2017,35039,151,479,35,162,11,23,46,185,0.00695384152758984,0.248648648648649
2017,35041,155,365,41,213,9,153,50,366,0.0332606324972737,0.136612021857924
2017,35043,957,3183,1197,2567,35,142,1232,2709,0.0288292698500537,0.454780361757106
2017,35045,161,882,659,1981,67,223,726,2204,0.0271081373610154,0.32940108892922
2017,35047,30,315,91,195,16,49,107,244,0.0125269534859842,0.438524590163934
2017,35049,970,2124,1981,3454,144,331,2125,3785,0.0349624511587951,0.561426684280053
2017,35051,14,240,92,206,8,8,100,214,0.0246288410634135,0.467289719626168
2017,35053,8,109,50,245,7,95,57,340,0.0310162379127896,0.167647058823529
2017,35055,129,415,387,793,23,91,410,884,0.0363711170541041,0.463800904977376
2017,35057,9,485,115,288,0,116,115,404,0.0367406329574391,0.284653465346535
2017,35059,15,228,19,92,0,0,19,92,0.030779524924724,0.206521739130435
2017,35061,100,1792,89,993,20,128,109,1121,0.0221699232655644,0.0972346119536128
2017,36001,2991,7466,1443,2573,639,1534,2082,4107,0.0200504801472419,0.506939371804237
2017,36003,111,575,93,261,73,98,166,359,0.0118360753024958,0.462395543175487
2017,36005,5621,21130,1846,5994,2226,9035,4072,15029,0.0162059751513413,0.270942843835252
2017,36007,507,2354,939,1628,245,467,1184,2095,0.0161399670267022,0.565155131264916
2017,36009,148,720,128,550,7,40,135,590,0.0110900171049416,0.228813559322034
2017,36011,482,2322,203,330,27,176,230,506,0.00912106135986733,0.454545454545455
2017,36013,294,1465,195,1032,63,258,258,1290,0.0142948959464551,0.2
2017,36015,431,1903,310,614,20,79,330,693,0.0115261792295922,0.476190476190476
2017,36017,181,707,115,345,7,52,122,397,0.011486936141894,0.307304785894207
2017,36019,211,2244,199,615,23,78,222,693,0.0125714285714286,0.32034632034632
2017,36021,402,905,206,570,47,91,253,661,0.0144591490757957,0.382753403933434
2017,36023,302,842,117,202,21,40,138,242,0.00801351038113845,0.570247933884298
2017,36025,228,963,99,405,23,41,122,446,0.013526628654616,0.273542600896861
2017,36027,2144,7367,985,2289,348,717,1333,3006,0.0147231691548137,0.443446440452428
2017,36029,2579,7688,3312,6446,1625,3083,4937,9529,0.0148225693801711,0.518102634064435
2017,36031,209,1362,221,628,96,173,317,801,0.0277489087507795,0.395755305867665
2017,36033,181,2570,92,360,14,53,106,413,0.0115163683007083,0.256658595641647
2017,36035,280,1218,149,338,29,75,178,413,0.0106853638974412,0.430992736077482
2017,36037,281,1144,35,207,5,28,40,235,0.00569835111542192,0.170212765957447
2017,36039,45,500,65,208,10,17,75,225,0.00640095587607749,0.333333333333333
2017,36041,13,117,6,61,0,2,6,63,0.017480577136515,0.0952380952380952
2017,36043,219,952,53,302,4,58,57,360,0.00818572500511608,0.158333333333333
2017,36045,466,2015,1108,3296,554,1399,1662,4695,0.0643080210387903,0.353993610223642
2017,36047,18575,31748,12817,19082,7512,15569,20329,34651,0.0193650784779991,0.58667859513434
2017,36049,66,310,70,179,0,47,70,226,0.012307357185645,0.309734513274336
2017,36051,143,1512,127,372,2,73,129,445,0.0104173982255308,0.289887640449438
2017,36053,422,1328,145,374,58,141,203,515,0.01079506152137,0.394174757281553
2017,36055,3400,7341,2876,5755,1213,3033,4089,8788,0.0172257994962414,0.465293582157488
2017,36057,146,1096,54,281,46,199,100,480,0.0140655218894684,0.208333333333333
2017,36059,9426,18663,2197,4715,1694,3628,3891,8343,0.00885195182195513,0.466379000359583
2017,36061,17262,27678,31649,36181,14973,19945,46622,56126,0.0445749747644617,0.830666714178812
2017,36063,1195,3419,435,1154,57,275,492,1429,0.00949489043334972,0.344296710986704
2017,36065,832,4095,494,1683,96,433,590,2116,0.0132318640294653,0.27882797731569
2017,36067,1690,4981,2055,3794,976,2085,3031,5879,0.0185742765699987,0.515563871406702
2017,36069,1255,2992,543,993,13,86,556,1079,0.0141315451711764,0.515291936978684
2017,36071,1537,4491,1369,2942,143,399,1512,3341,0.0138949539815427,0.452559114037713
2017,36073,115,1590,8,59,0,37,8,96,0.00323188796121734,0.0833333333333333
2017,36075,216,1997,149,655,52,105,201,760,0.00947619106993678,0.264473684210526
2017,36077,337,1011,196,403,77,92,273,495,0.0123737626237376,0.551515151515152
2017,36079,1178,2679,207,502,45,140,252,642,0.00912281698947039,0.392523364485981
2017,36081,14736,31308,6951,11979,6083,16414,13034,28393,0.0170469555276973,0.459056809777058
2017,36083,1321,4976,560,1529,267,434,827,1963,0.0177130894587717,0.421293937850229
2017,36085,1704,4702,595,1521,498,1156,1093,2677,0.00814901402105289,0.408292865147553
2017,36087,1768,3241,1083,1872,317,1017,1400,2889,0.0141169916978993,0.484596746278989
2017,36089,401,2033,364,704,110,213,474,917,0.0127129805492784,0.51690294438386
2017,36091,2247,5532,1595,3123,467,779,2062,3902,0.0243441370059581,0.528446950281907
2017,36093,1066,2649,353,820,474,627,827,1447,0.0135564320445198,0.571527297857636
2017,36095,125,607,28,280,0,5,28,285,0.0128430444774909,0.0982456140350877
2017,36097,109,501,24,104,0,32,24,136,0.0103210138878349,0.176470588235294
2017,36099,182,1840,127,297,7,39,134,336,0.0135102533172497,0.398809523809524
2017,36101,519,1540,250,689,108,159,358,848,0.0124409495026554,0.422169811320755
2017,36103,5496,12742,3269,6128,1360,3047,4629,9175,0.00890654774443498,0.504523160762943
2017,36105,430,2043,203,596,80,227,283,823,0.0154513367377591,0.343863912515188
2017,36107,220,767,122,502,27,49,149,551,0.0158460830553319,0.270417422867514
2017,36109,898,1659,1747,2105,1072,1136,2819,3241,0.0539339679158623,0.869793273680963
2017,36111,1102,4357,407,1121,78,247,485,1368,0.0105507523581086,0.35453216374269
2017,36113,440,1986,245,476,45,99,290,575,0.0120691826539608,0.504347826086956
2017,36115,425,2689,203,745,0,52,203,797,0.0178040880151904,0.254705144291092
2017,36117,497,1723,120,662,15,91,135,753,0.0117860664590149,0.179282868525896
2017,36119,8984,15911,4699,7152,2275,4478,6974,11630,0.0174075216059823,0.599656061908856
2017,36121,205,1783,103,250,9,30,112,280,0.00954979536152797,0.4
2017,36123,191,534,58,313,7,24,65,337,0.0202853187262987,0.192878338278932
2017,37001,975,2959,521,1509,243,569,764,2078,0.0195221855828941,0.367661212704524
2017,37003,165,1075,35,196,9,12,44,208,0.00783103045819058,0.211538461538462
2017,37005,19,50,10,56,0,5,10,61,0.00755324418028727,0.163934426229508
2017,37007,14,928,11,158,0,31,11,189,0.0104529616724739,0.0582010582010582
2017,37009,281,573,51,146,0,44,51,190,0.00940268223882813,0.268421052631579
2017,37011,90,1056,58,216,3,3,61,219,0.0165595463137996,0.278538812785388
2017,37013,111,502,160,325,0,48,160,373,0.0110240874833752,0.428954423592493
2017,37015,99,593,7,80,79,83,86,163,0.0111209660912874,0.52760736196319
2017,37017,25,446,28,265,3,89,31,354,0.0145805016681082,0.0875706214689266
2017,37019,837,3595,1697,4221,36,139,1733,4360,0.0457406630297944,0.397477064220183
2017,37021,1978,4567,3055,5726,213,416,3268,6142,0.0334613603552069,0.532074242917616
2017,37023,379,2065,212,691,78,165,290,856,0.0134460117495523,0.338785046728972
2017,37025,1660,4851,1281,3413,185,249,1466,3662,0.0282812681005522,0.400327689787002
2017,37027,268,1680,154,824,0,86,154,910,0.0155425370202736,0.169230769230769
2017,37029,45,298,40,135,0,0,40,135,0.0189314261674379,0.296296296296296
2017,37031,636,1733,610,1421,94,253,704,1674,0.032467028704422,0.420549581839904
2017,37033,37,441,44,321,0,0,44,321,0.0193245439768828,0.137071651090343
2017,37035,751,3530,479,1690,0,102,479,1792,0.0166897951960958,0.267299107142857
2017,37037,835,1803,687,1001,48,61,735,1062,0.0212578565995436,0.692090395480226
2017,37039,87,168,260,933,0,17,260,950,0.0453633845859994,0.273684210526316
2017,37041,53,166,39,268,0,0,39,268,0.0255432710636676,0.145522388059701
2017,37043,5,53,121,431,0,0,121,431,0.052484169508037,0.280742459396752
2017,37045,247,1173,287,944,35,62,322,1006,0.0151659053563083,0.320079522862823
2017,37047,117,1564,60,732,12,60,72,792,0.0201716628887248,0.0909090909090909
2017,37049,413,2336,748,2826,155,428,903,3254,0.0484723898050081,0.277504609711125
2017,37051,1086,4018,3389,9758,803,2539,4192,12297,0.060283548871001,0.340896153533382
2017,37053,174,359,287,817,0,42,287,859,0.0480936117798555,0.334109429569267
2017,37055,122,252,307,1086,52,113,359,1199,0.0456205768206377,0.299416180150125
2017,37057,924,3970,490,1670,0,99,490,1769,0.015459502918866,0.276992651215376
2017,37059,284,1341,117,441,26,51,143,492,0.0165606381904473,0.290650406504065
2017,37061,82,1126,29,496,0,83,29,579,0.0145371463004344,0.0500863557858377
2017,37063,4998,9160,4638,7487,1622,2547,6260,10034,0.0489793129033203,0.623878812039067
2017,37065,197,1178,12,300,0,58,12,358,0.00975025192690035,0.0335195530726257
2017,37067,2234,6750,2574,4949,352,847,2926,5796,0.0236173307852477,0.504830917874396
2017,37069,458,1856,107,430,8,115,115,545,0.0124355405467074,0.211009174311927
2017,37071,1282,4450,853,3099,13,176,866,3275,0.0222963542907717,0.264427480916031
2017,37073,0,53,28,125,0,1,28,126,0.0152229068503081,0.222222222222222
2017,37075,0,55,34,148,0,1,34,149,0.0246158929456468,0.228187919463087
2017,37077,422,1592,147,569,9,68,156,637,0.0155650580329872,0.244897959183673
2017,37079,32,1540,30,268,2,65,32,333,0.0224378411158278,0.0960960960960961
2017,37081,2630,7370,2910,6529,599,1333,3509,7862,0.0228283719903832,0.446324090562198
2017,37083,155,1246,42,423,6,23,48,446,0.0122148275956509,0.10762331838565
2017,37085,812,3949,1222,3203,93,297,1315,3500,0.0426117340540804,0.375714285714286
2017,37087,449,1316,372,1695,0,17,372,1712,0.0382049050456361,0.217289719626168
2017,37089,675,2289,1548,2918,3,82,1551,3000,0.0361615698942877,0.517
2017,37091,67,538,113,654,2,4,115,658,0.0389879717959353,0.174772036474164
2017,37093,346,2658,265,1287,109,522,374,1809,0.054226618705036,0.206744057490326
2017,37095,7,421,0,17,0,0,0,17,0.00428427419354839,0
2017,37097,1153,2928,1229,3306,326,545,1555,3851,0.0332996100201475,0.403791223058946
2017,37099,394,943,280,593,0,101,280,694,0.0259769426560862,0.403458213256484
2017,37101,1250,4461,754,2396,56,319,810,2715,0.0221323703238744,0.298342541436464
2017,37103,85,313,10,61,0,0,10,61,0.00844407530454042,0.163934426229508
2017,37105,407,1396,190,499,53,247,243,746,0.018788092479726,0.32573726541555
2017,37107,79,1103,31,396,0,127,31,523,0.0130164260826282,0.0592734225621415
2017,37109,364,1575,141,1207,0,122,141,1329,0.0233608718579715,0.106094808126411
2017,37111,164,682,55,286,0,39,55,325,0.0100507174666007,0.169230769230769
2017,37113,80,258,384,1231,9,40,393,1271,0.0496950265874257,0.309205350118017
2017,37115,218,543,93,265,8,9,101,274,0.0180572031105839,0.368613138686131
2017,37117,70,341,14,84,0,9,14,93,0.00559533120750857,0.150537634408602
2017,37119,6262,13829,16066,28883,2974,5082,19040,33965,0.0493644320292539,0.56057706462535
2017,37121,54,246,8,78,0,0,8,78,0.00696117804551539,0.102564102564103
2017,37123,63,968,17,124,10,53,27,177,0.00936012691697514,0.152542372881356
2017,37125,591,1722,1338,2064,255,366,1593,2430,0.0357579057345086,0.655555555555556
2017,37127,335,2966,206,886,0,224,206,1110,0.0172061011904762,0.185585585585586
2017,37129,1998,5219,1789,4222,236,694,2025,4916,0.0328818434166081,0.411920260374288
2017,37131,68,901,59,263,0,4,59,267,0.0177220230983672,0.220973782771536
2017,37133,746,3035,2166,7264,289,1213,2455,8477,0.083467078898396,0.289607172348708
2017,37135,2271,3989,2738,3923,1079,1364,3817,5287,0.0604028379165762,0.721959523359183
2017,37137,57,607,56,132,7,17,63,149,0.0151669381107492,0.422818791946309
2017,37139,57,1037,189,842,0,12,189,854,0.0321403033382259,0.221311475409836
2017,37141,726,2623,285,653,51,111,336,764,0.0188674585730867,0.43979057591623
2017,37143,25,139,60,337,0,3,60,340,0.0336900515259612,0.176470588235294
2017,37145,85,641,88,365,0,86,88,451,0.0163033655062719,0.195121951219512
2017,37147,760,3072,1102,2568,42,217,1144,2785,0.0263900996854035,0.410771992818671
2017,37149,92,378,195,389,10,11,205,400,0.0255623721881391,0.5125
2017,37151,400,2865,142,1026,0,60,142,1086,0.0110731582972215,0.130755064456722
2017,37153,84,895,19,167,0,8,19,175,0.00572943949711891,0.108571428571429
2017,37155,75,1426,69,573,20,129,89,702,0.00820246775098149,0.126780626780627
2017,37157,271,1228,101,802,57,175,158,977,0.0149262852341303,0.16171954964176
2017,37159,551,3378,355,1491,0,140,355,1631,0.0171543364395549,0.217657878602085
2017,37161,251,907,249,723,0,40,249,763,0.016081101017978,0.326343381389253
2017,37163,154,1905,61,456,3,123,64,579,0.0136238499729405,0.110535405872193
2017,37165,101,1145,76,374,38,82,114,456,0.0193154862758387,0.25
2017,37167,140,1344,99,351,0,64,99,415,0.00980600647432717,0.23855421686747
2017,37169,81,548,4,143,0,50,4,193,0.00574490251525525,0.0207253886010363
2017,37171,99,780,73,505,15,138,88,643,0.012669201820582,0.136858475894246
2017,37173,10,214,39,147,0,45,39,192,0.0195559177021797,0.203125
2017,37175,184,598,253,647,45,69,298,716,0.0286274039422654,0.416201117318436
2017,37177,0,449,0,35,0,0,0,35,0.0108932461873638,0
2017,37179,1784,4288,1665,4042,132,358,1797,4400,0.0312906689802798,0.408409090909091
2017,37181,92,790,78,279,52,85,130,364,0.0122402313538234,0.357142857142857
2017,37183,9301,17833,13621,22641,3255,5244,16876,27885,0.0411818306678737,0.605199928276851
2017,37185,76,795,112,269,13,13,125,282,0.0194912911252419,0.443262411347518
2017,37187,19,97,70,209,0,21,70,230,0.0270079849694692,0.304347826086957
2017,37189,400,1000,333,577,11,90,344,667,0.0221073216002121,0.515742128935532
2017,37191,534,2779,335,1761,110,453,445,2214,0.0269136792968892,0.200993676603433
2017,37193,260,1134,179,334,9,55,188,389,0.00796413070182622,0.483290488431877
2017,37195,454,1219,101,533,22,74,123,607,0.0110341568050026,0.202635914332784
2017,37197,91,633,8,156,0,1,8,157,0.00591248022896739,0.0509554140127389
2017,37199,27,313,76,270,0,3,76,273,0.0209436133486766,0.278388278388278
2017,38001,5,22,10,31,5,5,15,36,0.0213523131672598,0.416666666666667
2017,38003,20,181,48,221,0,1,48,222,0.0287267080745342,0.216216216216216
2017,38005,45,137,8,42,0,4,8,46,0.011743681388818,0.173913043478261
2017,38007,8,34,0,15,0,0,0,15,0.0210084033613445,0
2017,38009,12,155,92,143,0,2,92,145,0.0312230835486649,0.63448275862069
2017,38011,24,54,7,15,0,0,7,15,0.00677200902934537,0.466666666666667
2017,38013,15,59,4,36,0,3,4,39,0.0264945652173913,0.102564102564103
2017,38015,858,2490,546,1329,44,151,590,1480,0.0236754543127719,0.398648648648649
2017,38017,699,1738,1446,4971,237,575,1683,5546,0.0520282186948854,0.303461954561846
2017,38019,22,62,7,19,0,3,7,22,0.00793078586878154,0.318181818181818
2017,38021,19,100,19,82,0,1,19,83,0.0238300315819696,0.228915662650602
2017,38023,0,42,0,54,0,16,0,70,0.0383982446516731,0
2017,38025,24,83,6,116,12,25,18,141,0.0464579901153213,0.127659574468085
2017,38027,9,32,7,44,0,0,7,44,0.0269277845777234,0.159090909090909
2017,38029,5,10,4,6,0,15,4,21,0.008300395256917,0.19047619047619
2017,38031,12,65,19,31,0,5,19,36,0.015025041736227,0.527777777777778
2017,38033,3,3,17,50,0,18,17,68,0.0542697525937749,0.25
2017,38035,186,717,746,2230,179,252,925,2482,0.0609304038296305,0.372683319903304
2017,38037,22,60,8,61,0,0,8,61,0.0338325013865779,0.131147540983607
2017,38039,28,94,0,27,0,0,0,27,0.0161773517076093,0
2017,38041,11,124,3,52,2,5,5,57,0.0294573643410853,0.087719298245614
2017,38043,12,46,21,76,2,24,23,100,0.0573394495412844,0.23
2017,38045,10,52,25,72,0,3,25,75,0.0255275697753574,0.333333333333333
2017,38047,10,28,0,13,0,7,0,20,0.0138792505204719,0
2017,38049,17,121,11,44,0,13,11,57,0.0137250180592343,0.192982456140351
2017,38051,0,17,9,35,0,4,9,39,0.0186068702290076,0.230769230769231
2017,38053,97,206,100,555,0,0,100,555,0.0768166089965398,0.18018018018018
2017,38055,78,250,6,90,1,7,7,97,0.0138058639339596,0.0721649484536082
2017,38057,33,138,12,107,9,20,21,127,0.0207177814029364,0.165354330708661
2017,38059,322,1180,89,549,0,191,89,740,0.0351895002139902,0.12027027027027
2017,38061,88,340,20,101,0,13,20,114,0.0181124880838894,0.175438596491228
2017,38063,15,92,1,45,0,0,1,45,0.0199203187250996,0.0222222222222222
2017,38065,8,56,0,0,0,0,0,0,0,NA
2017,38067,59,165,10,69,0,35,10,104,0.0201941747572816,0.0961538461538462
2017,38069,25,236,0,45,0,12,0,57,0.0186213655668082,0
2017,38071,0,248,41,71,60,60,101,131,0.0165299684542587,0.770992366412214
2017,38073,10,77,5,46,0,9,5,55,0.0144889357218124,0.0909090909090909
2017,38075,12,54,4,31,0,0,4,31,0.0178983833718245,0.129032258064516
2017,38077,50,131,62,272,16,53,78,325,0.0307619498343587,0.24
2017,38079,27,148,0,58,0,10,0,68,0.00814566363200767,0
2017,38081,7,44,9,27,0,10,9,37,0.0130927105449398,0.243243243243243
2017,38083,0,46,7,18,0,0,7,18,0.016304347826087,0.388888888888889
2017,38085,16,40,17,56,0,2,17,58,0.0250865051903114,0.293103448275862
2017,38087,2,2,0,2,0,0,0,2,0.00397614314115308,0
2017,38089,116,444,290,1051,63,182,353,1233,0.0622067504162252,0.286293592862936
2017,38091,3,46,7,11,0,0,7,11,0.00779588944011339,0.636363636363636
2017,38093,167,564,106,332,1,39,107,371,0.0255070470952217,0.288409703504043
2017,38095,4,47,3,5,0,0,3,5,0.00304321363359708,0.6
2017,38097,53,156,15,91,0,6,15,97,0.0177104254153734,0.154639175257732
2017,38099,54,127,5,82,9,22,14,104,0.0135381411090862,0.134615384615385
2017,38101,229,1024,650,2296,135,519,785,2815,0.0653374802710983,0.27886323268206
2017,38103,11,68,14,23,0,0,14,23,0.0075187969924812,0.608695652173913
2017,38105,90,483,301,1407,21,109,322,1516,0.0714487699123386,0.212401055408971
2017,39001,10,256,8,117,0,0,8,117,0.00616373406384996,0.0683760683760684
2017,39003,421,1993,249,780,69,193,318,973,0.0140554127062087,0.326824254881809
2017,39005,207,1338,102,249,137,164,239,413,0.0117100002835351,0.578692493946731
2017,39007,165,1650,84,604,25,132,109,736,0.0107054545454545,0.148097826086957
2017,39009,279,1109,469,817,46,163,515,980,0.0270426888159166,0.525510204081633
2017,39011,326,1068,60,219,23,24,83,243,0.00785695809622349,0.34156378600823
2017,39013,191,1502,216,749,16,64,232,813,0.0160779970731321,0.285362853628536
2017,39015,128,929,99,412,0,53,99,465,0.0153602219799822,0.212903225806452
2017,39017,2736,8031,1444,3630,382,751,1826,4381,0.0182981584893682,0.416799817393289
2017,39019,90,561,51,187,0,9,51,196,0.00990249077956853,0.260204081632653
2017,39021,121,1188,100,290,0,38,100,328,0.0123150859803259,0.304878048780488
2017,39023,418,2468,302,1078,42,263,344,1341,0.0144935368120704,0.256524981357196
2017,39025,1391,4623,794,2282,79,159,873,2441,0.0177329952852462,0.357640311347808
2017,39027,146,1058,106,422,1,48,107,470,0.0168416526319561,0.227659574468085
2017,39029,126,1225,217,1587,29,61,246,1648,0.0220111925845788,0.149271844660194
2017,39031,33,772,82,222,0,24,82,246,0.00975880672802285,0.333333333333333
2017,39033,192,892,72,228,44,101,116,329,0.0111212520704459,0.35258358662614
2017,39035,4921,12911,5625,11371,2116,4655,7741,16026,0.0183269693258269,0.483027580182204
2017,39037,73,630,50,252,32,73,82,325,0.00918286618444846,0.252307692307692
2017,39039,205,667,61,172,6,45,67,217,0.00839166247728064,0.308755760368664
2017,39041,3317,5800,1402,2145,337,491,1739,2636,0.0209864256996139,0.659711684370258
2017,39043,427,1766,154,884,14,43,168,927,0.0172873580366634,0.181229773462783
2017,39045,874,4354,533,1615,9,173,542,1788,0.0175709273872581,0.303131991051454
2017,39047,108,522,52,187,69,139,121,326,0.0166607042469464,0.371165644171779
2017,39049,7957,19276,8448,17488,2985,5705,11433,23193,0.0279156596342908,0.492950459190273
2017,39051,168,652,33,205,0,30,33,235,0.00826388156275275,0.140425531914894
2017,39053,46,407,73,314,0,0,73,314,0.0152308886301901,0.232484076433121
2017,39055,811,1997,361,532,80,143,441,675,0.0105864086196892,0.653333333333333
2017,39057,1664,4370,1846,3110,307,573,2153,3683,0.0334790789844467,0.584577789845235
2017,39059,154,592,36,260,0,0,36,260,0.00950153486332408,0.138461538461538
2017,39061,3774,10472,5733,11323,1766,2672,7499,13995,0.0257527551491709,0.535834226509468
2017,39063,218,1148,161,647,33,63,194,710,0.0138296421823565,0.273239436619718
2017,39065,106,472,102,208,0,30,102,238,0.0123713483730117,0.428571428571429
2017,39067,32,212,21,202,11,22,32,224,0.0202751629254164,0.142857142857143
2017,39069,168,814,43,120,7,21,50,141,0.00751278772378517,0.354609929078014
2017,39071,73,880,32,203,14,26,46,229,0.00783361269797831,0.200873362445415
2017,39073,96,703,0,39,0,7,0,46,0.00230830991569651,0
2017,39075,47,591,0,122,0,19,0,141,0.00562200956937799,0
2017,39077,62,1285,104,585,4,25,108,610,0.0155421932327762,0.177049180327869
2017,39079,95,553,43,256,0,70,43,326,0.0146569553097743,0.131901840490798
2017,39081,103,775,248,1261,0,13,248,1274,0.0266622020383819,0.194662480376766
2017,39083,336,1297,102,506,11,45,113,551,0.0138955438428366,0.20508166969147
2017,39085,1237,3284,406,1453,82,296,488,1749,0.0106630736965322,0.279016580903373
2017,39087,59,339,75,1285,0,71,75,1356,0.0317452885403254,0.0553097345132743
2017,39089,1298,4641,473,1236,84,152,557,1388,0.0120817520281327,0.401296829971182
2017,39091,147,1042,34,340,9,37,43,377,0.0121754295310683,0.114058355437666
2017,39093,1798,6268,714,1792,133,449,847,2241,0.010704919677276,0.377956269522535
2017,39095,1601,5062,1580,4777,279,740,1859,5517,0.0189783934585258,0.336958491934022
2017,39097,398,2984,52,353,15,56,67,409,0.0131914207385906,0.163814180929095
2017,39099,419,3672,570,2326,134,379,704,2705,0.0164627837624003,0.260258780036969
2017,39101,163,2208,21,410,0,22,21,432,0.00933367902514908,0.0486111111111111
2017,39103,1514,4527,587,1206,56,141,643,1347,0.0110606570703629,0.47735708982925
2017,39105,66,344,40,202,0,14,40,216,0.0131195335276968,0.185185185185185
2017,39107,158,664,41,163,41,92,82,255,0.00947638336616002,0.32156862745098
2017,39109,721,2407,155,666,13,217,168,883,0.0122746291894296,0.190260475651189
2017,39111,1,106,27,76,0,19,27,95,0.00926738854745878,0.284210526315789
2017,39113,2693,8870,2561,6145,775,1738,3336,7883,0.0217348747825272,0.423189141189902
2017,39115,11,259,11,43,8,18,19,61,0.00583062511948002,0.311475409836066
2017,39117,76,660,40,162,22,41,62,203,0.00854053599225882,0.305418719211823
2017,39119,335,1255,37,267,38,113,75,380,0.0065311173366791,0.197368421052632
2017,39121,29,991,0,89,0,1,0,90,0.00818777292576419,0
2017,39123,364,969,117,375,3,11,120,386,0.0127962870876844,0.310880829015544
2017,39125,51,271,37,51,0,65,37,116,0.00889502338777701,0.318965517241379
2017,39127,167,971,30,149,0,27,30,176,0.0072225869993434,0.170454545454545
2017,39129,299,3540,46,288,0,84,46,372,0.0094380312063935,0.123655913978495
2017,39131,153,903,21,139,0,29,21,168,0.00866783613662161,0.125
2017,39133,1319,3875,729,1447,359,456,1088,1903,0.0183170985253918,0.571728849185497
2017,39135,76,605,30,208,11,37,41,245,0.00856673310255603,0.16734693877551
2017,39137,102,544,32,63,0,14,32,77,0.00341463414634146,0.415584415584416
2017,39139,579,3775,134,859,115,216,249,1075,0.0126830189124459,0.231627906976744
2017,39141,200,2645,50,253,12,31,62,284,0.00523994907655123,0.21830985915493
2017,39143,201,774,63,368,0,23,63,391,0.00953635277188361,0.161125319693095
2017,39145,98,1256,135,603,0,38,135,641,0.0120895494238132,0.210608424336973
2017,39147,208,1314,109,306,21,40,130,346,0.00934100051294512,0.375722543352601
2017,39149,123,582,27,254,13,51,40,305,0.00944535629122666,0.131147540983607
2017,39151,1293,4758,579,2626,242,476,821,3102,0.0119676387640384,0.264667956157318
2017,39153,3180,8529,2260,4349,542,1172,2802,5521,0.0146539688606479,0.507516754211194
2017,39155,462,2807,398,1515,37,189,435,1704,0.0117899398048848,0.255281690140845
2017,39157,309,1284,139,775,14,86,153,861,0.0134537556447958,0.177700348432056
2017,39159,982,3172,207,548,65,91,272,639,0.017513566847558,0.42566510172144
2017,39161,92,682,33,298,16,22,49,320,0.0165349041492275,0.153125
2017,39163,27,294,0,41,0,0,0,41,0.00449315068493151,0
2017,39165,3317,7458,1687,3061,801,1171,2488,4232,0.0283249335716055,0.587901701323251
2017,39167,135,535,309,896,21,103,330,999,0.0231346394330971,0.33033033033033
2017,39169,574,2513,189,507,44,53,233,560,0.00737346605572234,0.416071428571429
2017,39171,78,803,49,447,0,24,49,471,0.0183582787652011,0.104033970276008
2017,39173,987,3146,674,1109,169,331,843,1440,0.0180648074968951,0.585416666666667
2017,39175,133,597,0,171,0,11,0,182,0.0118861024033438,0
2017,40001,33,178,22,197,0,3,22,200,0.013971358714635,0.11
2017,40003,17,307,28,164,1,11,29,175,0.0404063726622027,0.165714285714286
2017,40005,25,860,27,100,0,9,27,109,0.0112813082177603,0.247706422018349
2017,40007,22,83,3,55,3,10,6,65,0.0179359823399559,0.0923076923076923
2017,40009,26,1043,11,228,0,0,11,228,0.0150733835779453,0.0482456140350877
2017,40011,42,299,1,305,0,6,1,311,0.0448838216192813,0.00321543408360129
2017,40013,90,506,336,1215,14,53,350,1268,0.0422878105719526,0.27602523659306
2017,40015,137,689,11,367,0,43,11,410,0.0211307529763439,0.0268292682926829
2017,40017,968,4123,530,2200,80,273,610,2473,0.0282257604291503,0.246663970885564
2017,40019,172,854,187,631,30,82,217,713,0.0222402445491126,0.304347826086957
2017,40021,174,821,222,434,16,36,238,470,0.015659358965816,0.506382978723404
2017,40023,9,263,21,225,0,0,21,225,0.0219812426729191,0.0933333333333333
2017,40025,0,19,9,13,0,0,9,13,0.00829081632653061,0.692307692307692
2017,40027,1776,7651,1773,3654,384,679,2157,4333,0.0250980346727061,0.497807523655666
2017,40029,22,131,0,38,0,8,0,46,0.0121148274953911,0
2017,40031,457,2623,1782,4816,453,927,2235,5743,0.0742075951984081,0.389169423646178
2017,40033,10,158,16,135,0,3,16,138,0.0336585365853659,0.115942028985507
2017,40035,49,778,29,156,0,8,29,164,0.016039119804401,0.176829268292683
2017,40037,192,1388,110,306,9,75,119,381,0.00794362320955737,0.312335958005249
2017,40039,186,737,18,237,10,21,28,258,0.01516309138995,0.108527131782946
2017,40041,188,790,205,1007,0,5,205,1012,0.0336492103075644,0.202569169960474
2017,40043,70,180,10,29,0,0,10,29,0.00900062073246431,0.344827586206897
2017,40045,28,156,9,93,0,0,9,93,0.0327004219409283,0.0967741935483871
2017,40047,164,1187,413,1409,102,276,515,1685,0.0414820285573609,0.305637982195846
2017,40049,41,371,18,86,0,16,18,102,0.00549213870342451,0.176470588235294
2017,40051,357,1400,120,470,0,26,120,496,0.0135711940461858,0.241935483870968
2017,40053,8,121,9,33,0,0,9,33,0.0107038598767434,0.272727272727273
2017,40055,18,638,21,87,0,9,21,96,0.0223776223776224,0.21875
2017,40057,4,67,7,23,0,0,7,23,0.0117767537122376,0.304347826086957
2017,40059,20,130,15,43,0,48,15,91,0.035546875,0.164835164835165
2017,40061,11,211,4,54,0,16,4,70,0.00808034168301974,0.0571428571428571
2017,40063,60,583,16,44,6,15,22,59,0.00626726152538772,0.372881355932203
2017,40065,86,583,346,728,17,113,363,841,0.0516584766584767,0.431629013079667
2017,40067,41,214,13,49,0,0,13,49,0.0114245744928888,0.26530612244898
2017,40069,41,229,61,243,5,12,66,255,0.0344827586206897,0.258823529411765
2017,40071,189,1109,199,886,21,73,220,959,0.0321974148061105,0.229405630865485
2017,40073,33,149,7,60,0,0,7,60,0.00592768227622999,0.116666666666667
2017,40075,57,243,18,196,3,9,21,205,0.0324623911322249,0.102439024390244
2017,40077,24,224,21,145,0,18,21,163,0.0227972027972028,0.128834355828221
2017,40079,42,748,75,778,6,19,81,797,0.0237209440757165,0.101631116687578
2017,40081,127,628,29,227,0,33,29,260,0.0110516024823599,0.111538461538462
2017,40083,455,1388,290,752,12,28,302,780,0.0261894369271061,0.387179487179487
2017,40085,18,119,11,92,0,18,11,110,0.0168892983264241,0.1
2017,40087,618,2040,98,254,0,2,98,256,0.0102081505702209,0.3828125
2017,40089,28,295,10,192,0,24,10,216,0.00991234913496398,0.0462962962962963
2017,40091,19,371,0,136,0,17,0,153,0.010596301682942,0
2017,40093,9,161,9,60,0,2,9,62,0.0118185284025925,0.145161290322581
2017,40095,41,441,32,334,0,4,32,338,0.0302894524598978,0.0946745562130177
2017,40097,104,781,27,304,0,24,27,328,0.0118407277715606,0.0823170731707317
2017,40099,71,324,33,113,0,0,33,113,0.0118398994132439,0.292035398230089
2017,40101,389,2654,109,750,15,49,124,799,0.0173296317182145,0.155193992490613
2017,40103,76,239,62,178,0,12,62,190,0.0243871133359004,0.326315789473684
2017,40105,33,243,7,77,0,0,7,77,0.0106870229007634,0.0909090909090909
2017,40107,43,242,9,33,0,8,9,41,0.00497029943023397,0.219512195121951
2017,40109,3869,14663,4344,12340,967,2715,5311,15055,0.0299329168638336,0.352773165061441
2017,40111,219,1142,87,338,0,21,87,359,0.0138813703503209,0.242339832869081
2017,40113,250,1711,52,461,11,26,63,487,0.0147750371651346,0.129363449691992
2017,40115,67,485,108,557,4,16,112,573,0.0277791244485383,0.195462478184991
2017,40117,53,409,11,88,4,20,15,108,0.00960683152463974,0.138888888888889
2017,40119,616,1887,360,962,319,434,679,1396,0.0322089428268192,0.486389684813754
2017,40121,144,1548,126,635,0,20,126,655,0.0208705072648483,0.19236641221374
2017,40123,132,810,54,404,9,57,63,461,0.0186217482630473,0.136659436008677
2017,40125,264,2190,72,639,0,50,72,689,0.0146548973731788,0.104499274310595
2017,40127,32,242,9,165,0,9,9,174,0.022151495862508,0.0517241379310345
2017,40129,8,64,5,55,0,0,5,55,0.0224765018389865,0.0909090909090909
2017,40131,522,2616,288,794,11,105,299,899,0.0149860807814766,0.332591768631813
2017,40133,64,763,52,213,0,3,52,216,0.0130726865581311,0.240740740740741
2017,40135,80,571,43,804,0,23,43,827,0.0292712278342123,0.0519951632406288
2017,40137,134,853,89,480,23,49,112,529,0.0174110522331567,0.2117202268431
2017,40139,31,73,60,392,9,253,69,645,0.0495239557739558,0.106976744186047
2017,40141,14,216,18,155,0,29,18,184,0.0355693021457568,0.0978260869565217
2017,40143,2571,10605,3616,10624,675,1915,4291,12539,0.030109907525916,0.34221229763139
2017,40145,627,3169,208,768,0,86,208,854,0.0165430137729307,0.243559718969555
2017,40147,235,1000,272,1010,86,175,358,1185,0.0334537857828468,0.30210970464135
2017,40149,12,222,24,127,3,8,27,135,0.0174938447583258,0.2
2017,40151,55,479,93,171,0,0,93,171,0.0296514652332235,0.543859649122807
2017,40153,149,785,25,233,0,58,25,291,0.0210671106928256,0.0859106529209622
2017,41001,120,495,115,404,0,6,115,410,0.0346635103145079,0.280487804878049
2017,41003,800,1688,1459,2071,397,494,1856,2565,0.0480247144729451,0.723586744639376
2017,41005,5156,12365,3349,6865,447,902,3796,7767,0.0277269076305221,0.488734389082014
2017,41007,198,928,373,1233,0,9,373,1242,0.0453334306675913,0.300322061191626
2017,41009,294,1578,411,1255,20,37,431,1292,0.036326828993983,0.33359133126935
2017,41011,142,833,337,1473,47,117,384,1590,0.0340471092077088,0.241509433962264
2017,41013,239,1060,70,334,0,23,70,357,0.0220057942427418,0.196078431372549
2017,41015,66,441,284,1372,0,43,284,1415,0.0792805916629314,0.200706713780919
2017,41017,1237,3088,2559,5006,329,563,2888,5569,0.0442532023775468,0.518585024241336
2017,41019,286,1786,711,2738,10,114,721,2852,0.036078431372549,0.252805049088359
2017,41021,11,33,8,13,0,0,8,13,0.00946831755280408,0.615384615384615
2017,41023,14,147,56,153,0,1,56,154,0.02792384406165,0.363636363636364
2017,41025,65,248,41,108,11,20,52,128,0.0246580620304373,0.40625
2017,41027,123,218,274,431,90,103,364,534,0.0346415828738242,0.681647940074906
2017,41029,794,3351,1926,5101,155,346,2081,5447,0.0361235642093535,0.382045162474757
2017,41031,133,1132,109,396,2,11,111,407,0.0263652264040941,0.272727272727273
2017,41033,407,1704,644,2294,39,117,683,2411,0.0388057299211331,0.283284944006636
2017,41035,275,983,333,1514,17,103,350,1617,0.0351010484728765,0.216450216450216
2017,41037,50,333,34,131,6,23,40,154,0.0264377682403433,0.25974025974026
2017,41039,1452,4207,2573,7543,560,1058,3133,8601,0.0348010099211808,0.364259969770957
2017,41041,479,1240,339,1129,9,50,348,1179,0.032558267977466,0.295165394402036
2017,41043,765,3294,496,1795,95,200,591,1995,0.0239357873014349,0.296240601503759
2017,41045,89,1090,78,739,0,57,78,796,0.0403733008723879,0.0979899497487437
2017,41047,2256,8542,1615,4451,194,937,1809,5388,0.0250009280225695,0.335746102449889
2017,41049,37,230,17,217,0,46,17,263,0.0370892680863066,0.064638783269962
2017,41051,6608,16156,12574,22050,2904,4692,15478,26742,0.0470594446204202,0.578789918480293
2017,41053,743,2982,196,1043,142,241,338,1284,0.0252180061277398,0.263239875389408
2017,41055,6,54,23,50,0,0,23,50,0.0383141762452107,0.46
2017,41057,100,614,51,308,2,3,53,311,0.0162198810889747,0.170418006430868
2017,41059,146,1664,186,898,45,78,231,976,0.0195602942060645,0.236680327868852
2017,41061,150,465,97,428,3,86,100,514,0.0299516345201329,0.194552529182879
2017,41063,57,158,45,238,0,5,45,243,0.0450834879406308,0.185185185185185
2017,41065,141,540,197,652,0,20,197,672,0.0376217668794088,0.293154761904762
2017,41067,5606,12771,7365,13505,2129,3532,9494,17037,0.0439222459975766,0.557257733168985
2017,41069,9,57,0,16,0,0,0,16,0.0144144144144144,0
2017,41071,1091,3125,825,2134,29,105,854,2239,0.0328159580237143,0.381420276909334
2017,42001,253,1371,554,1376,30,186,584,1562,0.0220431549089062,0.373879641485275
2017,42003,5276,11298,9469,15056,2942,4873,12411,19929,0.0225723074971458,0.622760800842993
2017,42005,232,1112,88,320,0,47,88,367,0.00750204415372036,0.239782016348774
2017,42007,882,2890,428,1144,62,148,490,1292,0.010591726648194,0.379256965944272
2017,42009,127,479,110,346,11,35,121,381,0.0107339061839696,0.31758530183727
2017,42011,1291,5432,1023,3043,240,834,1263,3877,0.0138474176726909,0.325767345885994
2017,42013,481,1676,178,549,25,140,203,689,0.00779835204636001,0.294629898403483
2017,42015,59,252,180,644,0,11,180,655,0.0150935570098627,0.274809160305344
2017,42017,3644,8819,3715,7367,951,1812,4666,9179,0.0206899194402745,0.508334241202745
2017,42019,1829,3949,709,1280,38,170,747,1450,0.0110769042726294,0.515172413793103
2017,42021,328,1502,252,983,31,184,283,1167,0.01203825006963,0.242502142245073
2017,42023,32,118,9,30,0,0,9,30,0.00836120401337793,0.3
2017,42025,221,1051,122,549,74,99,196,648,0.0138045631750495,0.302469135802469
2017,42027,1412,3617,1282,2064,1223,1482,2505,3546,0.0369209624855533,0.706429780033841
2017,42029,4359,8106,4254,6786,1010,1906,5264,8692,0.0250067609167228,0.605614358030373
2017,42031,149,590,90,288,6,41,96,329,0.0125185495224687,0.291793313069909
2017,42033,292,2049,90,805,61,150,151,955,0.0161645226811104,0.158115183246073
2017,42035,172,590,51,147,0,55,51,202,0.00800380378793882,0.252475247524752
2017,42037,220,772,135,383,40,67,175,450,0.0102351817313379,0.388888888888889
2017,42039,284,1301,193,665,33,80,226,745,0.0123813797344236,0.303355704697987
2017,42041,2019,8004,1870,3565,584,923,2454,4488,0.0262186287797355,0.546791443850267
2017,42043,1699,5819,1764,3926,538,1145,2302,5071,0.0268545585493984,0.453953855255374
2017,42045,3489,9163,2974,5337,948,1950,3922,7287,0.0191624986194165,0.538218745711541
2017,42047,19,189,16,115,0,23,16,138,0.00612598215474764,0.115942028985507
2017,42049,788,2465,1374,2940,184,449,1558,3389,0.0180168206611307,0.459722632044851
2017,42051,197,1869,188,713,32,82,220,795,0.00819511591707986,0.276729559748428
2017,42053,5,641,11,53,0,1,11,54,0.00889328063241107,0.203703703703704
2017,42055,362,1492,600,1879,22,121,622,2000,0.018834697279328,0.311
2017,42057,41,313,39,143,0,6,39,149,0.0142420187344676,0.261744966442953
2017,42059,96,659,41,335,2,24,43,359,0.0135323608126955,0.119777158774373
2017,42061,117,1025,64,119,86,98,150,217,0.0066615502686109,0.691244239631336
2017,42063,254,1322,213,740,63,140,276,880,0.0157283288650581,0.313636363636364
2017,42065,73,748,65,260,0,33,65,293,0.00934370814465208,0.221843003412969
2017,42067,58,470,15,109,3,76,18,185,0.0108263108614232,0.0972972972972973
2017,42069,837,2641,570,2000,192,548,762,2548,0.0170762601113844,0.299058084772371
2017,42071,2303,6367,1895,4496,316,1342,2211,5838,0.0163187495108289,0.378725590955807
2017,42073,173,937,274,814,5,52,279,866,0.0137543280073695,0.322170900692841
2017,42075,754,2535,264,876,8,468,272,1344,0.0142722127239325,0.202380952380952
2017,42077,2083,6890,1783,4441,305,1565,2088,6006,0.0244963883529992,0.347652347652348
2017,42079,876,3245,678,2266,281,774,959,3040,0.0134103842251533,0.315460526315789
2017,42081,341,1900,350,1006,66,182,416,1188,0.0147680373924718,0.35016835016835
2017,42083,75,443,91,449,12,52,103,501,0.0168584696143751,0.205588822355289
2017,42085,275,1308,385,1044,13,143,398,1187,0.0149498104510132,0.335299073294019
2017,42087,169,648,60,193,2,59,62,252,0.00775241493878053,0.246031746031746
2017,42089,624,1995,798,2661,157,461,955,3122,0.0273219739732381,0.305893657911595
2017,42091,8199,17704,5428,8985,2312,3139,7740,12124,0.0211540877430522,0.638403167271528
2017,42093,409,791,122,230,37,37,159,267,0.0198882681564246,0.595505617977528
2017,42095,1450,4635,1461,3749,301,714,1762,4463,0.0213298795146174,0.394801702890432
2017,42097,287,2043,112,580,43,118,155,698,0.0103294166395359,0.222063037249284
2017,42099,108,776,69,206,1,35,70,241,0.00744769615871937,0.29045643153527
2017,42101,7732,15133,12706,20650,4049,8947,16755,29597,0.0281341373921574,0.566104672770889
2017,42103,209,628,439,1800,24,26,463,1826,0.0452204061416543,0.253559693318729
2017,42105,36,246,51,232,0,12,51,244,0.0199803471994759,0.209016393442623
2017,42107,245,2098,96,864,20,237,116,1101,0.0104421555795823,0.10535876475931
2017,42109,53,574,77,274,9,54,86,328,0.0122064679394142,0.26219512195122
2017,42111,213,1343,50,401,12,71,62,472,0.00839066360905196,0.13135593220339
2017,42113,45,165,23,55,0,4,23,59,0.0120383595184656,0.389830508474576
2017,42115,55,563,90,503,6,27,96,530,0.0172779136104319,0.181132075471698
2017,42117,106,436,144,393,2,34,146,427,0.014576363760497,0.34192037470726
2017,42119,340,1249,194,1031,0,89,194,1120,0.0365249152100183,0.173214285714286
2017,42121,158,913,69,268,2,21,71,289,0.00753801611935627,0.245674740484429
2017,42123,103,511,104,388,12,22,116,410,0.0139185932036528,0.282926829268293
2017,42125,998,3282,707,1687,123,374,830,2061,0.0138810312777823,0.402717127607957
2017,42127,206,1305,177,829,3,19,180,848,0.0217146368943972,0.212264150943396
2017,42129,1655,5108,870,2048,92,324,962,2372,0.00906831823221317,0.405564924114671
2017,42131,88,531,22,230,7,7,29,237,0.0120567736684133,0.122362869198312
2017,42133,1280,5222,1320,4999,498,1079,1818,6078,0.019843744388543,0.299111549851925
2017,44001,561,865,504,824,44,87,548,911,0.0267602737714067,0.601536772777168
2017,44003,1448,4221,1017,1937,138,229,1155,2166,0.0180216159548711,0.533240997229917
2017,44005,326,700,2708,4010,428,536,3136,4546,0.0754309987223522,0.689837219533656
2017,44007,1258,3744,5209,10290,1407,3038,6616,13328,0.0310445869961194,0.496398559423769
2017,44009,882,1663,1032,1879,119,222,1151,2101,0.0245892046252516,0.547834364588291
2017,45001,183,697,6,170,0,10,6,180,0.0105201636469901,0.0333333333333333
2017,45003,278,1349,822,3501,65,196,887,3697,0.0321003733611183,0.239924262915878
2017,45005,22,497,47,77,0,0,47,77,0.0115338526063511,0.61038961038961
2017,45007,670,3136,763,2569,215,417,978,2986,0.0224961200596682,0.327528466175486
2017,45009,15,136,89,144,0,11,89,155,0.015653403352858,0.574193548387097
2017,45011,53,364,41,320,7,32,48,352,0.0244682330043097,0.136363636363636
2017,45013,502,1577,4415,8957,318,736,4733,9693,0.0763805711403896,0.488290518931187
2017,45015,1549,5557,1552,4789,203,547,1755,5336,0.0396366148429317,0.328898050974513
2017,45017,26,281,9,84,0,0,9,84,0.00782268578878748,0.107142857142857
2017,45019,1897,5911,6293,9741,534,911,6827,10652,0.0390230320881279,0.640912504693954
2017,45021,241,855,25,469,0,43,25,512,0.013575860423185,0.048828125
2017,45023,52,410,60,190,0,29,60,219,0.00978858445447638,0.273972602739726
2017,45025,285,831,140,571,14,84,154,655,0.0206761577069983,0.235114503816794
2017,45027,72,706,35,331,14,73,49,404,0.0168642511270663,0.121287128712871
2017,45029,219,683,87,326,0,6,87,332,0.0127412979237825,0.262048192771084
2017,45031,213,1412,204,567,25,46,229,613,0.0133078609730152,0.373572593800979
2017,45033,11,378,32,219,42,43,74,262,0.0128639465802524,0.282442748091603
2017,45035,1235,4748,1151,3374,185,508,1336,3882,0.0385245169549555,0.344152498712004
2017,45037,118,956,120,608,24,88,144,696,0.0359875904860393,0.206896551724138
2017,45039,9,193,37,132,24,57,61,189,0.0115068493150685,0.322751322751323
2017,45041,268,1804,429,1439,11,105,440,1544,0.0166697256620926,0.284974093264249
2017,45043,232,1356,523,1475,0,40,523,1515,0.0338245144005358,0.345214521452145
2017,45045,1976,6413,4316,9513,1227,2311,5543,11824,0.035743219549945,0.468792286874154
2017,45047,254,1262,346,1054,32,64,378,1118,0.0237503452085059,0.338103756708408
2017,45049,45,141,20,374,0,28,20,402,0.0288793103448276,0.0497512437810945
2017,45051,694,3030,2784,10926,242,998,3026,11924,0.052648078239177,0.253773901375377
2017,45053,144,779,220,776,0,28,220,804,0.0419602317206826,0.27363184079602
2017,45055,169,570,179,568,21,123,200,691,0.0157593449950966,0.289435600578871
2017,45057,188,877,1147,2152,18,167,1165,2319,0.0377964306087523,0.502371711944804
2017,45059,284,1998,144,655,0,55,144,710,0.0156843686489352,0.202816901408451
2017,45061,36,482,7,70,0,6,7,76,0.00613447413027686,0.0921052631578947
2017,45063,1908,6556,1202,3996,314,915,1516,4911,0.0254774096151152,0.308694766849929
2017,45065,46,439,61,162,18,22,79,184,0.0231068692703755,0.429347826086957
2017,45067,25,245,26,435,128,241,154,676,0.0311549451562356,0.227810650887574
2017,45069,50,619,4,452,0,30,4,482,0.0245880732540938,0.00829875518672199
2017,45071,71,552,66,262,16,79,82,341,0.0132160297651345,0.240469208211144
2017,45073,349,968,563,1359,25,102,588,1461,0.0268230887860762,0.402464065708419
2017,45075,300,925,126,471,25,68,151,539,0.00908263682933405,0.280148423005566
2017,45077,576,2537,734,1699,116,324,850,2023,0.0265862377122431,0.420168067226891
2017,45079,2700,8974,3706,8869,733,1453,4439,10322,0.0410874930339941,0.430052315442744
2017,45081,44,254,90,227,0,38,90,265,0.0188625524948395,0.339622641509434
2017,45083,1228,4963,1355,4225,171,566,1526,4791,0.024025514886191,0.318513880192027
2017,45085,178,1320,565,1681,126,446,691,2127,0.0305823148813803,0.324870709920075
2017,45087,142,500,4,50,0,15,4,65,0.00330183887026313,0.0615384615384615
2017,45089,40,453,13,158,98,192,111,350,0.0155210643015521,0.317142857142857
2017,45091,1066,2824,3579,7388,295,576,3874,7964,0.0474788062335309,0.486438975389252
2017,46003,1,30,4,7,0,3,4,10,0.00549752611324904,0.4
2017,46005,41,162,54,220,17,61,71,281,0.0232885794795293,0.252669039145907
2017,46007,2,47,13,22,4,4,17,26,0.0136339800734137,0.653846153846154
2017,46009,62,499,15,131,0,1,15,132,0.0258165460590651,0.113636363636364
2017,46011,169,651,220,369,91,140,311,509,0.0286051478026301,0.611001964636542
2017,46013,90,654,191,827,65,65,256,892,0.0349968612680477,0.286995515695067
2017,46015,41,116,6,25,0,0,6,25,0.00704423781346858,0.24
2017,46017,0,4,3,3,0,0,3,3,0.0029126213592233,1
2017,46019,101,338,4,118,14,19,18,137,0.0195546674279189,0.131386861313869
2017,46021,18,27,1,3,0,0,1,3,0.00274977085242896,0.333333333333333
2017,46023,22,131,21,103,0,0,21,103,0.0179223942926744,0.203883495145631
2017,46025,13,119,0,10,0,0,0,10,0.00409836065573771,0
2017,46027,31,137,159,236,61,77,220,313,0.045010066148979,0.702875399361022
2017,46029,55,495,77,285,0,49,77,334,0.0177433064173396,0.230538922155689
2017,46031,2,9,4,13,18,18,22,31,0.0134141064474254,0.709677419354839
2017,46033,39,225,61,204,27,77,88,281,0.0416975812435079,0.313167259786477
2017,46035,106,439,75,257,0,12,75,269,0.0202926976463488,0.278810408921933
2017,46037,14,142,19,95,7,11,26,106,0.0265066266566642,0.245283018867925
2017,46039,16,56,29,91,0,0,29,91,0.0301724137931034,0.318681318681319
2017,46041,1,27,3,15,0,5,3,20,0.00645994832041344,0.15
2017,46043,4,80,3,16,0,2,3,18,0.00875486381322957,0.166666666666667
2017,46045,18,52,1,18,5,5,6,23,0.00844346549192364,0.260869565217391
2017,46047,15,60,53,319,0,3,53,322,0.0622583139984532,0.164596273291925
2017,46049,13,132,9,19,0,4,9,23,0.0138221153846154,0.391304347826087
2017,46051,10,70,29,65,3,5,32,70,0.0139248060473443,0.457142857142857
2017,46053,6,67,16,84,0,8,16,92,0.0310286677908938,0.173913043478261
2017,46055,4,19,18,29,0,0,18,29,0.0201809324982603,0.620689655172414
2017,46057,59,193,4,77,0,1,4,78,0.0218609865470852,0.0512820512820513
2017,46059,39,58,3,30,0,0,3,30,0.012701100762066,0.1
2017,46061,17,78,2,49,0,0,2,49,0.0236714975845411,0.0408163265306122
2017,46063,1,36,5,26,0,0,5,26,0.029445073612684,0.192307692307692
2017,46065,80,634,137,324,0,0,137,324,0.0266622778143515,0.422839506172839
2017,46067,13,177,9,37,0,2,9,39,0.00782033286545017,0.230769230769231
2017,46069,12,31,3,4,0,0,3,4,0.0039564787339268,0.75
2017,46071,0,66,19,40,0,0,19,40,0.0211752249867655,0.475
2017,46073,6,24,22,28,0,12,22,40,0.027027027027027,0.55
2017,46075,0,0,0,21,0,0,0,21,0.0350584307178631,0
2017,46077,45,164,12,43,0,0,12,43,0.0119179600886918,0.27906976744186
2017,46079,77,235,90,291,7,11,97,302,0.0365131181235643,0.321192052980132
2017,46081,216,635,228,632,4,74,232,706,0.0410536721521196,0.328611898016997
2017,46083,711,2050,307,1203,0,25,307,1228,0.0360127862987184,0.25
2017,46085,16,59,16,45,0,0,16,45,0.0184653262207632,0.355555555555556
2017,46087,27,202,2,134,0,0,2,134,0.0368233031052487,0.0149253731343284
2017,46089,7,112,0,68,0,3,0,71,0.0407110091743119,0
2017,46091,15,111,13,72,4,9,17,81,0.0248009797917942,0.209876543209877
2017,46093,254,896,106,661,23,117,129,778,0.0440418907444099,0.165809768637532
2017,46095,0,21,0,15,0,7,0,22,0.0174188440221694,0
2017,46097,0,31,14,52,0,0,14,52,0.0334190231362468,0.269230769230769
2017,46099,922,3128,964,2773,60,420,1024,3193,0.0265554437412154,0.320701534606953
2017,46101,38,162,2,41,16,52,18,93,0.0211459754433834,0.193548387096774
2017,46102,11,117,29,102,0,0,29,102,0.0142081069786878,0.284313725490196
2017,46103,453,2080,823,2798,159,377,982,3175,0.0434015911638461,0.309291338582677
2017,46105,26,36,17,69,2,2,19,71,0.033713200379867,0.267605633802817
2017,46107,0,26,3,3,0,0,3,3,0.00175541252194266,1
2017,46109,31,136,26,122,0,8,26,130,0.0200772200772201,0.2
2017,46111,0,41,3,24,0,0,3,24,0.0142602495543672,0.125
2017,46115,9,136,26,135,0,2,26,137,0.030600848782667,0.18978102189781
2017,46117,11,79,0,0,0,0,0,0,0,NA
2017,46119,6,6,1,7,0,6,1,13,0.0138888888888889,0.0769230769230769
2017,46121,0,68,14,66,0,10,14,76,0.0155007138486641,0.184210526315789
2017,46123,36,72,8,61,0,7,8,68,0.017625712804562,0.117647058823529
2017,46125,56,249,31,88,10,13,41,101,0.0174680041508129,0.405940594059406
2017,46127,111,288,131,488,0,49,131,537,0.0527090694935218,0.243947858472998
2017,46129,39,174,28,103,35,44,63,147,0.037328593194515,0.428571428571429
2017,46135,66,440,180,601,0,16,180,617,0.0389053534270761,0.291734197730956
2017,46137,5,16,4,4,0,0,4,4,0.00254129606099111,1
2017,47001,308,1868,305,925,151,220,456,1145,0.0213324887282483,0.39825327510917
2017,47003,152,768,29,446,11,71,40,517,0.0167715564782975,0.0773694390715667
2017,47005,91,370,29,101,36,55,65,156,0.0131901581127928,0.416666666666667
2017,47007,71,651,0,120,0,59,0,179,0.0162890162890163,0
2017,47009,535,1966,475,1309,85,184,560,1493,0.0165138426484089,0.375083724045546
2017,47011,484,1501,326,1612,58,226,384,1838,0.026254892437791,0.20892274211099
2017,47013,49,376,52,565,0,22,52,587,0.0205295002273284,0.0885860306643952
2017,47015,55,549,28,154,0,13,28,167,0.0169818995322351,0.167664670658683
2017,47017,86,486,31,225,0,22,31,247,0.0127418106783596,0.125506072874494
2017,47019,324,1230,69,599,44,72,113,671,0.0162253657357031,0.168405365126677
2017,47021,287,1298,221,470,0,22,221,492,0.0180094439767195,0.449186991869919
2017,47023,0,175,28,172,5,18,33,190,0.0174905643008377,0.173684210526316
2017,47025,150,457,205,765,0,19,205,784,0.0348785479135154,0.261479591836735
2017,47027,22,277,18,50,0,0,18,50,0.00892857142857143,0.36
2017,47029,63,402,103,486,0,1,103,487,0.0192004415707302,0.211498973305955
2017,47031,128,897,191,835,72,117,263,952,0.0259252199014188,0.276260504201681
2017,47033,46,380,0,70,0,0,0,70,0.00710371422772478,0
2017,47035,117,1128,400,1292,21,91,421,1383,0.0313833166923845,0.304410701373825
2017,47037,5009,11285,9930,17216,1851,3709,11781,20925,0.0450944559141083,0.563010752688172
2017,47039,13,228,25,113,0,4,25,117,0.0139451728247914,0.213675213675214
2017,47041,108,461,21,123,0,4,21,127,0.00932246935329957,0.165354330708661
2017,47043,123,1382,180,700,0,16,180,716,0.020445459737293,0.251396648044693
2017,47045,35,651,33,174,12,68,45,242,0.00950958817981767,0.18595041322314
2017,47047,243,711,90,374,22,79,112,453,0.0158791362871565,0.247240618101545
2017,47049,25,381,69,213,0,8,69,221,0.0173537495092265,0.312217194570136
2017,47051,228,902,154,592,0,41,154,633,0.022460348437001,0.243285939968404
2017,47053,118,1001,59,307,0,34,59,341,0.0102809937288953,0.173020527859238
2017,47055,62,531,69,367,19,54,88,421,0.0205898175771507,0.209026128266033
2017,47057,60,556,78,456,18,43,96,499,0.0303011901870294,0.192384769539078
2017,47059,121,1002,160,956,16,105,176,1061,0.0215821484510079,0.165881244109331
2017,47061,14,175,4,41,0,0,4,41,0.00440292096219931,0.0975609756097561
2017,47063,182,1078,92,692,98,170,190,862,0.0197865258808677,0.220417633410673
2017,47065,1328,3173,2379,6672,350,790,2729,7462,0.0301826653938874,0.365719646207451
2017,47067,3,145,19,39,0,26,19,65,0.0136097152428811,0.292307692307692
2017,47069,30,426,3,95,0,3,3,98,0.00535138972314749,0.0306122448979592
2017,47071,8,296,52,262,0,8,52,270,0.0144756594467081,0.192592592592593
2017,47073,251,1360,142,630,0,9,142,639,0.0157894736842105,0.222222222222222
2017,47075,12,286,7,45,0,63,7,108,0.00869075400337974,0.0648148148148148
2017,47077,50,497,3,67,0,32,3,99,0.00511971867404458,0.0303030303030303
2017,47079,20,333,42,524,2,9,44,533,0.0229316353310674,0.0825515947467167
2017,47081,45,762,52,135,0,13,52,148,0.00863628406372177,0.351351351351351
2017,47083,37,247,22,147,0,0,22,147,0.0257262863143157,0.149659863945578
2017,47085,54,255,20,156,0,103,20,259,0.0200930954228084,0.0772200772200772
2017,47087,13,253,0,64,10,18,10,82,0.0095895216933692,0.121951219512195
2017,47089,216,1591,133,971,18,60,151,1031,0.0277329459866581,0.146459747817653
2017,47091,19,680,40,373,14,33,54,406,0.030098598858329,0.133004926108374
2017,47093,2259,7460,3867,8135,622,968,4489,9103,0.0302693751600257,0.493134131604965
2017,47095,69,751,0,81,0,8,0,89,0.0157077303212143,0
2017,47097,16,1291,26,194,0,24,26,218,0.0121380846325167,0.119266055045872
2017,47099,99,372,61,373,0,30,61,403,0.0140540540540541,0.15136476426799
2017,47101,79,206,37,94,0,0,37,94,0.0110199296600234,0.393617021276596
2017,47103,90,504,75,662,10,43,85,705,0.0298475867908552,0.120567375886525
2017,47105,351,1403,396,982,0,54,396,1036,0.0277443025093061,0.382239382239382
2017,47107,102,911,135,623,8,105,143,728,0.0197231177697705,0.196428571428571
2017,47109,20,225,17,367,0,26,17,393,0.0216995196289548,0.0432569974554707
2017,47111,16,497,34,252,0,0,34,252,0.0160970935803258,0.134920634920635
2017,47113,449,1730,245,708,9,31,254,739,0.0114224770854908,0.343707713125846
2017,47115,57,221,77,193,0,0,77,193,0.00954500494559842,0.398963730569948
2017,47117,68,878,60,279,5,9,65,288,0.0132286068623398,0.225694444444444
2017,47119,552,2361,449,1556,26,197,475,1753,0.0291486531426671,0.270964061608671
2017,47121,0,281,0,121,0,0,0,121,0.0141537021873903,0
2017,47123,113,866,42,863,4,19,46,882,0.02752723073562,0.0521541950113379
2017,47125,519,1777,2790,7922,532,1404,3322,9326,0.0790593580983707,0.356208449496033
2017,47127,16,185,13,14,0,7,13,21,0.00459921156373193,0.619047619047619
2017,47129,32,1313,0,196,0,15,0,211,0.013517842270485,0
2017,47131,93,688,56,334,0,0,56,334,0.015607476635514,0.167664670658683
2017,47133,31,375,50,125,0,0,50,125,0.00816246571764399,0.4
2017,47135,3,89,4,34,3,6,7,40,0.00717102904266762,0.175
2017,47137,16,186,1,80,0,0,1,80,0.020253164556962,0.0125
2017,47139,12,428,28,272,14,23,42,295,0.0243862114573861,0.142372881355932
2017,47141,192,1070,343,957,214,270,557,1227,0.0254781037812247,0.453952730236349
2017,47143,88,605,89,435,0,60,89,495,0.0224052867424071,0.17979797979798
2017,47145,228,1090,202,845,96,224,298,1069,0.0274948559670782,0.278765201122544
2017,47147,586,2160,120,688,9,80,129,768,0.0166151050342903,0.16796875
2017,47149,1625,5932,1665,5472,369,729,2034,6201,0.0334213646653013,0.328011611030479
2017,47151,13,194,16,117,0,29,16,146,0.00981380654701889,0.10958904109589
2017,47153,82,411,74,152,0,5,74,157,0.0152131782945736,0.471337579617834
2017,47155,310,2029,369,2288,49,236,418,2524,0.0374808808897997,0.165610142630745
2017,47157,1766,6147,5465,14611,967,1948,6432,16559,0.0272636268740759,0.388429252974213
2017,47159,34,382,17,80,0,0,17,80,0.00606198378419338,0.2125
2017,47161,28,498,23,207,3,33,26,240,0.0254858235106722,0.108333333333333
2017,47163,605,2722,525,3183,85,255,610,3438,0.0303313688816741,0.177428737638162
2017,47165,1445,4052,1479,3509,191,468,1670,3977,0.0333392014351701,0.419914508423435
2017,47167,231,1432,204,986,41,226,245,1212,0.0299740323976753,0.202145214521452
2017,47169,34,389,7,46,0,13,7,59,0.0098349724954159,0.11864406779661
2017,47171,44,270,46,280,0,63,46,343,0.0260420621061423,0.134110787172012
2017,47173,10,404,29,123,0,4,29,127,0.00943326153160514,0.228346456692913
2017,47175,15,159,24,57,0,9,24,66,0.0158653846153846,0.363636363636364
2017,47177,30,609,19,230,0,69,19,299,0.0109000765557216,0.0635451505016722
2017,47179,667,2443,778,1961,222,345,1000,2306,0.0267176456957479,0.433651344319167
2017,47181,18,339,6,60,20,20,26,80,0.00652368914621218,0.325
2017,47183,136,445,71,381,17,53,88,434,0.0202086049543677,0.202764976958525
2017,47185,131,580,0,194,0,10,0,204,0.0109813209883189,0
2017,47187,3901,6498,3524,5343,528,767,4052,6110,0.0444887795074925,0.663175122749591
2017,47189,1112,3370,708,2238,127,328,835,2566,0.0291461738547689,0.325409197194076
2017,48001,128,4155,39,221,0,92,39,313,0.0074749838798271,0.124600638977636
2017,48003,38,503,0,80,0,14,0,94,0.00904716073147257,0
2017,48005,549,2348,82,1002,11,60,93,1062,0.0186436809859031,0.0875706214689266
2017,48007,157,1272,134,186,10,11,144,197,0.0107897907766459,0.730964467005076
2017,48009,47,233,9,32,0,0,9,32,0.00518554529249716,0.28125
2017,48011,25,60,0,8,0,0,0,8,0.00571428571428571,0
2017,48013,150,1240,149,394,20,41,169,435,0.0142941640378549,0.388505747126437
2017,48015,254,918,70,202,1,40,71,242,0.0121406712486831,0.293388429752066
2017,48017,0,100,0,89,0,0,0,89,0.020516366989396,0
2017,48019,124,1241,28,175,0,12,28,187,0.0114745045100325,0.149732620320856
2017,48021,636,3594,181,824,98,279,279,1103,0.0207490735341146,0.252946509519492
2017,48023,15,87,0,20,0,0,0,20,0.00781555295037124,0
2017,48025,146,2426,55,217,19,63,74,280,0.0126239855725879,0.264285714285714
2017,48027,1987,7586,3027,9482,874,2546,3901,12028,0.0593828684275488,0.324326571333555
2017,48029,9253,27651,9798,23596,4022,8366,13820,31962,0.0266857919573588,0.432388461297791
2017,48031,81,297,20,144,0,40,20,184,0.0224171539961014,0.108695652173913
2017,48033,5,30,2,2,0,4,2,6,0.0143884892086331,0.333333333333333
2017,48035,124,767,10,62,0,10,10,72,0.0056066033328142,0.138888888888889
2017,48037,189,1286,373,1757,38,78,411,1835,0.0290435415710419,0.223978201634877
2017,48039,3063,10227,1521,3620,426,802,1947,4422,0.0197050042333229,0.440298507462687
2017,48041,2138,6255,1399,2424,1402,1611,2801,4035,0.0363304040913347,0.694175960346964
2017,48043,204,657,37,163,0,9,37,172,0.0255306516253525,0.215116279069767
2017,48045,0,12,12,26,0,0,12,26,0.022887323943662,0.461538461538462
2017,48047,9,267,8,116,0,163,8,279,0.0668583752695902,0.028673835125448
2017,48049,149,1061,50,120,10,50,60,170,0.00661221314663555,0.352941176470588
2017,48051,142,771,6,78,0,0,6,78,0.00634507443260392,0.0769230769230769
2017,48053,414,1739,79,393,0,101,79,494,0.0158145788648078,0.159919028340081
2017,48055,152,2184,32,235,0,42,32,277,0.0106272779589488,0.115523465703971
2017,48057,159,357,50,167,46,66,96,233,0.0161312655774024,0.412017167381974
2017,48059,46,424,31,77,0,0,31,77,0.00806536084633916,0.402597402597403
2017,48061,1110,3485,290,1540,296,1424,586,2964,0.0121851451405362,0.197705802968961
2017,48063,70,251,22,95,0,8,22,103,0.0125963067139538,0.213592233009709
2017,48065,125,239,0,105,0,0,0,105,0.025887573964497,0
2017,48067,153,479,31,178,0,13,31,191,0.00907449638920563,0.162303664921466
2017,48069,18,144,0,35,0,19,0,54,0.011397214014352,0
2017,48071,419,1097,40,478,0,7,40,485,0.0195116063885425,0.0824742268041237
2017,48073,172,1453,62,413,0,65,62,478,0.014199144486692,0.129707112970711
2017,48075,99,474,27,89,0,0,27,89,0.0186857022884736,0.303370786516854
2017,48077,73,460,9,63,0,23,9,86,0.0115498254096159,0.104651162790698
2017,48079,12,30,0,18,0,3,0,21,0.0115384615384615,0
2017,48081,34,89,2,3,0,4,2,7,0.0029093931837074,0.285714285714286
2017,48083,49,166,0,41,0,7,0,48,0.00782906540531724,0
2017,48085,12432,25181,10059,15683,3450,6079,13509,21762,0.0365792777937461,0.620760959470637
2017,48087,0,94,0,25,0,0,0,25,0.0121241513094083,0
2017,48089,126,293,0,73,0,9,0,82,0.00576936607331316,0
2017,48091,2904,6474,521,1597,181,383,702,1980,0.0221107996739215,0.354545454545455
2017,48093,77,378,26,33,0,29,26,62,0.00658523632501328,0.419354838709677
2017,48095,0,258,0,140,0,118,0,258,0.0899581589958159,0
2017,48097,257,1237,139,296,7,37,146,333,0.0127157476706889,0.438438438438438
2017,48099,510,3390,487,2469,77,724,564,3193,0.067789053543374,0.176636392107736
2017,48101,7,40,0,6,0,0,0,6,0.0056550424128181,0
2017,48103,21,127,0,17,0,0,0,17,0.00588438906195916,0
2017,48105,0,52,0,4,0,0,0,4,0.0016260162601626,0
2017,48107,4,219,3,11,0,4,3,15,0.0040290088638195,0.2
2017,48109,19,92,0,14,0,1,0,15,0.00957243139757498,0
2017,48111,24,200,34,129,4,9,38,138,0.031521242576519,0.27536231884058
2017,48113,19583,46243,15934,30783,6399,13847,22333,44630,0.027519451066186,0.500403316155053
2017,48115,154,580,11,94,0,46,11,140,0.0166587339362208,0.0785714285714286
2017,48117,52,368,13,193,0,0,13,193,0.0174124864669794,0.0673575129533679
2017,48119,52,215,0,27,0,0,0,27,0.0075187969924812,0
2017,48121,14188,30991,6710,14522,2327,3830,9037,18352,0.0362593157516221,0.492425893635571
2017,48123,56,1093,37,74,3,10,40,84,0.00582120582120582,0.476190476190476
2017,48125,5,86,7,20,0,8,7,28,0.0174237710018668,0.25
2017,48127,8,219,0,32,0,12,0,44,0.00670629477213839,0
2017,48129,11,84,17,44,0,0,17,44,0.0195555555555556,0.386363636363636
2017,48131,52,520,0,0,0,0,0,0,0,NA
2017,48133,71,637,50,113,4,48,54,161,0.0128501875648495,0.335403726708075
2017,48135,653,3704,325,1591,296,876,621,2467,0.0267759266294025,0.251722740170247
2017,48137,0,16,0,0,0,1,0,1,0.000623052959501558,0
2017,48139,1079,3807,251,839,33,281,284,1120,0.0106980476063118,0.253571428571429
2017,48141,1090,3939,3977,11844,1611,5650,5588,17494,0.0347379561913348,0.319423802446553
2017,48143,449,1240,90,330,0,47,90,377,0.0162408994959721,0.238726790450928
2017,48145,79,1060,20,63,0,9,20,72,0.00600500417014178,0.277777777777778
2017,48147,352,2556,26,388,29,91,55,479,0.0201015569264342,0.11482254697286
2017,48149,138,461,0,144,0,0,0,144,0.00801157227105819,0
2017,48151,42,120,0,1,0,3,0,4,0.001458257382428,0
2017,48153,0,92,0,18,6,6,6,24,0.00626795507965526,0.25
2017,48155,13,49,0,0,0,0,0,0,0,NA
2017,48157,7992,20007,4536,8122,3732,6867,8268,14989,0.0330797564425965,0.551604509973981
2017,48159,18,327,17,39,0,0,17,39,0.00542797494780793,0.435897435897436
2017,48161,123,1169,33,126,0,19,33,145,0.0105754503683174,0.227586206896552
2017,48163,26,716,0,48,26,651,26,699,0.0608355091383812,0.0371959942775393
2017,48165,44,414,14,284,0,130,14,414,0.0379746835443038,0.0338164251207729
2017,48167,3959,10987,1162,3381,362,826,1524,4207,0.0196535518410898,0.36225338721179
2017,48169,35,707,0,355,14,222,14,577,0.113986566574476,0.024263431542461
2017,48171,315,752,49,227,0,30,49,257,0.0135256039155834,0.190661478599222
2017,48173,39,48,0,8,0,54,0,62,0.0662393162393162,0
2017,48175,52,204,4,89,0,8,4,97,0.0186073278342605,0.0412371134020619
2017,48177,8,495,5,51,0,17,5,68,0.00515385781415795,0.0735294117647059
2017,48179,116,1234,37,158,0,17,37,175,0.01144089958159,0.211428571428571
2017,48181,651,3757,354,1711,84,174,438,1885,0.0221556182416549,0.23236074270557
2017,48183,996,4000,301,1187,148,319,449,1506,0.0189818374317801,0.298140770252324
2017,48185,158,1470,17,55,22,22,39,77,0.00410097997443545,0.506493506493506
2017,48187,1608,5200,947,2180,218,355,1165,2535,0.0258546834203655,0.45956607495069
2017,48189,201,1677,21,147,0,74,21,221,0.010535348238547,0.0950226244343891
2017,48191,10,72,0,55,0,7,0,62,0.0298220298220298,0
2017,48193,37,163,0,0,0,0,0,0,0,NA
2017,48195,1,52,0,40,0,0,0,40,0.0117370892018779,0
2017,48197,0,81,0,35,0,0,0,35,0.0125134072220236,0
2017,48199,194,1703,112,269,16,98,128,367,0.00976323490289971,0.348773841961853
2017,48201,19671,53696,22869,50434,16725,34680,39594,85114,0.0297096127425246,0.465187865686021
2017,48203,201,1163,135,420,0,71,135,491,0.0112552723271594,0.274949083503055
2017,48205,38,423,17,18,4,7,21,25,0.00576036866359447,0.84
2017,48207,27,699,8,134,7,75,15,209,0.048234479575352,0.0717703349282297
2017,48209,3243,8628,853,2354,132,643,985,2997,0.0260217238415254,0.328661995328662
2017,48211,30,109,3,102,0,0,3,102,0.0409967845659164,0.0294117647058824
2017,48213,518,2398,30,599,28,94,58,693,0.0124055708710751,0.0836940836940837
2017,48215,1189,6650,1057,4454,655,2762,1712,7216,0.0155151098162741,0.237250554323725
2017,48217,192,1314,54,324,2,47,56,371,0.0155158713562795,0.150943396226415
2017,48219,52,828,0,110,3,16,3,126,0.00880318591490254,0.0238095238095238
2017,48221,714,2033,180,438,10,108,190,546,0.0137244551692934,0.347985347985348
2017,48223,162,1068,69,226,0,33,69,259,0.0107993161822958,0.266409266409266
2017,48225,30,828,8,40,0,25,8,65,0.00390460743677539,0.123076923076923
2017,48227,81,1154,25,516,41,369,66,885,0.0357879412835133,0.0745762711864407
2017,48229,0,154,0,58,0,273,0,331,0.134826883910387,0
2017,48231,374,3002,242,911,133,323,375,1234,0.0206451181155056,0.303889789303079
2017,48233,111,586,19,158,0,4,19,162,0.0114269591592015,0.117283950617284
2017,48235,8,66,0,20,0,0,0,20,0.0190294957183635,0
2017,48237,78,830,0,14,0,32,0,46,0.00753480753480754,0
2017,48239,77,388,74,120,0,0,74,120,0.0122988623552321,0.616666666666667
2017,48241,128,1170,46,243,0,15,46,258,0.0107818964436458,0.178294573643411
2017,48243,30,58,36,38,0,13,36,51,0.0288461538461538,0.705882352941177
2017,48245,1173,7080,649,2495,246,550,895,3045,0.0180436959652044,0.293924466338259
2017,48247,0,91,0,1,0,0,0,1,0.000313479623824451,0
2017,48249,118,774,30,105,128,247,158,352,0.0136895733675573,0.448863636363636
2017,48251,1327,4321,300,1026,11,100,311,1126,0.0107945394585474,0.276198934280639
2017,48253,115,2829,0,87,0,0,0,87,0.00591595267237862,0
2017,48255,67,833,0,56,3,156,3,212,0.0206205622021204,0.0141509433962264
2017,48257,1215,5263,145,875,46,260,191,1135,0.0154036154389013,0.168281938325991
2017,48259,832,2493,304,674,0,0,304,674,0.0244583953260515,0.451038575667656
2017,48261,0,1,1,1,0,0,1,1,0.00293255131964809,1
2017,48263,7,29,0,0,0,0,0,0,0,NA
2017,48265,432,1766,149,440,49,79,198,519,0.0141582780914968,0.38150289017341
2017,48267,70,215,0,50,0,24,0,74,0.0222222222222222,0
2017,48269,3,3,0,0,0,0,0,0,0,NA
2017,48271,0,177,0,54,0,133,0,187,0.0702479338842975,0
2017,48273,265,662,176,437,34,64,210,501,0.0287848319448434,0.419161676646707
2017,48275,26,203,5,41,7,22,12,63,0.0256933115823817,0.19047619047619
2017,48277,138,998,33,436,26,42,59,478,0.0142648243755409,0.123430962343096
2017,48279,18,274,7,220,11,34,18,254,0.0300556147201515,0.0708661417322835
2017,48281,151,484,50,277,0,41,50,318,0.0224338624338624,0.157232704402516
2017,48283,14,367,13,80,0,96,13,176,0.0345504515115823,0.0738636363636364
2017,48285,118,775,6,16,3,50,9,66,0.00481400437636762,0.136363636363636
2017,48287,119,635,10,62,0,25,10,87,0.00755733148019458,0.114942528735632
2017,48289,91,687,0,92,33,47,33,139,0.0118986474918678,0.237410071942446
2017,48291,451,5999,75,551,27,51,102,602,0.0115336718076444,0.169435215946844
2017,48293,102,654,38,44,0,21,38,65,0.00405034895314058,0.584615384615385
2017,48295,24,86,4,41,0,1,4,42,0.0185348631950574,0.0952380952380952
2017,48297,94,448,71,115,11,137,82,252,0.0288494562106468,0.325396825396825
2017,48299,289,1103,46,241,34,57,80,298,0.018437171317206,0.268456375838926
2017,48301,0,0,0,5,0,0,0,5,0.078125,0
2017,48303,1947,6970,1140,3111,332,602,1472,3713,0.0212287883639025,0.396444923242661
2017,48305,97,276,0,15,0,2,0,17,0.00446311367813074,0
2017,48307,18,288,1,33,0,0,1,33,0.00565843621399177,0.0303030303030303
2017,48309,1220,4295,956,2289,152,403,1108,2692,0.0181745758477981,0.411589895988113
2017,48311,14,20,0,5,0,0,0,5,0.0124688279301746,0
2017,48313,96,1050,5,29,0,6,5,35,0.00361906731465205,0.142857142857143
2017,48315,60,255,28,122,0,0,28,122,0.0159414608650203,0.229508196721311
2017,48317,53,96,21,21,0,0,21,21,0.00644765121277249,1
2017,48319,36,136,0,0,0,0,0,0,0,NA
2017,48321,39,603,73,224,18,47,91,271,0.0113048556649424,0.335793357933579
2017,48323,43,785,26,332,59,535,85,867,0.0269212855146716,0.0980392156862745
2017,48325,574,1955,80,236,0,0,80,236,0.00729814144787704,0.338983050847458
2017,48327,5,82,0,42,0,0,0,42,0.0256410256410256,0
2017,48329,1420,4960,655,2617,251,687,906,3304,0.0331597065406116,0.274213075060533
2017,48331,156,907,89,184,0,18,89,202,0.0121745419479267,0.440594059405941
2017,48333,29,158,0,10,16,16,16,26,0.00777047220561865,0.615384615384615
2017,48335,56,890,21,93,0,27,21,120,0.0201308505284348,0.175
2017,48337,164,826,42,155,0,50,42,205,0.015072421145504,0.204878048780488
2017,48339,5708,15648,4104,7783,1456,2316,5560,10099,0.0290166963087682,0.550549559362313
2017,48341,118,502,0,108,0,68,0,176,0.0138976626658244,0
2017,48343,36,369,4,41,6,8,10,49,0.00552237123858898,0.204081632653061
2017,48345,19,70,0,21,0,0,0,21,0.0283018867924528,0
2017,48347,349,1371,141,407,21,95,162,502,0.013458805866109,0.322709163346614
2017,48349,88,1372,8,231,0,36,8,267,0.00849047603904983,0.0299625468164794
2017,48351,4,266,0,55,0,6,0,61,0.00618535793956601,0
2017,48353,63,576,1,221,0,0,1,221,0.0226504048375525,0.00452488687782805
2017,48355,2186,8050,1549,3985,303,657,1852,4642,0.0200234656728264,0.398965962947006
2017,48357,36,79,24,144,7,24,31,168,0.0271317829457364,0.18452380952381
2017,48359,10,35,0,9,0,0,0,9,0.00776531492666091,0
2017,48361,343,2062,154,779,60,135,214,914,0.0163220115004107,0.234135667396061
2017,48363,240,1026,91,288,23,29,114,317,0.0165699649783075,0.359621451104101
2017,48365,52,612,0,51,0,0,0,51,0.00321929049362454,0
2017,48367,1007,4593,401,1569,38,326,439,1895,0.0224127735068007,0.231662269129288
2017,48369,63,249,15,96,0,52,15,148,0.024370163016631,0.101351351351351
2017,48371,67,1037,0,51,0,8,0,59,0.00554980716771705,0
2017,48373,424,1961,44,204,13,279,57,483,0.0144015743335917,0.118012422360248
2017,48375,597,4177,324,1276,58,549,382,1825,0.0238658802913599,0.209315068493151
2017,48377,45,143,48,161,37,69,85,230,0.0509187513836617,0.369565217391304
2017,48379,35,450,0,45,0,43,0,88,0.0107369448511469,0
2017,48381,1077,4707,400,1495,54,109,454,1604,0.018767477505938,0.283042394014963
2017,48383,10,71,18,68,0,43,18,111,0.0471938775510204,0.162162162162162
2017,48385,49,207,0,11,0,0,0,11,0.00454921422663358,0
2017,48387,46,341,13,64,0,10,13,74,0.00832583258325833,0.175675675675676
2017,48389,47,663,16,354,0,259,16,613,0.0627238309628568,0.0261011419249592
2017,48391,7,297,0,12,0,2,0,14,0.00283630470016207,0
2017,48393,15,74,0,0,0,0,0,0,0,NA
2017,48395,217,678,0,24,0,32,0,56,0.00496541940060294,0
2017,48397,1481,3530,654,1198,110,216,764,1414,0.0242521953896817,0.54031117397454
2017,48399,40,152,14,28,0,15,14,43,0.00614900614900615,0.325581395348837
2017,48401,416,4969,3,214,0,61,3,275,0.00760088446655611,0.0109090909090909
2017,48403,2,207,33,134,0,0,33,134,0.0166666666666667,0.246268656716418
2017,48405,31,257,10,22,33,51,43,73,0.0118892508143322,0.589041095890411
2017,48407,263,1162,2,271,0,58,2,329,0.0172053132517519,0.0060790273556231
2017,48409,243,2224,165,642,29,233,194,875,0.0206348457692671,0.221714285714286
2017,48411,19,496,0,67,0,4,0,71,0.0170714113969704,0
2017,48413,24,24,0,4,0,0,0,4,0.00203769740193581,0
2017,48415,159,829,17,81,0,0,17,81,0.00724248927038627,0.209876543209877
2017,48417,0,99,2,7,0,0,2,7,0.00313620071684588,0.285714285714286
2017,48419,275,662,16,224,0,7,16,231,0.0140870837907062,0.0692640692640693
2017,48421,7,45,0,4,0,0,0,4,0.00192585459797785,0
2017,48423,1623,5306,774,2450,198,548,972,2998,0.0207280395478273,0.324216144096064
2017,48425,18,332,23,40,0,0,23,40,0.00669456066945607,0.575
2017,48427,7,550,0,105,19,442,19,547,0.0156379542010921,0.0347349177330896
2017,48429,83,436,13,36,8,29,21,65,0.0101010101010101,0.323076923076923
2017,48431,17,51,0,0,0,0,0,0,0,NA
2017,48433,0,39,0,5,2,6,2,11,0.0138713745271122,0.181818181818182
2017,48435,14,155,0,37,0,4,0,41,0.0153385708941264,0
2017,48437,15,422,9,63,0,5,9,68,0.0135081446166071,0.132352941176471
2017,48439,12815,37030,11003,25882,3389,8762,14392,34644,0.0274173163414138,0.415425470499942
2017,48441,783,2896,638,1845,93,405,731,2250,0.0273922571219869,0.324888888888889
2017,48443,0,12,0,0,0,5,0,5,0.0089126559714795,0
2017,48445,64,919,41,99,14,41,55,140,0.0171715932785478,0.392857142857143
2017,48447,2,29,6,16,0,2,6,18,0.0161290322580645,0.333333333333333
2017,48449,141,496,30,379,0,22,30,401,0.0202658311012281,0.0748129675810474
2017,48451,684,2334,857,2270,143,276,1000,2546,0.0340857364714703,0.392772977219167
2017,48453,12672,27297,15774,24115,4777,7930,20551,32045,0.0402968727011165,0.64131689811203
2017,48455,98,560,14,128,0,0,14,128,0.0120766110010378,0.109375
2017,48457,85,883,8,236,0,0,8,236,0.015685231955337,0.0338983050847458
2017,48459,421,1620,37,391,30,30,67,421,0.0153258099745177,0.159144893111639
2017,48461,18,78,0,18,0,7,0,25,0.0112410071942446,0
2017,48463,53,361,0,243,0,90,0,333,0.0199652257329576,0
2017,48465,208,649,143,479,90,582,233,1061,0.0362289148398552,0.219604147031103
2017,48467,362,1880,109,451,0,19,109,470,0.0126913833607863,0.231914893617021
2017,48469,463,1887,210,654,64,172,274,826,0.0139378701719454,0.331719128329298
2017,48471,409,3458,174,453,170,178,344,631,0.0137185842247152,0.545166402535658
2017,48473,333,1326,47,131,53,74,100,205,0.00785199938716102,0.48780487804878
2017,48475,144,390,10,138,0,0,10,138,0.0191321225564952,0.072463768115942
2017,48477,298,888,9,95,12,90,21,185,0.00796555435952637,0.113513513513514
2017,48479,253,1141,232,821,410,1829,642,2650,0.0179867101967678,0.242264150943396
2017,48481,118,718,25,70,18,84,43,154,0.00573984345881476,0.279220779220779
2017,48483,28,160,6,108,0,0,6,108,0.0288153681963714,0.0555555555555556
2017,48485,400,3569,504,2243,184,366,688,2609,0.031079503490339,0.263702568033729
2017,48487,34,300,23,110,8,8,31,118,0.0134595642751226,0.26271186440678
2017,48489,28,699,0,99,0,192,0,291,0.0214080776870448,0
2017,48491,9062,20454,5265,10536,885,2547,6150,13083,0.0393769751693002,0.470075670717725
2017,48493,229,1212,0,217,43,95,43,312,0.00986374126647909,0.137820512820513
2017,48495,46,176,29,121,17,54,46,175,0.0381263616557734,0.262857142857143
2017,48497,740,2709,94,397,0,112,94,509,0.0120350885489324,0.18467583497053
2017,48499,263,1748,36,469,0,126,36,595,0.0189068954559898,0.0605042016806723
2017,48501,0,80,0,19,0,35,0,54,0.0110723805618208,0
2017,48503,32,259,32,46,0,26,32,72,0.00588668138337013,0.444444444444444
2017,48505,12,101,19,19,29,29,48,48,0.00597460791635549,1
2017,48507,14,145,4,73,0,46,4,119,0.0171321623956234,0.0336134453781513
2017,49001,15,126,12,77,0,10,12,87,0.0228947368421053,0.137931034482759
2017,49003,317,1195,171,751,40,92,211,843,0.0275859812166628,0.250296559905101
2017,49005,498,1493,478,1226,159,324,637,1550,0.0257852009582113,0.410967741935484
2017,49007,84,461,14,231,4,4,18,235,0.0179471513670383,0.0765957446808511
2017,49009,0,24,0,0,0,0,0,0,0,NA
2017,49011,2727,7633,1930,4480,596,1088,2526,5568,0.0288104810543146,0.453663793103448
2017,49013,70,481,16,100,3,10,19,110,0.00949421715863974,0.172727272727273
2017,49015,34,207,18,89,0,0,18,89,0.0140025173064821,0.202247191011236
2017,49017,45,114,45,68,0,0,45,68,0.0201481481481481,0.661764705882353
2017,49019,0,7,53,74,0,0,53,74,0.011287370347773,0.716216216216216
2017,49021,219,1013,263,1132,18,48,281,1180,0.04384661117717,0.238135593220339
2017,49023,10,295,6,126,0,0,6,126,0.021049114600735,0.0476190476190476
2017,49025,35,119,89,321,11,11,100,332,0.0660171008152714,0.301204819277108
2017,49027,54,222,6,146,4,19,10,165,0.0215320370612032,0.0606060606060606
2017,49029,32,164,80,159,0,0,80,159,0.0256121134020619,0.50314465408805
2017,49031,13,23,0,37,0,0,0,37,0.0272259013980868,0
2017,49033,0,4,0,21,0,0,0,21,0.0150862068965517,0
2017,49035,5301,11714,9586,19065,2238,4219,11824,23284,0.0337546136427555,0.507816526370039
2017,49037,25,130,34,236,6,10,40,246,0.0279133098831272,0.16260162601626
2017,49039,172,1590,78,268,11,32,89,300,0.017950098725543,0.296666666666667
2017,49041,129,536,59,226,0,23,59,249,0.0193428105336751,0.236947791164659
2017,49043,443,739,670,919,52,110,722,1029,0.0390112598096827,0.701652089407191
2017,49045,368,1910,218,752,73,73,291,825,0.0228519195612431,0.352727272727273
2017,49047,59,618,79,720,34,97,113,817,0.0393753915851366,0.138310893512852
2017,49049,2496,6608,3800,8131,752,1762,4552,9893,0.0352318578902196,0.460123319518852
2017,49051,567,1029,490,811,54,106,544,917,0.05283475455174,0.593238822246456
2017,49053,982,3643,1243,4630,111,268,1354,4898,0.0497809759022675,0.276439363005308
2017,49055,0,30,0,35,0,37,0,72,0.0401114206128134,0
2017,49057,1419,5778,1013,3108,102,613,1115,3721,0.0248766529837276,0.299650631550658
2017,50001,199,766,203,527,28,80,231,607,0.024080612528266,0.380560131795717
2017,50003,136,362,313,775,2,12,315,787,0.0306523855890945,0.400254129606099
2017,50005,141,642,215,510,15,19,230,529,0.024562381018712,0.434782608695652
2017,50007,644,1744,1982,2821,230,557,2212,3378,0.032092267644572,0.654825340438129
2017,50009,17,129,16,106,0,1,16,107,0.0227321011259826,0.149532710280374
2017,50011,204,740,171,412,3,52,174,464,0.0137051039697543,0.375
2017,50013,71,128,47,73,9,9,56,82,0.0157148332694519,0.682926829268293
2017,50015,142,410,188,503,32,85,220,588,0.0337388111085609,0.374149659863946
2017,50017,201,443,248,510,17,45,265,555,0.0264411624583135,0.477477477477477
2017,50019,59,246,219,408,21,30,240,438,0.0223583460949464,0.547945205479452
2017,50021,100,318,447,915,41,97,488,1012,0.0234498099916582,0.482213438735178
2017,50023,324,816,659,1048,48,94,707,1142,0.0272990223029666,0.619089316987741
2017,50025,197,461,416,936,24,58,440,994,0.0312195734790666,0.442655935613682
2017,50027,225,791,627,1201,145,158,772,1359,0.0326643432279774,0.568064753495217
2017,51001,49,140,148,446,4,31,152,477,0.0202478988029544,0.318658280922432
2017,51003,1521,3263,1655,2150,411,533,2066,2683,0.0378885232937455,0.770033544539694
2017,51005,6,158,127,220,0,0,127,220,0.0193236714975845,0.577272727272727
2017,51007,38,280,0,20,17,26,17,46,0.00513278286096853,0.369565217391304
2017,51009,115,1002,83,319,0,71,83,390,0.0173696165323119,0.212820512820513
2017,51011,5,48,22,133,9,30,31,163,0.0147993462865444,0.190184049079755
2017,51013,4705,6100,9752,11083,2790,3580,12542,14663,0.0853144818758364,0.85535020118666
2017,51015,571,2299,216,662,69,144,285,806,0.0149544501549251,0.353598014888337
2017,51017,1,69,24,112,0,0,24,112,0.0343663700521632,0.214285714285714
2017,51019,623,2263,383,810,53,154,436,964,0.017365301821195,0.452282157676349
2017,51021,31,540,8,90,0,0,8,90,0.0179425837320574,0.0888888888888889
2017,51023,192,755,73,310,0,22,73,332,0.0137570960924875,0.219879518072289
2017,51025,44,594,2,94,0,11,2,105,0.00882427094713841,0.019047619047619
2017,51027,0,245,90,223,0,0,90,223,0.013147809681033,0.403587443946188
2017,51029,63,800,18,120,0,4,18,124,0.00994147358293915,0.145161290322581
2017,51031,288,1364,182,388,0,42,182,430,0.0109231316364375,0.423255813953488
2017,51033,200,1324,276,545,0,0,276,545,0.0267130673463386,0.506422018348624
2017,51035,32,360,50,241,0,79,50,320,0.0146065364250502,0.15625
2017,51036,58,180,7,38,0,0,7,38,0.00701365817644887,0.184210526315789
2017,51037,11,245,19,104,0,0,19,104,0.0122670441141779,0.182692307692308
2017,51041,3022,8091,2269,4380,477,959,2746,5339,0.0238448277402124,0.514328525941187
2017,51043,177,462,20,202,0,9,20,211,0.0205994337596407,0.0947867298578199
2017,51045,0,164,0,73,0,0,0,73,0.0189561152947286,0
2017,51047,295,1636,264,704,14,52,278,756,0.0227402616934877,0.367724867724868
2017,51049,2,114,17,65,0,52,17,117,0.0168466522678186,0.145299145299145
2017,51051,8,203,8,41,0,0,8,41,0.00370772291553626,0.195121951219512
2017,51053,66,824,7,84,0,37,7,121,0.00612348178137652,0.0578512396694215
2017,51057,71,322,18,52,0,16,18,68,0.00876288659793814,0.264705882352941
2017,51059,13555,21186,17640,24747,6963,11998,24603,36745,0.0472799702513835,0.669560484419649
2017,51061,894,2126,289,731,30,93,319,824,0.0176181312807355,0.387135922330097
2017,51063,130,325,49,157,0,31,49,188,0.016400593212946,0.26063829787234
2017,51065,462,1399,72,280,14,32,86,312,0.0168512017283284,0.275641025641026
2017,51067,169,1277,218,413,0,0,218,413,0.010167655530663,0.527845036319613
2017,51069,632,2540,416,1023,175,227,591,1250,0.0217285495758587,0.4728
2017,51071,58,240,86,242,0,33,86,275,0.0226002629848784,0.312727272727273
2017,51073,212,822,172,421,24,88,196,509,0.0189932460166424,0.385068762278978
2017,51075,324,1278,10,121,17,17,27,138,0.00833031510322347,0.195652173913043
2017,51077,41,405,71,136,0,7,71,143,0.0120705663881151,0.496503496503497
2017,51079,143,602,39,153,0,30,39,183,0.0138071525577184,0.213114754098361
2017,51081,34,1270,8,56,0,0,8,56,0.00643234550884448,0.142857142857143
2017,51083,104,451,34,226,10,37,44,263,0.010499001996008,0.167300380228137
2017,51085,1295,2616,516,1091,92,223,608,1314,0.0186187547822144,0.462709284627093
2017,51087,3914,9588,2183,3763,1185,2116,3368,5879,0.0264087037769073,0.572886545330839
2017,51089,79,1070,19,672,0,8,19,680,0.0178933242112465,0.0279411764705882
2017,51091,5,12,3,5,0,0,3,5,0.00267379679144385,0.6
2017,51093,219,1198,110,245,81,180,191,425,0.0164901253249525,0.449411764705882
2017,51095,1161,2804,1120,2077,196,320,1316,2397,0.0454226753330428,0.549019607843137
2017,51097,19,143,0,73,0,0,0,73,0.0140953852094999,0
2017,51099,137,536,202,621,9,78,211,699,0.0416269652215341,0.301859799713877
2017,51101,56,347,32,112,24,35,56,147,0.0129996462681288,0.380952380952381
2017,51103,111,265,56,147,24,25,80,172,0.020041948263808,0.465116279069767
2017,51105,12,314,32,483,0,52,32,535,0.0294490009357626,0.0598130841121495
2017,51107,5813,9278,3928,6220,1399,3310,5327,9530,0.039796881394436,0.55897166841553
2017,51109,190,1284,189,372,0,45,189,417,0.0165897517504774,0.453237410071942
2017,51111,18,239,0,19,0,26,0,45,0.00496798410245087,0
2017,51113,54,440,56,63,0,0,56,63,0.00674085170126257,0.888888888888889
2017,51115,8,389,34,95,0,0,34,95,0.0136553111973552,0.357894736842105
2017,51117,130,504,183,357,13,23,196,380,0.0166849615806806,0.515789473684211
2017,51119,52,416,71,157,0,0,71,157,0.0189842805320435,0.452229299363057
2017,51121,844,1857,1046,1671,615,898,1661,2569,0.0468154897494305,0.646555079797587
2017,51125,162,341,105,137,14,64,119,201,0.0181604625948681,0.592039800995025
2017,51127,312,1271,13,253,0,0,13,253,0.0171432443420518,0.0513833992094862
2017,51131,128,226,31,63,4,4,35,67,0.00766415008007321,0.522388059701492
2017,51133,195,592,3,34,0,0,3,34,0.00347861673828525,0.0882352941176471
2017,51135,121,857,17,97,0,37,17,134,0.0121984524351388,0.126865671641791
2017,51137,311,1329,198,376,13,33,211,409,0.0165145764354357,0.515892420537897
2017,51139,102,571,73,124,28,28,101,152,0.00883669554095692,0.664473684210526
2017,51141,76,460,40,250,19,19,59,269,0.0198846836191603,0.219330855018587
2017,51143,107,1026,117,504,0,15,117,519,0.011472909344121,0.225433526011561
2017,51145,283,1359,37,222,0,52,37,274,0.0132418325923062,0.135036496350365
2017,51147,89,383,148,253,18,59,166,312,0.0245167373880245,0.532051282051282
2017,51149,223,1649,477,1443,140,172,617,1615,0.061598901518041,0.382043343653251
2017,51153,4269,11905,3534,7705,1030,2455,4564,10160,0.0354494862266883,0.449212598425197
2017,51155,174,1056,31,350,26,46,57,396,0.0155075187969925,0.143939393939394
2017,51157,18,139,9,44,0,0,9,44,0.00795660036166365,0.204545454545455
2017,51159,131,584,32,91,0,19,32,110,0.016240956739997,0.290909090909091
2017,51161,864,3045,442,1189,126,342,568,1531,0.0229064739590347,0.370999346832136
2017,51163,211,753,80,262,11,30,91,292,0.0173026783598009,0.311643835616438
2017,51165,444,1555,262,584,18,60,280,644,0.011993891310016,0.434782608695652
2017,51167,45,490,25,268,0,76,25,344,0.0169675446384532,0.0726744186046512
2017,51169,78,546,39,295,0,8,39,303,0.0182959966185617,0.128712871287129
2017,51171,507,1371,134,678,9,73,143,751,0.0245545201896354,0.190412782956059
2017,51173,78,519,78,263,6,28,84,291,0.0127985222324845,0.288659793814433
2017,51175,25,617,13,79,0,16,13,95,0.00719806031216851,0.136842105263158
2017,51177,1270,3775,518,1530,97,317,615,1847,0.0215614858396955,0.332972387655658
2017,51179,1540,4826,1510,3487,495,738,2005,4225,0.047177712020546,0.474556213017751
2017,51181,34,122,29,86,0,0,29,86,0.0172482952266346,0.337209302325581
2017,51183,139,1350,21,78,10,15,31,93,0.0103933839964238,0.333333333333333
2017,51185,72,553,30,693,0,20,30,713,0.0230542891324732,0.0420757363253857
2017,51187,323,1275,88,410,32,56,120,466,0.0173874109175031,0.257510729613734
2017,51191,343,1244,368,913,50,68,418,981,0.0245975628102904,0.426095820591233
2017,51193,255,698,70,322,0,11,70,333,0.0255701451278507,0.21021021021021
2017,51195,25,818,40,448,24,32,64,480,0.0173066522444565,0.133333333333333
2017,51197,98,383,0,125,0,21,0,146,0.00689948490146968,0
2017,51199,969,2437,1026,1766,281,502,1307,2268,0.0505945077743324,0.576278659611993
2017,51510,4580,7205,5959,7954,1710,2724,7669,10678,0.0907499320097906,0.718205656489979
2017,51520,166,558,145,624,0,0,145,624,0.0510429447852761,0.232371794871795
2017,51530,16,66,71,112,0,0,71,112,0.0275319567354966,0.633928571428571
2017,51540,943,2043,1152,1492,263,395,1415,1887,0.063420044363783,0.749867514573397
2017,51550,1847,8076,1719,4340,322,867,2041,5207,0.0332333418432474,0.3919723449203
2017,51570,125,986,185,302,27,37,212,339,0.0275789131142206,0.625368731563422
2017,51580,23,193,14,157,0,28,14,185,0.0471577874075962,0.0756756756756757
2017,51590,194,837,133,610,38,77,171,687,0.0237798546209761,0.248908296943231
2017,51595,48,303,0,148,0,0,0,148,0.0404371584699454,0
2017,51600,857,1310,266,328,180,199,446,527,0.0323729958842681,0.846299810246679
2017,51610,378,601,305,373,233,319,538,692,0.0730651462358779,0.777456647398844
2017,51620,136,354,0,35,0,0,0,35,0.00610713662537079,0
2017,51630,595,1610,275,688,46,81,321,769,0.0459543444484284,0.41742522756827
2017,51640,22,167,10,75,0,12,10,87,0.0172859129743692,0.114942528735632
2017,51650,1031,5298,817,2649,128,349,945,2998,0.0330919687403417,0.315210140093396
2017,51660,715,2581,296,766,137,335,433,1101,0.0416887542597501,0.393278837420527
2017,51670,194,865,147,405,0,4,147,409,0.0276875169239101,0.359413202933985
2017,51678,15,91,19,44,0,0,19,44,0.0168517809268479,0.431818181818182
2017,51680,714,2360,531,1088,117,298,648,1386,0.0315322488909112,0.467532467532468
2017,51683,601,1851,158,429,28,200,186,629,0.0237906123529634,0.29570747217806
2017,51685,240,1073,36,112,56,203,92,315,0.0299173710703771,0.292063492063492
2017,51690,92,690,9,163,0,7,9,170,0.0186056692568677,0.0529411764705882
2017,51700,1332,5187,945,3504,219,735,1164,4239,0.0365519263270445,0.274593064401982
2017,51710,2363,8313,2568,7495,666,1183,3234,8678,0.0572234934158034,0.372666513021433
2017,51720,21,297,43,106,0,0,43,106,0.0368311327310632,0.405660377358491
2017,51730,300,1819,207,497,127,238,334,735,0.0330902215018909,0.454421768707483
2017,51735,124,423,86,155,5,33,91,188,0.0226587923345788,0.484042553191489
2017,51740,738,3674,441,1653,56,172,497,1825,0.0287415153471818,0.272328767123288
2017,51750,98,604,46,118,0,0,46,118,0.0155018392012612,0.389830508474576
2017,51760,3553,9485,2649,4341,387,810,3036,5151,0.0341058067933523,0.589400116482236
2017,51770,931,3577,645,1822,83,333,728,2155,0.0310080865636421,0.337819025522042
2017,51775,299,1326,104,272,0,0,104,272,0.0158369723435226,0.382352941176471
2017,51790,251,1372,155,467,9,22,164,489,0.0282707984043476,0.335378323108384
2017,51800,872,2739,531,1174,188,444,719,1618,0.027439541430655,0.444375772558714
2017,51810,2770,9701,3970,9951,957,2083,4927,12034,0.0396517865380307,0.409423300648164
2017,51820,373,1351,139,217,28,154,167,371,0.0248909761824891,0.450134770889488
2017,51830,335,742,185,258,84,134,269,392,0.053920220082531,0.686224489795918
2017,51840,512,1419,372,791,29,59,401,850,0.0466417910447761,0.471764705882353
2017,53001,76,353,32,87,0,52,32,139,0.0131516699782382,0.23021582733813
2017,53003,37,186,180,813,0,24,180,837,0.0526646951488077,0.21505376344086
2017,53005,1173,3916,856,2701,175,492,1031,3193,0.0259921038707314,0.32289383025368
2017,53007,610,2002,235,456,45,197,280,653,0.0128949447077409,0.428790199081164
2017,53009,338,1090,656,1835,0,111,656,1946,0.0350378105869643,0.33710174717369
2017,53011,950,4044,4925,13878,515,1412,5440,15290,0.0499913357070227,0.355788096795291
2017,53013,42,159,21,59,0,0,21,59,0.0193887610910286,0.355932203389831
2017,53015,368,1730,332,1727,42,100,374,1827,0.0255160470377922,0.204707170224412
2017,53017,224,1185,98,449,0,67,98,516,0.0195092442058301,0.189922480620155
2017,53019,16,291,7,162,0,0,7,162,0.029136690647482,0.0432098765432099
2017,53021,528,3180,168,627,0,173,168,800,0.0156485339279776,0.21
2017,53023,15,17,12,104,0,12,12,116,0.0708180708180708,0.103448275862069
2017,53025,294,1853,172,637,18,414,190,1051,0.0187060603363887,0.180780209324453
2017,53027,290,2267,249,760,4,100,253,860,0.0167975311535607,0.294186046511628
2017,53029,807,2363,649,2475,92,252,741,2727,0.0469274319836176,0.271727172717272
2017,53031,476,1382,536,1073,46,66,582,1139,0.0454981225533275,0.510974539069359
2017,53033,9298,24157,31703,48295,14119,20914,45822,69209,0.046136565139425,0.662081521189441
2017,53035,2075,5109,2966,6821,433,1029,3399,7850,0.0440550885030249,0.432993630573248
2017,53037,511,1994,346,921,53,107,399,1028,0.0390978587456738,0.388132295719844
2017,53039,136,357,104,414,4,24,108,438,0.0284785435630689,0.246575342465753
2017,53041,294,2248,204,1344,3,129,207,1473,0.0275982238210331,0.140529531568228
2017,53043,60,255,35,113,1,16,36,129,0.0171656686626746,0.27906976744186
2017,53045,432,2964,170,792,30,147,200,939,0.0208185526782547,0.212992545260916
2017,53047,289,925,81,348,19,68,100,416,0.0144776223289483,0.240384615384615
2017,53049,78,595,123,366,0,36,123,402,0.0249829097010751,0.305970149253731
2017,53051,16,320,69,320,0,15,69,335,0.0342956592956593,0.205970149253731
2017,53053,4438,18471,6328,16257,1319,3737,7647,19994,0.0354970546357087,0.382464739421827
2017,53055,158,316,262,454,16,34,278,488,0.0371159111651962,0.569672131147541
2017,53057,908,3415,631,1783,154,386,785,2169,0.0256483025293554,0.361917934532042
2017,53059,44,239,73,246,15,30,88,276,0.0327440977577411,0.318840579710145
2017,53061,7277,19359,4625,11470,1317,3082,5942,14552,0.0274505439365272,0.408328752061572
2017,53063,2016,7857,3222,9214,410,1203,3632,10417,0.0314136915083216,0.348660842853029
2017,53065,139,872,107,469,52,135,159,604,0.0194031289151595,0.263245033112583
2017,53067,2258,8060,2370,6098,655,1723,3025,7821,0.0416859879435232,0.386779184247539
2017,53069,14,73,0,7,0,0,0,7,0.00224430907342097,0
2017,53071,360,1950,414,1167,122,135,536,1302,0.0332694518972787,0.411674347158218
2017,53073,1029,2937,1334,3090,402,773,1736,3863,0.0277261406618961,0.449391664509449
2017,53075,283,929,846,1389,293,347,1139,1736,0.0742991654183608,0.65610599078341
2017,53077,677,2473,737,2078,157,544,894,2622,0.0175478516932138,0.340961098398169
2017,54001,15,293,63,204,5,5,68,209,0.0184645286686103,0.325358851674641
2017,54003,218,1127,455,3363,18,108,473,3471,0.0455751050420168,0.136271967732642
2017,54005,31,299,9,101,9,19,18,120,0.00729838219194745,0.15
2017,54007,49,457,4,130,10,37,14,167,0.016094834232845,0.0838323353293413
2017,54009,122,320,58,339,0,21,58,360,0.0216749954843759,0.161111111111111
2017,54011,309,1454,588,1552,31,74,619,1626,0.0254519840338108,0.380688806888069
2017,54013,22,80,0,46,0,0,0,46,0.00828082808280828,0
2017,54015,0,109,6,13,0,14,6,27,0.00432969852469532,0.222222222222222
2017,54017,24,483,40,179,0,0,40,179,0.0286858974358974,0.223463687150838
2017,54019,35,375,73,181,7,53,80,234,0.00730656341722351,0.341880341880342
2017,54021,14,165,46,294,0,24,46,318,0.055838454784899,0.144654088050314
2017,54023,7,183,5,85,0,29,5,114,0.0134007288115669,0.043859649122807
2017,54025,176,586,317,775,49,49,366,824,0.0316059990027233,0.444174757281553
2017,54027,52,287,11,244,0,13,11,257,0.0151229845827939,0.0428015564202335
2017,54029,30,317,166,708,13,109,179,817,0.0370303222589856,0.219094247246022
2017,54031,0,257,16,172,19,45,35,217,0.0214660203778811,0.161290322580645
2017,54033,268,949,205,651,21,36,226,687,0.014165824690187,0.328966521106259
2017,54035,109,329,20,200,12,18,32,218,0.0106258529927861,0.146788990825688
2017,54037,130,610,538,1855,56,148,594,2003,0.0525721784776903,0.296555167249126
2017,54039,605,2325,833,1850,118,213,951,2063,0.0152821606886232,0.460979156568105
2017,54041,68,557,21,151,0,0,21,151,0.0128565346956152,0.139072847682119
2017,54043,0,203,32,266,0,29,32,295,0.0197298020331728,0.108474576271186
2017,54045,64,410,2,102,0,8,2,110,0.00443316003707734,0.0181818181818182
2017,54047,12,370,12,261,0,42,12,303,0.0209877398351458,0.0396039603960396
2017,54049,202,823,233,947,4,56,237,1003,0.0258598463363069,0.23629112662014
2017,54051,95,464,33,195,22,65,55,260,0.0112277065250248,0.211538461538462
2017,54053,47,464,55,326,0,0,55,326,0.0167626491155903,0.168711656441718
2017,54055,55,474,136,993,61,87,197,1080,0.0250673103704391,0.182407407407407
2017,54057,0,58,36,161,2,2,38,163,0.00845611122639552,0.233128834355828
2017,54059,26,184,53,265,0,8,53,273,0.015346562482433,0.194139194139194
2017,54061,522,1530,1149,2058,378,483,1527,2541,0.0399641407945645,0.600944510035419
2017,54063,50,220,55,327,32,59,87,386,0.0386812305842269,0.225388601036269
2017,54065,47,116,97,514,0,9,97,523,0.0403362640752738,0.18546845124283
2017,54067,0,137,31,264,0,0,31,264,0.0142118863049096,0.117424242424242
2017,54069,106,352,301,862,18,58,319,920,0.0304857843462125,0.346739130434783
2017,54071,19,97,17,84,0,0,17,84,0.0156980003737619,0.202380952380952
2017,54073,14,414,0,114,0,0,0,114,0.0209597352454495,0
2017,54075,21,259,35,109,3,3,38,112,0.0171096853040024,0.339285714285714
2017,54077,142,566,49,480,22,78,71,558,0.0225072604065828,0.127240143369176
2017,54079,267,830,61,294,38,76,99,370,0.00928831429647295,0.267567567567568
2017,54081,195,1620,151,887,0,55,151,942,0.0170862656896176,0.160297239915074
2017,54083,81,776,66,254,0,9,66,263,0.0124822021831989,0.250950570342205
2017,54085,21,125,7,100,0,0,7,100,0.0137155397064875,0.07
2017,54087,71,346,20,121,6,14,26,135,0.013142523364486,0.192592592592593
2017,54089,5,370,90,553,0,40,90,593,0.0582343120887754,0.15177065767285
2017,54091,90,580,29,236,8,31,37,267,0.0217267474977622,0.138576779026217
2017,54093,19,94,13,50,0,0,13,50,0.00951112801978315,0.26
2017,54095,24,80,14,139,0,7,14,146,0.0224063842848373,0.0958904109589041
2017,54097,61,244,63,247,0,12,63,259,0.0154783959839837,0.243243243243243
2017,54099,108,805,146,386,0,15,146,401,0.0137281752824375,0.364089775561097
2017,54101,53,179,22,74,0,0,22,74,0.0118059987236758,0.297297297297297
2017,54103,59,170,16,103,0,0,16,103,0.00908449461986241,0.155339805825243
2017,54105,0,49,0,27,0,0,0,27,0.00664370078740158,0
2017,54107,217,690,285,1149,0,51,285,1200,0.0196534442661076,0.2375
2017,54109,3,86,0,54,0,0,0,54,0.00340500662084621,0
2017,55001,97,640,63,408,7,41,70,449,0.0280747827174389,0.155902004454343
2017,55003,40,317,87,158,0,23,87,181,0.0169618592446818,0.480662983425414
2017,55005,197,938,80,417,47,54,127,471,0.0146191569929853,0.26963906581741
2017,55007,73,184,86,175,5,11,91,186,0.016260162601626,0.489247311827957
2017,55009,979,4060,1297,2620,197,442,1494,3062,0.0178846782860614,0.48791639451339
2017,55011,68,336,18,195,0,7,18,202,0.02120067170445,0.0891089108910891
2017,55013,15,181,91,313,3,6,94,319,0.0274196321127729,0.294670846394984
2017,55015,494,1249,43,198,46,63,89,261,0.00780175763735278,0.340996168582375
2017,55017,285,2193,89,401,83,87,172,488,0.0109749240976049,0.352459016393443
2017,55019,98,528,12,86,18,50,30,136,0.0062603572086172,0.220588235294118
2017,55021,428,1624,178,549,10,61,188,610,0.0152553393687791,0.308196721311475
2017,55023,69,529,46,236,2,22,48,258,0.0221706625418922,0.186046511627907
2017,55025,2997,6714,5239,8163,1691,2461,6930,10624,0.0311375279897771,0.652296686746988
2017,55027,362,3467,168,683,18,173,186,856,0.013584929615464,0.217289719626168
2017,55029,233,496,273,526,5,47,278,573,0.0268032556834129,0.485165794066318
2017,55031,109,328,249,1159,16,77,265,1236,0.0402291368311418,0.214401294498382
2017,55033,280,1045,208,511,8,40,216,551,0.0204992745265821,0.392014519056261
2017,55035,437,1616,369,1125,21,130,390,1255,0.0195796995179182,0.310756972111554
2017,55037,6,107,9,111,1,19,10,130,0.0381231671554252,0.0769230769230769
2017,55039,436,1992,179,386,194,280,373,666,0.00941023539717976,0.56006006006006
2017,55041,21,186,33,71,2,7,35,78,0.0121249805689414,0.448717948717949
2017,55043,169,764,116,410,29,58,145,468,0.0147508431304567,0.30982905982906
2017,55045,394,1021,147,375,0,2,147,377,0.0146101379631065,0.389920424403183
2017,55047,78,449,38,113,0,11,38,124,0.00934086629001883,0.306451612903226
2017,55049,126,498,47,150,9,24,56,174,0.0105576117954008,0.32183908045977
2017,55051,37,205,52,149,0,6,52,155,0.0335207612456747,0.335483870967742
2017,55053,143,840,37,140,0,9,37,149,0.0102822441515423,0.248322147651007
2017,55055,631,2112,127,445,106,183,233,628,0.0109120606071137,0.371019108280255
2017,55057,146,903,46,249,18,40,64,289,0.0149927370823822,0.221453287197232
2017,55059,627,2144,792,3094,102,207,894,3301,0.0296825825015736,0.270827022114511
2017,55061,73,309,39,132,48,109,87,241,0.0167047896305538,0.360995850622407
2017,55063,550,1759,557,1444,63,227,620,1671,0.0224334447621733,0.371035308198683
2017,55065,64,380,14,126,3,19,17,145,0.0127708296635547,0.117241379310345
2017,55067,105,566,33,91,33,51,66,142,0.0100723506880409,0.464788732394366
2017,55069,129,727,87,203,8,33,95,236,0.0114763664656682,0.402542372881356
2017,55071,200,728,150,544,14,59,164,603,0.0105966083823917,0.271973466003317
2017,55073,653,2187,493,1207,63,259,556,1466,0.0157787105801313,0.379263301500682
2017,55075,83,560,45,629,29,63,74,692,0.0231121205036572,0.106936416184971
2017,55077,53,370,15,138,0,8,15,146,0.0129180675986551,0.102739726027397
2017,55078,26,120,0,12,0,0,0,12,0.00468384074941452,0
2017,55079,5076,10976,4924,9988,1169,2427,6093,12415,0.0197800692103267,0.490777285541683
2017,55081,209,966,217,533,45,74,262,607,0.0199127382475478,0.43163097199341
2017,55083,89,792,64,167,3,29,67,196,0.00715119673088149,0.341836734693878
2017,55085,177,572,133,326,11,11,144,337,0.0124667061260728,0.427299703264095
2017,55087,1301,4243,607,1311,174,300,781,1611,0.0130988389111133,0.484792054624457
2017,55089,1350,2473,508,918,105,178,613,1096,0.018035511527259,0.559306569343066
2017,55091,39,165,24,47,5,9,29,56,0.0107795957651588,0.517857142857143
2017,55093,143,538,207,586,4,83,211,669,0.0258590700011596,0.315396113602392
2017,55095,141,704,219,632,3,15,222,647,0.0209575019435087,0.343122102009274
2017,55097,442,1541,150,372,67,169,217,541,0.0120928984956524,0.401109057301294
2017,55099,99,393,48,137,0,20,48,157,0.0150831011624556,0.305732484076433
2017,55101,889,3648,532,1975,86,174,618,2149,0.0162151965592696,0.287575616565845
2017,55103,103,397,27,104,9,34,36,138,0.0112103980503656,0.260869565217391
2017,55105,398,1985,503,1792,76,187,579,1979,0.0181906757849842,0.292572006063669
2017,55107,76,311,24,90,0,28,24,118,0.0114920140241527,0.203389830508475
2017,55109,343,1088,633,1732,74,116,707,1848,0.0317771472788238,0.382575757575758
2017,55111,338,1424,218,658,49,88,267,746,0.0169491525423729,0.357908847184987
2017,55113,108,430,76,214,4,8,80,222,0.0183668404070489,0.36036036036036
2017,55115,175,1029,77,219,0,28,77,247,0.00843032185398819,0.311740890688259
2017,55117,397,1757,237,675,71,228,308,903,0.0113654957143397,0.341085271317829
2017,55119,99,307,34,107,0,20,34,127,0.00903400199174847,0.267716535433071
2017,55121,120,535,71,191,0,19,71,210,0.0104602510460251,0.338095238095238
2017,55123,127,418,62,192,3,14,65,206,0.0101084449678591,0.315533980582524
2017,55125,166,464,182,326,4,16,186,342,0.0204888569374551,0.543859649122807
2017,55127,622,1863,688,1868,21,92,709,1960,0.0290934999777346,0.361734693877551
2017,55129,77,336,82,246,5,11,87,257,0.0219301988224251,0.33852140077821
2017,55131,1176,3194,142,716,55,168,197,884,0.00943094288091834,0.222850678733032
2017,55133,3995,9034,2136,3473,475,831,2611,4304,0.0154955590678183,0.606644981412639
2017,55135,336,1418,41,346,36,74,77,420,0.0113253336928677,0.183333333333333
2017,55137,95,885,55,200,3,17,58,217,0.0119671317487454,0.267281105990783
2017,55139,1201,5176,771,1668,79,165,850,1833,0.0161307355192988,0.463720676486634
2017,55141,333,1493,160,446,3,62,163,508,0.00976735243222457,0.320866141732283
2017,56001,95,291,454,873,61,106,515,979,0.0468309016981583,0.526046986721144
2017,56003,27,257,10,293,1,4,11,297,0.036986301369863,0.037037037037037
2017,56005,214,705,64,1290,54,55,118,1345,0.0441490234695552,0.0877323420074349
2017,56007,62,296,88,286,11,54,99,340,0.0319428786170613,0.291176470588235
2017,56009,122,335,38,193,0,0,38,193,0.020258213498478,0.196891191709845
2017,56011,30,124,24,94,0,0,24,94,0.0183989038950871,0.25531914893617
2017,56013,134,716,257,853,4,35,261,888,0.0331578357790971,0.293918918918919
2017,56015,24,216,84,381,0,15,84,396,0.0419091967403958,0.212121212121212
2017,56017,37,145,51,148,2,21,53,169,0.0468923418423973,0.313609467455621
2017,56019,17,163,60,74,0,27,60,101,0.01665841992413,0.594059405940594
2017,56021,260,784,1074,3470,42,153,1116,3623,0.0555623715608993,0.308032017664919
2017,56023,23,360,139,586,0,35,139,621,0.0498675018067935,0.223832528180354
2017,56025,125,849,658,1531,26,194,684,1725,0.031721221037146,0.396521739130435
2017,56027,9,97,3,20,0,0,3,20,0.0113250283125708,0.15
2017,56029,70,265,270,602,0,13,270,615,0.0297561447648539,0.439024390243902
2017,56031,70,196,86,242,0,44,86,286,0.0454979319121858,0.300699300699301
2017,56033,92,333,273,476,6,6,279,482,0.0228739559605163,0.578838174273859
2017,56035,43,128,26,444,73,73,99,517,0.0733229329173167,0.191489361702128
2017,56037,129,465,341,1043,27,39,368,1082,0.0381079843623428,0.340110905730129
2017,56039,133,445,512,1069,71,80,583,1149,0.0675564440263405,0.50739773716275
2017,56041,34,351,64,288,44,45,108,333,0.0256588072122053,0.324324324324324
2017,56043,11,90,34,73,0,9,34,82,0.014373356704645,0.414634146341463
2017,56045,14,258,31,121,0,0,31,121,0.0238470634607805,0.256198347107438
2017,72001,NA,NA,NA,NA,NA,NA,NA,NA,NA,NA
2017,72003,NA,NA,NA,NA,NA,NA,NA,NA,NA,NA
2017,72005,NA,NA,NA,NA,NA,NA,NA,NA,NA,NA
2017,72007,NA,NA,NA,NA,NA,NA,NA,NA,NA,NA
2017,72009,NA,NA,NA,NA,NA,NA,NA,NA,NA,NA
2017,72011,NA,NA,NA,NA,NA,NA,NA,NA,NA,NA
2017,72013,NA,NA,NA,NA,NA,NA,NA,NA,NA,NA
2017,72015,NA,NA,NA,NA,NA,NA,NA,NA,NA,NA
2017,72017,NA,NA,NA,NA,NA,NA,NA,NA,NA,NA
2017,72019,NA,NA,NA,NA,NA,NA,NA,NA,NA,NA
2017,72021,NA,NA,NA,NA,NA,NA,NA,NA,NA,NA
2017,72023,NA,NA,NA,NA,NA,NA,NA,NA,NA,NA
2017,72025,NA,NA,NA,NA,NA,NA,NA,NA,NA,NA
2017,72027,NA,NA,NA,NA,NA,NA,NA,NA,NA,NA
2017,72029,NA,NA,NA,NA,NA,NA,NA,NA,NA,NA
2017,72031,NA,NA,NA,NA,NA,NA,NA,NA,NA,NA
2017,72033,NA,NA,NA,NA,NA,NA,NA,NA,NA,NA
2017,72035,NA,NA,NA,NA,NA,NA,NA,NA,NA,NA
2017,72037,NA,NA,NA,NA,NA,NA,NA,NA,NA,NA
2017,72039,NA,NA,NA,NA,NA,NA,NA,NA,NA,NA
2017,72041,NA,NA,NA,NA,NA,NA,NA,NA,NA,NA
2017,72043,NA,NA,NA,NA,NA,NA,NA,NA,NA,NA
2017,72045,NA,NA,NA,NA,NA,NA,NA,NA,NA,NA
2017,72047,NA,NA,NA,NA,NA,NA,NA,NA,NA,NA
2017,72049,NA,NA,NA,NA,NA,NA,NA,NA,NA,NA
2017,72051,NA,NA,NA,NA,NA,NA,NA,NA,NA,NA
2017,72053,NA,NA,NA,NA,NA,NA,NA,NA,NA,NA
2017,72054,NA,NA,NA,NA,NA,NA,NA,NA,NA,NA
2017,72055,NA,NA,NA,NA,NA,NA,NA,NA,NA,NA
2017,72057,NA,NA,NA,NA,NA,NA,NA,NA,NA,NA
2017,72059,NA,NA,NA,NA,NA,NA,NA,NA,NA,NA
2017,72061,NA,NA,NA,NA,NA,NA,NA,NA,NA,NA
2017,72063,NA,NA,NA,NA,NA,NA,NA,NA,NA,NA
2017,72065,NA,NA,NA,NA,NA,NA,NA,NA,NA,NA
2017,72067,NA,NA,NA,NA,NA,NA,NA,NA,NA,NA
2017,72069,NA,NA,NA,NA,NA,NA,NA,NA,NA,NA
2017,72071,NA,NA,NA,NA,NA,NA,NA,NA,NA,NA
2017,72073,NA,NA,NA,NA,NA,NA,NA,NA,NA,NA
2017,72075,NA,NA,NA,NA,NA,NA,NA,NA,NA,NA
2017,72077,NA,NA,NA,NA,NA,NA,NA,NA,NA,NA
2017,72079,NA,NA,NA,NA,NA,NA,NA,NA,NA,NA
2017,72081,NA,NA,NA,NA,NA,NA,NA,NA,NA,NA
2017,72083,NA,NA,NA,NA,NA,NA,NA,NA,NA,NA
2017,72085,NA,NA,NA,NA,NA,NA,NA,NA,NA,NA
2017,72087,NA,NA,NA,NA,NA,NA,NA,NA,NA,NA
2017,72089,NA,NA,NA,NA,NA,NA,NA,NA,NA,NA
2017,72091,NA,NA,NA,NA,NA,NA,NA,NA,NA,NA
2017,72093,NA,NA,NA,NA,NA,NA,NA,NA,NA,NA
2017,72095,NA,NA,NA,NA,NA,NA,NA,NA,NA,NA
2017,72097,NA,NA,NA,NA,NA,NA,NA,NA,NA,NA
2017,72099,NA,NA,NA,NA,NA,NA,NA,NA,NA,NA
2017,72101,NA,NA,NA,NA,NA,NA,NA,NA,NA,NA
2017,72103,NA,NA,NA,NA,NA,NA,NA,NA,NA,NA
2017,72105,NA,NA,NA,NA,NA,NA,NA,NA,NA,NA
2017,72107,NA,NA,NA,NA,NA,NA,NA,NA,NA,NA
2017,72109,NA,NA,NA,NA,NA,NA,NA,NA,NA,NA
2017,72111,NA,NA,NA,NA,NA,NA,NA,NA,NA,NA
2017,72113,NA,NA,NA,NA,NA,NA,NA,NA,NA,NA
2017,72115,NA,NA,NA,NA,NA,NA,NA,NA,NA,NA
2017,72117,NA,NA,NA,NA,NA,NA,NA,NA,NA,NA
2017,72119,NA,NA,NA,NA,NA,NA,NA,NA,NA,NA
2017,72121,NA,NA,NA,NA,NA,NA,NA,NA,NA,NA
2017,72123,NA,NA,NA,NA,NA,NA,NA,NA,NA,NA
2017,72125,NA,NA,NA,NA,NA,NA,NA,NA,NA,NA
2017,72127,NA,NA,NA,NA,NA,NA,NA,NA,NA,NA
2017,72129,NA,NA,NA,NA,NA,NA,NA,NA,NA,NA
2017,72131,NA,NA,NA,NA,NA,NA,NA,NA,NA,NA
2017,72133,NA,NA,NA,NA,NA,NA,NA,NA,NA,NA
2017,72135,NA,NA,NA,NA,NA,NA,NA,NA,NA,NA
2017,72137,NA,NA,NA,NA,NA,NA,NA,NA,NA,NA
2017,72139,NA,NA,NA,NA,NA,NA,NA,NA,NA,NA
2017,72141,NA,NA,NA,NA,NA,NA,NA,NA,NA,NA
2017,72143,NA,NA,NA,NA,NA,NA,NA,NA,NA,NA
2017,72145,NA,NA,NA,NA,NA,NA,NA,NA,NA,NA
2017,72147,NA,NA,NA,NA,NA,NA,NA,NA,NA,NA
2017,72149,NA,NA,NA,NA,NA,NA,NA,NA,NA,NA
2017,72151,NA,NA,NA,NA,NA,NA,NA,NA,NA,NA
2017,72153,NA,NA,NA,NA,NA,NA,NA,NA,NA,NA
