cbsa_code,age_017,age_1834,age_35plus,female,male,total,race
10100,8859,8532,21649,19821,19219,39040,white non-hispanic
10100,301,173,157,336,295,631,black
10100,271,370,351,523,469,992,asian
10100,385,386,249,539,481,1020,latino
10140,12359,11591,38930,30817,32063,62880,white non-hispanic
10140,51,224,442,25,692,717,black
10140,255,195,694,556,588,1144,asian
10140,3007,1844,2127,3180,3798,6978,latino
10180,29338,34422,68130,67462,64428,131890,white non-hispanic
10180,3389,4991,5149,5400,8129,13529,black
10180,471,965,1328,1651,1113,2764,asian
10180,12857,11934,14101,18472,20420,38892,latino
10220,5143,6375,15295,13822,12991,26813,white non-hispanic
10220,154,355,320,402,427,829,black
10220,0,203,95,155,143,298,asian
10220,757,607,580,896,1048,1944,latino
10260,3051,3256,8089,7174,7222,14396,white non-hispanic
10260,24,11,85,51,69,120,black
10260,0,0,0,0,0,0,asian
10260,4129,4072,10258,9189,9270,18459,latino
10300,19140,18360,53853,45936,45417,91353,white non-hispanic
10300,562,963,1124,594,2055,2649,black
10300,17,61,190,189,79,268,asian
10300,2601,2061,2998,3758,3902,7660,latino
10380,43764,47208,129128,113740,106360,220100,white non-hispanic
10380,1308,2111,5897,4451,4865,9316,black
10380,340,357,361,827,231,1058,asian
10380,64358,66008,176969,157514,149821,307335,latino
10420,109391,128133,338367,294268,281623,575891,white non-hispanic
10420,22320,21928,40782,44942,40088,85030,black
10420,4298,6445,8439,9823,9359,19182,asian
10420,4590,4049,4679,6717,6601,13318,latino
10460,11169,12393,27330,24428,26464,50892,white non-hispanic
10460,376,810,1013,941,1258,2199,black
10460,215,141,520,471,405,876,asian
10460,7865,6507,10043,12139,12276,24415,latino
10500,13698,12833,39900,33836,32595,66431,white non-hispanic
10500,21971,21539,37734,43716,37528,81244,black
10500,384,364,859,858,749,1607,asian
10500,1630,1000,1427,1974,2083,4057,latino
10540,24525,22884,63601,56263,54747,111010,white non-hispanic
10540,144,75,246,209,256,465,black
10540,287,453,761,891,610,1501,asian
10540,4279,2834,3370,4996,5487,10483,latino
10580,133161,166383,435476,375128,359892,735020,white non-hispanic
10580,17996,20782,29882,35853,32807,68660,black
10580,9036,12920,15805,19258,18503,37761,asian
10580,14256,14203,14540,21615,21384,42999,latino
10620,10506,9873,30834,25864,25349,51213,white non-hispanic
10620,1643,1688,3453,3294,3490,6784,black
10620,349,418,399,500,666,1166,asian
10620,999,583,858,1105,1335,2440,latino
10660,6057,5028,17766,14607,14244,28851,white non-hispanic
10660,184,109,114,171,236,407,black
10660,201,208,165,244,330,574,asian
10660,1130,844,934,1397,1511,2908,latino
10700,21141,17795,48829,44867,42898,87765,white non-hispanic
10700,585,549,957,919,1172,2091,black
10700,135,74,325,273,261,534,asian
10700,5909,3420,3271,5707,6893,12600,latino
10740,143076,147397,381598,342212,329859,672071,white non-hispanic
10740,5806,6189,11448,10857,12586,23443,black
10740,3906,4483,11022,11117,8294,19411,asian
10740,127553,114607,196521,222746,215935,438681,latino
10760,5344,4899,18212,14493,13962,28455,white non-hispanic
10760,2918,2552,5746,5983,5233,11216,black
10760,75,62,23,129,31,160,asian
10760,382,245,341,559,409,968,latino
10780,22771,21239,57848,51425,50433,101858,white non-hispanic
10780,13194,11641,20864,23358,22341,45699,black
10780,613,331,1182,995,1131,2126,asian
10780,1381,1558,2104,1835,3208,5043,latino
10820,7507,6777,21555,17934,17905,35839,white non-hispanic
10820,21,64,160,82,163,245,black
10820,0,1,36,36,1,37,asian
10820,226,160,184,266,304,570,latino
10860,11390,8857,19484,20334,19397,39731,white non-hispanic
10860,9,115,122,67,179,246,black
10860,75,103,59,211,26,237,asian
10860,9905,7908,15338,16823,16328,33151,latino
10900,135459,139707,424999,358503,341662,700165,white non-hispanic
10900,14096,12861,19953,22998,23912,46910,black
10900,5438,6179,12047,12256,11408,23664,asian
10900,45332,37328,48742,65491,65911,131402,latino
10940,7965,8449,21297,18596,19115,37711,white non-hispanic
10940,135,1344,909,235,2153,2388,black
10940,35,39,68,84,58,142,asian
10940,906,660,845,1096,1315,2411,latino
10980,5209,4800,17807,14157,13659,27816,white non-hispanic
10980,33,48,89,90,80,170,black
10980,23,58,62,69,74,143,asian
10980,127,109,136,197,175,372,latino
11020,23872,23642,71834,61142,58206,119348,white non-hispanic
11020,332,631,899,808,1054,1862,black
11020,186,267,419,476,396,872,asian
11020,531,436,500,555,912,1467,latino
11060,3936,4170,9604,8840,8870,17710,white non-hispanic
11060,421,568,872,813,1048,1861,black
11060,30,114,204,249,99,348,asian
11060,2152,1676,2134,2974,2988,5962,latino
11100,54975,53184,113501,111645,110015,221660,white non-hispanic
11100,4421,4648,6578,6602,9045,15647,black
11100,2500,2329,3540,3924,4445,8369,asian
11100,25523,22135,25316,35337,37637,72974,latino
11140,3100,3858,9573,8488,8043,16531,white non-hispanic
11140,4761,4736,8036,9457,8076,17533,black
11140,57,119,168,179,165,344,asian
11140,778,601,505,901,983,1884,latino
11180,13694,35680,34113,40306,43181,83487,white non-hispanic
11180,282,883,670,714,1121,1835,black
11180,994,4188,1844,3111,3915,7026,asian
11180,897,1470,766,1419,1714,3133,latino
11220,9333,8324,26023,22257,21423,43680,white non-hispanic
11220,187,265,435,382,505,887,black
11220,104,60,217,252,129,381,asian
11220,2348,1891,2271,3209,3301,6510,latino
11260,59045,69867,145052,130717,143247,273964,white non-hispanic
11260,4528,5165,7780,8085,9388,17473,black
11260,7861,7832,13435,15808,13320,29128,asian
11260,11050,10275,9756,15198,15883,31081,latino
11380,5018,3668,7448,7859,8275,16134,white non-hispanic
11380,63,181,123,214,153,367,black
11380,0,0,37,19,18,37,asian
11380,3494,2556,3687,4632,5105,9737,latino
11420,6946,6867,19702,16623,16892,33515,white non-hispanic
11420,33,30,19,22,60,82,black
11420,24,55,86,85,80,165,asian
11420,486,248,462,612,584,1196,latino
11460,46939,83865,136421,134896,132329,267225,white non-hispanic
11460,9742,14062,19162,21464,21502,42966,black
11460,5001,13883,12621,15845,15660,31505,asian
11460,4799,6211,5395,8213,8192,16405,latino
11500,17429,18053,50654,44369,41767,86136,white non-hispanic
11500,5735,6590,11410,12742,10993,23735,black
11500,298,231,620,677,472,1149,asian
11500,1582,1179,1360,1972,2149,4121,latino
11540,48464,43439,120006,106577,105332,211909,white non-hispanic
11540,1161,750,806,1218,1499,2717,black
11540,2447,2404,2454,3726,3579,7305,asian
11540,4031,2549,3105,4695,4990,9685,latino
11580,5890,6309,17592,13223,16568,29791,white non-hispanic
11580,970,1471,2131,1791,2781,4572,black
11580,0,20,40,23,37,60,asian
11580,3195,3608,4084,3907,6980,10887,latino
11620,7865,7055,20979,18454,17445,35899,white non-hispanic
11620,690,658,1732,1566,1514,3080,black
11620,129,242,165,328,208,536,asian
11620,1455,785,1066,1609,1697,3306,latino
11640,33473,34865,93766,85368,76736,162104,white non-hispanic
11640,1031,1479,3445,2681,3274,5955,black
11640,207,269,282,651,107,758,asian
11640,38351,41035,107600,97198,89788,186986,latino
11660,2814,5283,8089,8360,7826,16186,white non-hispanic
11660,1151,1606,2611,2910,2458,5368,black
11660,35,30,92,76,81,157,asian
11660,430,276,329,523,512,1035,latino
11680,7149,6788,17573,15916,15594,31510,white non-hispanic
11680,272,383,422,383,694,1077,black
11680,121,125,326,296,276,572,asian
11680,1547,1106,1127,1799,1981,3780,latino
11700,72713,78201,252747,209558,194103,403661,white non-hispanic
11700,4755,5076,10930,10361,10400,20761,black
11700,1033,1352,2531,2649,2267,4916,asian
11700,11547,8047,10586,14352,15828,30180,latino
11740,11747,11027,28866,26368,25272,51640,white non-hispanic
11740,85,186,150,192,229,421,black
11740,68,90,167,295,30,325,asian
11740,237,220,214,355,316,671,latino
11780,20004,16882,54742,46295,45333,91628,white non-hispanic
11780,555,1027,2025,1176,2431,3607,black
11780,93,119,267,313,166,479,asian
11780,1592,967,1378,1824,2113,3937,latino
11820,6406,6662,21444,17459,17053,34512,white non-hispanic
11820,82,131,82,140,155,295,black
11820,63,51,242,229,127,356,asian
11820,1263,785,1111,1435,1724,3159,latino
11860,3320,3644,7958,7632,7290,14922,white non-hispanic
11860,108,139,263,334,176,510,black
11860,0,29,26,21,34,55,asian
11860,159,165,154,200,278,478,latino
11900,8922,24032,26666,29943,29677,59620,white non-hispanic
11900,195,1065,431,774,917,1691,black
11900,160,1207,508,909,966,1875,asian
11900,240,670,301,602,609,1211,latino
11940,10146,9311,29170,24976,23651,48627,white non-hispanic
11940,350,553,972,934,941,1875,black
11940,48,157,97,166,136,302,asian
11940,696,502,737,991,944,1935,latino
11980,14991,12900,43192,36555,34528,71083,white non-hispanic
11980,1462,1219,2785,2635,2831,5466,black
11980,146,82,300,333,195,528,asian
11980,3704,2442,3522,4729,4939,9668,latino
12020,26503,50230,69328,74500,71561,146061,white non-hispanic
12020,10172,12077,18591,22190,18650,40840,black
12020,1260,3483,2463,3983,3223,7206,asian
12020,6101,5100,5650,7988,8863,16851,latino
12060,704811,656671,1751348,1572785,1540045,3112830,white non-hispanic
12060,516135,493230,911417,1032980,887802,1920782,black
12060,74157,84755,160735,164238,155409,319647,asian
12060,223105,158136,218792,287610,312423,600033,latino
12100,34164,36656,111853,93895,88778,182673,white non-hispanic
12100,10311,10080,20868,22015,19244,41259,black
12100,5426,4735,12741,11915,10987,22902,asian
12100,16778,13512,20220,25195,25315,50510,latino
12120,4773,4300,14014,11537,11550,23087,white non-hispanic
12120,2944,3148,6036,5658,6470,12128,black
12120,0,91,58,43,106,149,asian
12120,286,269,254,336,473,809,latino
12140,10049,8296,23009,20840,20514,41354,white non-hispanic
12140,55,43,28,60,66,126,black
12140,27,27,75,65,64,129,asian
12140,467,308,400,566,609,1175,latino
12180,14127,14499,43414,36061,35979,72040,white non-hispanic
12180,477,1180,1535,777,2415,3192,black
12180,80,80,223,247,136,383,asian
12180,638,811,737,785,1401,2186,latino
12220,21827,37918,49736,54839,54642,109481,white non-hispanic
12220,8960,10821,16358,19662,16477,36139,black
12220,1410,2060,2530,2835,3165,6000,asian
12220,1846,2142,1825,2592,3221,5813,latino
12260,71702,76296,197481,173651,171828,345479,white non-hispanic
12260,55708,53395,100555,111104,98554,209658,black
12260,2175,2475,6728,6468,4910,11378,asian
12260,10306,9734,10614,14434,16220,30654,latino
12300,22335,22593,71411,59618,56721,116339,white non-hispanic
12300,404,391,293,379,709,1088,black
12300,257,340,462,654,405,1059,asian
12300,626,444,709,889,890,1779,latino
12380,8174,6834,20562,17978,17592,35570,white non-hispanic
12380,531,276,544,444,907,1351,black
12380,347,217,400,477,487,964,asian
12380,1865,1275,1194,2133,2201,4334,latino
12420,353422,414828,786717,777834,777133,1554967,white non-hispanic
12420,35344,41147,68752,73853,71390,145243,black
12420,24106,35300,50527,55648,54285,109933,asian
12420,206583,194063,243167,317265,326548,643813,latino
12460,2938,2698,8523,7233,6926,14159,white non-hispanic
12460,3225,2748,5409,5923,5459,11382,black
12460,31,24,64,66,53,119,asian
12460,636,525,403,796,768,1564,latino
12540,189567,165928,304701,323561,336635,660196,white non-hispanic
12540,13942,14386,19750,21866,26212,48078,black
12540,9867,9314,22082,21061,20202,41263,asian
12540,164869,132865,161173,220862,238045,458907,latino
12580,328708,379355,991233,865026,834270,1699296,white non-hispanic
12580,200615,204374,407797,438524,374262,812786,black
12580,33026,39735,76879,77449,72191,149640,asian
12580,52594,44700,55272,73164,79402,152566,latino
12620,25968,34530,83996,73117,71377,144494,white non-hispanic
12620,239,513,437,432,757,1189,black
12620,302,679,640,973,648,1621,asian
12620,649,738,548,955,980,1935,latino
12660,13117,11307,35280,30003,29701,59704,white non-hispanic
12660,133,128,183,159,285,444,black
12660,148,107,182,308,129,437,asian
12660,1312,619,1129,1456,1604,3060,latino
12680,9773,8565,23045,20923,20460,41383,white non-hispanic
12680,712,463,1211,1213,1173,2386,black
12680,50,22,93,75,90,165,asian
12680,385,370,174,370,559,929,latino
12700,28193,30240,138754,103363,93824,197187,white non-hispanic
12700,1603,1317,2937,2740,3117,5857,black
12700,914,797,1447,1736,1422,3158,asian
12700,1991,1516,2362,2791,3078,5869,latino
12740,10659,11211,34455,28526,27799,56325,white non-hispanic
12740,108,181,213,183,319,502,black
12740,29,138,222,238,151,389,asian
12740,291,331,465,581,506,1087,latino
12780,8457,7851,24230,20945,19593,40538,white non-hispanic
12780,349,285,684,608,710,1318,black
12780,295,429,281,508,497,1005,asian
12780,1139,781,1051,1469,1502,2971,latino
12820,2583,2226,8285,6708,6386,13094,white non-hispanic
12820,3596,3002,6008,6674,5932,12606,black
12820,0,26,87,91,22,113,asian
12820,233,27,70,263,67,330,latino
12860,10644,10762,32515,27264,26657,53921,white non-hispanic
12860,272,522,691,611,874,1485,black
12860,76,111,219,213,193,406,asian
12860,660,518,640,743,1075,1818,latino
12900,7830,7024,19343,17626,16571,34197,white non-hispanic
12900,184,207,365,357,399,756,black
12900,49,54,154,185,72,257,asian
12900,944,625,689,1076,1182,2258,latino
12940,104133,121945,267640,248500,245218,493718,white non-hispanic
12940,80095,82568,130942,153362,140243,293605,black
12940,3385,6024,7732,8703,8438,17141,asian
12940,10019,9923,11593,14151,17384,31535,latino
12980,23397,22416,64538,56565,53786,110351,white non-hispanic
12980,3945,3365,7166,7304,7172,14476,black
12980,681,866,1290,1539,1298,2837,asian
12980,2541,1871,2297,3325,3384,6709,latino
13020,19864,19639,60084,50600,48987,99587,white non-hispanic
13020,402,577,774,743,1010,1753,black
13020,131,180,286,313,284,597,asian
13020,2010,1425,1993,2689,2739,5428,latino
13060,6774,5733,14936,13666,13777,27443,white non-hispanic
13060,899,851,2020,2000,1770,3770,black
13060,308,44,379,460,271,731,asian
13060,5169,3901,6160,7457,7773,15230,latino
13100,4563,3571,12749,10497,10386,20883,white non-hispanic
13100,18,29,88,91,44,135,black
13100,37,52,47,54,82,136,asian
13100,238,33,219,219,271,490,latino
13140,65708,63170,156153,140381,144650,285031,white non-hispanic
13140,25489,25656,48475,50399,49221,99620,black
13140,2512,2559,5453,5133,5391,10524,asian
13140,20238,17036,21890,26568,32596,59164,latino
13180,16914,15785,49584,39951,42332,82283,white non-hispanic
13180,132,834,1178,285,1859,2144,black
13180,87,173,222,235,247,482,asian
13180,1648,1115,1286,1838,2211,4049,latino
13220,22651,20479,66446,55286,54290,109576,white non-hispanic
13220,1745,2047,4520,3558,4754,8312,black
13220,142,246,473,358,503,861,asian
13220,501,542,649,530,1162,1692,latino
13260,9583,8116,26414,22258,21855,44113,white non-hispanic
13260,16,35,97,55,93,148,black
13260,27,53,111,150,41,191,asian
13260,291,250,180,303,418,721,latino
13300,6351,7920,14323,12036,16558,28594,white non-hispanic
13300,271,959,1552,193,2589,2782,black
13300,4,1,156,87,74,161,asian
13300,5257,5569,8232,8495,10563,19058,latino
13340,9913,7989,25126,21761,21267,43028,white non-hispanic
13340,147,184,445,344,432,776,black
13340,85,38,213,195,141,336,asian
13340,255,96,308,293,366,659,latino
13380,32538,47422,99075,90508,88527,179035,white non-hispanic
13380,595,511,1023,755,1374,2129,black
13380,1067,3105,4462,4721,3913,8634,asian
13380,6818,6159,6221,9385,9813,19198,latino
13420,6579,8847,18267,16843,16850,33693,white non-hispanic
13420,240,156,50,156,290,446,black
13420,81,104,190,230,145,375,asian
13420,512,323,183,481,537,1018,latino
13460,33539,31466,99052,83020,81037,164057,white non-hispanic
13460,407,276,286,387,582,969,black
13460,392,569,1090,1234,817,2051,asian
13460,5114,3755,4815,6702,6982,13684,latino
13500,1990,2136,7170,5507,5789,11296,white non-hispanic
13500,2925,3414,7513,6366,7486,13852,black
13500,6,4,85,48,47,95,asian
13500,125,341,443,166,743,909,latino
13540,6567,6405,21700,17824,16848,34672,white non-hispanic
13540,68,141,141,118,232,350,black
13540,33,32,75,61,79,140,asian
13540,191,204,237,275,357,632,latino
13620,6179,5998,24165,17687,18655,36342,white non-hispanic
13620,54,343,435,61,771,832,black
13620,15,45,154,159,55,214,asian
13620,136,226,270,110,522,632,latino
13660,7453,11622,21181,20071,20185,40256,white non-hispanic
13660,192,684,222,488,610,1098,black
13660,48,133,128,160,149,309,asian
13660,281,329,314,380,544,924,latino
13700,6767,7822,16963,13814,17738,31552,white non-hispanic
13700,500,528,1108,927,1209,2136,black
13700,50,9,229,142,146,288,asian
13700,4341,4343,6922,6460,9146,15606,latino
13720,11402,11156,32586,27847,27297,55144,white non-hispanic
13720,284,1182,945,418,1993,2411,black
13720,48,69,210,149,178,327,asian
13720,252,215,175,207,435,642,latino
13740,33236,32191,87482,77648,75261,152909,white non-hispanic
13740,354,355,458,445,722,1167,black
13740,202,317,470,717,272,989,asian
13740,3531,2232,2911,4207,4467,8674,latino
13780,40567,48123,127769,110081,106378,216459,white non-hispanic
13780,3580,3657,4340,5712,5865,11577,black
13780,1241,4663,2807,4345,4366,8711,asian
13780,3011,3042,2645,4283,4415,8698,latino
13820,159647,157637,438814,387286,368812,756098,white non-hispanic
13820,83098,81298,163244,176016,151624,327640,black
13820,3850,3821,7798,8278,7191,15469,asian
13820,19483,13841,16046,22687,26683,49370,latino
13900,24825,26752,63137,57417,57297,114714,white non-hispanic
13900,422,749,669,649,1191,1840,black
13900,199,218,326,455,288,743,asian
13900,988,1060,999,1314,1733,3047,latino
13940,11373,7553,18809,18789,18946,37735,white non-hispanic
13940,100,21,21,69,73,142,black
13940,128,115,184,243,184,427,asian
13940,3268,2083,2770,3889,4232,8121,latino
13980,26566,52733,82470,80243,81526,161769,white non-hispanic
13980,1209,3625,3621,4104,4351,8455,black
13980,957,4164,1753,3046,3828,6874,asian
13980,1093,2440,1217,2264,2486,4750,latino
14010,31811,46187,81057,81853,77202,159055,white non-hispanic
14010,4562,4940,4788,7239,7051,14290,black
14010,2084,3386,3319,4213,4576,8789,asian
14010,3013,3023,2594,4186,4444,8630,latino
14020,23593,53443,68335,73012,72359,145371,white non-hispanic
14020,950,2170,1541,2255,2406,4661,black
14020,811,6280,2130,4535,4686,9221,asian
14020,1329,2259,1455,2399,2644,5043,latino
14100,14485,19714,46416,41841,38774,80615,white non-hispanic
14100,313,815,421,761,788,1549,black
14100,315,427,601,696,647,1343,asian
14100,645,693,849,1077,1110,2187,latino
14140,18722,18511,58804,49695,46342,96037,white non-hispanic
14140,1240,1265,2521,2469,2557,5026,black
14140,39,246,330,401,214,615,asian
14140,288,418,331,577,460,1037,latino
14180,6142,5306,15074,13565,12957,26522,white non-hispanic
14180,4796,3891,6607,8160,7134,15294,black
14180,77,44,117,75,163,238,asian
14180,685,445,623,998,755,1753,latino
14220,6885,6104,18195,15803,15381,31184,white non-hispanic
14220,3757,3032,7204,7028,6965,13993,black
14220,0,18,88,33,73,106,asian
14220,337,303,329,508,461,969,latino
14260,153037,134711,320513,305443,302818,608261,white non-hispanic
14260,2392,1859,2333,2589,3995,6584,black
14260,3033,3401,6829,7496,5767,13263,asian
14260,34866,25844,29712,44318,46104,90422,latino
14300,6301,5726,17556,14402,15181,29583,white non-hispanic
14300,295,675,1219,641,1548,2189,black
14300,50,29,154,140,93,233,asian
14300,1165,1245,1170,1429,2151,3580,latino
14340,5566,4918,15009,12670,12823,25493,white non-hispanic
14340,48,60,0,52,56,108,black
14340,0,34,65,37,62,99,asian
14340,289,141,235,289,376,665,latino
14380,6262,20264,23623,25033,25116,50149,white non-hispanic
14380,29,470,333,367,465,832,black
14380,0,362,84,351,95,446,asian
14380,536,882,411,764,1065,1829,latino
14420,4696,3912,10513,9521,9600,19121,white non-hispanic
14420,146,121,200,208,259,467,black
14420,20,46,65,86,45,131,asian
14420,1834,1282,1771,2445,2442,4887,latino
14460,686031,857649,2130733,1891166,1783247,3674413,white non-hispanic
14460,95116,107982,181429,200678,183849,384527,black
14460,71328,117646,170731,188179,171526,359705,asian
14460,151751,158056,195670,253718,251759,505477,latino
14500,53413,78013,149378,139665,141139,280804,white non-hispanic
14500,513,1065,1159,1153,1584,2737,black
14500,2772,4940,6593,7562,6743,14305,asian
14500,14975,13029,15554,21654,21904,43558,latino
14540,30455,38406,76400,74073,71188,145261,white non-hispanic
14540,3140,4248,4788,6000,6176,12176,black
14540,1484,1245,1476,2213,1992,4205,asian
14540,2864,2151,2203,3363,3855,7218,latino
14580,19013,30119,46213,45990,49355,95345,white non-hispanic
14580,65,147,106,145,173,318,black
14580,138,703,476,793,524,1317,asian
14580,1065,1061,1213,1626,1713,3339,latino
14620,8035,7959,23804,19808,19990,39798,white non-hispanic
14620,51,495,565,63,1048,1111,black
14620,0,103,80,114,69,183,asian
14620,178,315,390,181,702,883,latino
14660,17342,14305,53722,42560,42809,85369,white non-hispanic
14660,142,282,97,255,266,521,black
14660,111,167,181,275,184,459,asian
14660,602,343,543,716,772,1488,latino
14700,15548,14633,50480,41494,39167,80661,white non-hispanic
14700,104,204,290,176,422,598,black
14700,73,106,318,271,226,497,asian
14700,1356,1043,1282,1913,1768,3681,latino
14720,4035,7396,15344,12323,14452,26775,white non-hispanic
14720,29,1,253,33,250,283,black
14720,98,0,34,81,51,132,asian
14720,1395,1061,1702,1984,2174,4158,latino
14740,40263,48290,122861,102855,108559,211414,white non-hispanic
14740,1277,2489,2725,2575,3916,6491,black
14740,1861,2735,7914,7543,4967,12510,asian
14740,6122,6872,5960,8811,10143,18954,latino
14780,5526,5196,16295,13601,13416,27017,white non-hispanic
14780,1431,1666,2814,2894,3017,5911,black
14780,123,181,323,342,285,627,asian
14780,2089,1390,1893,2519,2853,5372,latino
14820,4353,4927,20864,15809,14335,30144,white non-hispanic
14820,295,463,605,660,703,1363,black
14820,0,138,94,164,68,232,asian
14820,360,382,318,497,563,1060,latino
14860,149253,127322,419711,357083,339203,696286,white non-hispanic
14860,26619,27539,53147,57748,49557,107305,black
14860,10645,13001,25316,25571,23391,48962,asian
14860,53752,48988,77639,88967,91412,180379,latino
15020,5510,4588,13469,12094,11473,23567,white non-hispanic
15020,2843,2472,5326,5779,4862,10641,black
15020,83,54,117,138,116,254,asian
15020,133,140,96,165,204,369,latino
15060,2803,2556,15140,10478,10021,20499,white non-hispanic
15060,0,0,74,56,18,74,black
15060,0,27,94,83,38,121,asian
15060,505,221,789,785,730,1515,latino
15100,6092,12413,12736,15435,15806,31241,white non-hispanic
15100,146,331,56,209,324,533,black
15100,242,453,287,429,553,982,asian
15100,334,364,178,482,394,876,latino
15140,1640,1423,5093,4233,3923,8156,white non-hispanic
15140,2178,1888,4907,4891,4082,8973,black
15140,0,15,0,15,0,15,asian
15140,287,277,204,403,365,768,latino
15180,125523,90336,178940,203218,191581,394799,white non-hispanic
15180,567,592,827,827,1159,1986,black
15180,594,583,1665,1376,1466,2842,asian
15180,124572,89568,161116,194490,180766,375256,latino
15220,7678,7061,19925,17596,17068,34664,white non-hispanic
15220,477,456,563,602,894,1496,black
15220,27,101,122,111,139,250,asian
15220,2700,2241,3178,4000,4119,8119,latino
15260,16376,14890,51199,42831,39634,82465,white non-hispanic
15260,7388,6503,13321,14744,12468,27212,black
15260,203,384,616,650,553,1203,asian
15260,2237,1780,2192,3009,3200,6209,latino
15340,8783,7557,24576,20993,19923,40916,white non-hispanic
15340,94,102,171,137,230,367,black
15340,60,44,69,75,98,173,asian
15340,246,184,221,286,365,651,latino
15380,165313,195559,546879,465379,442372,907751,white non-hispanic
15380,37726,37691,64001,74481,64937,139418,black
15380,8495,12929,12641,17173,16892,34065,asian
15380,19180,16169,18548,27388,26509,53897,latino
15420,12752,8490,20157,20383,21016,41399,white non-hispanic
15420,28,18,29,31,44,75,black
15420,66,0,150,142,74,216,asian
15420,5167,3504,4695,6323,7043,13366,latino
15460,8756,7737,26343,21960,20876,42836,white non-hispanic
15460,1011,608,805,1134,1290,2424,black
15460,44,118,139,162,139,301,asian
15460,522,341,412,600,675,1275,latino
15500,22194,23430,65605,58355,52874,111229,white non-hispanic
15500,7085,6826,16061,16332,13640,29972,black
15500,599,671,1108,1228,1150,2378,asian
15500,8023,5014,6416,9539,9914,19453,latino
15540,36730,53286,109274,101325,97965,199290,white non-hispanic
15540,1505,1619,1399,1935,2588,4523,black
15540,1363,2438,2530,3303,3028,6331,asian
15540,1123,1797,1447,2307,2060,4367,latino
15580,6500,7441,18638,16165,16414,32579,white non-hispanic
15580,20,156,9,97,88,185,black
15580,14,240,33,265,22,287,asian
15580,462,377,609,698,750,1448,latino
15620,10505,8615,26959,22981,23098,46079,white non-hispanic
15620,80,84,140,101,203,304,black
15620,67,89,113,176,93,269,asian
15620,402,315,285,496,506,1002,latino
15660,12514,10461,27904,25658,25221,50879,white non-hispanic
15660,589,612,1097,1077,1221,2298,black
15660,196,80,360,369,267,636,asian
15660,3324,2355,3011,4116,4574,8690,latino
15680,20431,20016,47038,43343,44142,87485,white non-hispanic
15680,4001,4080,7841,8108,7814,15922,black
15680,638,631,1810,1757,1322,3079,asian
15680,1763,1444,2170,2595,2782,5377,latino
15700,3677,3856,13812,11041,10304,21345,white non-hispanic
15700,2212,1926,4763,4755,4146,8901,black
15700,56,80,189,182,143,325,asian
15700,615,465,535,792,823,1615,latino
15740,8232,7249,22232,19072,18641,37713,white non-hispanic
15740,91,111,292,171,323,494,black
15740,21,31,77,74,55,129,asian
15740,190,31,220,217,224,441,latino
15780,3504,3273,11123,9077,8823,17900,white non-hispanic
15780,2811,2164,6153,5922,5206,11128,black
15780,0,14,14,8,20,28,asian
15780,329,250,145,444,280,724,latino
15820,5000,5498,12769,12046,11221,23267,white non-hispanic
15820,201,435,559,570,625,1195,black
15820,61,121,67,113,136,249,asian
15820,211,200,172,236,347,583,latino
15860,7130,8146,26792,18810,23258,42068,white non-hispanic
15860,14,773,1358,35,2110,2145,black
15860,37,56,246,159,180,339,asian
15860,1125,2186,2747,1810,4248,6058,latino
15900,6878,6234,20583,16714,16981,33695,white non-hispanic
15900,118,765,469,126,1226,1352,black
15900,2,7,76,48,37,85,asian
15900,165,276,588,208,821,1029,latino
15940,72585,70801,214010,183674,173722,357396,white non-hispanic
15940,6705,6741,13517,13621,13342,26963,black
15940,595,699,1866,1825,1335,3160,asian
15940,2786,2012,2755,3739,3814,7553,latino
15980,95608,98369,399250,301845,291382,593227,white non-hispanic
15980,18802,15117,26745,31459,29205,60664,black
15980,1839,2122,6895,6235,4621,10856,asian
15980,43520,36741,61283,69497,72047,141544,latino
16020,17115,20560,47228,43433,41470,84903,white non-hispanic
16020,2738,2584,3246,4563,4005,8568,black
16020,114,766,285,636,529,1165,asian
16020,766,657,575,940,1058,1998,latino
16060,20557,28061,58820,53847,53591,107438,white non-hispanic
16060,2267,5159,4065,5830,5661,11491,black
16060,505,979,1184,1282,1386,2668,asian
16060,1292,1853,1074,2017,2202,4219,latino
16100,13812,11943,26250,25903,26102,52005,white non-hispanic
16100,225,183,435,351,492,843,black
16100,48,95,113,112,144,256,asian
16100,8631,7072,11279,13409,13573,26982,latino
16140,4781,3517,11548,10072,9774,19846,white non-hispanic
16140,165,83,53,135,166,301,black
16140,0,0,31,20,11,31,asian
16140,257,78,146,201,280,481,latino
16180,7890,8632,27319,21604,22237,43841,white non-hispanic
16180,114,247,570,202,729,931,black
16180,191,335,800,682,644,1326,asian
16180,4391,3486,4788,6055,6610,12665,latino
16220,17641,17978,39969,37630,37958,75588,white non-hispanic
16220,245,192,630,242,825,1067,black
16220,144,204,304,397,255,652,asian
16220,2424,2020,2222,3170,3496,6666,latino
16260,12375,12700,19079,22056,22098,44154,white non-hispanic
16260,123,62,96,108,173,281,black
16260,48,60,206,170,144,314,asian
16260,1564,1329,1209,1942,2160,4102,latino
16300,52980,51082,136090,121695,118457,240152,white non-hispanic
16300,4000,3562,3995,5247,6310,11557,black
16300,1244,1775,2077,2607,2489,5096,asian
16300,2903,2284,2329,3663,3853,7516,latino
16340,7225,6244,17777,15954,15292,31246,white non-hispanic
16340,1315,1314,2624,2914,2339,5253,black
16340,56,109,106,103,168,271,asian
16340,2241,1489,1673,2449,2954,5403,latino
16380,9969,7638,21934,19656,19885,39541,white non-hispanic
16380,128,55,95,134,144,278,black
16380,61,64,50,129,46,175,asian
16380,304,86,341,304,427,731,latino
16420,5995,5641,17209,14344,14501,28845,white non-hispanic
16420,222,724,570,659,857,1516,black
16420,13,27,31,65,6,71,asian
16420,229,152,82,158,305,463,latino
16460,7841,6789,20922,18263,17289,35552,white non-hispanic
16460,267,274,758,641,658,1299,black
16460,41,141,88,129,141,270,asian
16460,279,186,254,282,437,719,latino
16500,14482,13077,41856,34941,34474,69415,white non-hispanic
16500,153,183,167,132,371,503,black
16500,268,233,480,601,380,981,asian
16500,3179,1958,2323,3495,3965,7460,latino
16540,30940,27460,83943,72494,69849,142343,white non-hispanic
16540,2112,1302,2619,2740,3293,6033,black
16540,376,285,865,827,699,1526,asian
16540,3344,2324,2395,3576,4487,8063,latino
16580,31708,58623,89324,90002,89653,179655,white non-hispanic
16580,8012,9699,9796,14586,12921,27507,black
16580,2834,13241,5534,10173,11436,21609,asian
16580,3906,5376,3284,5913,6653,12566,latino
16620,38866,37305,121639,102435,95375,197810,white non-hispanic
16620,2841,3784,6609,6711,6523,13234,black
16620,383,680,961,1021,1003,2024,asian
16620,686,676,777,1140,999,2139,latino
16660,10959,17066,31323,30455,28893,59348,white non-hispanic
16660,352,1314,345,1005,1006,2011,black
16660,121,425,143,426,263,689,asian
16660,394,662,332,661,727,1388,latino
16700,100763,126265,276376,253655,249749,503404,white non-hispanic
16700,49419,50186,96442,104539,91508,196047,black
16700,2383,3138,7301,6847,5975,12822,asian
16700,13934,12150,13927,18837,21174,40011,latino
16740,365097,341577,941238,838465,809447,1647912,white non-hispanic
16740,142629,138855,260566,292273,249777,542050,black
16740,20726,23945,38239,42022,40888,82910,asian
16740,90161,62063,86494,116111,122607,238718,latino
16820,33488,44321,101314,92586,86537,179123,white non-hispanic
16820,6280,8401,16655,16381,14955,31336,black
16820,1429,4392,3300,4666,4455,9121,asian
16820,3962,4106,3282,5691,5659,11350,latino
16860,89956,95063,261744,229265,217498,446763,white non-hispanic
16860,18182,19140,37140,39631,34831,74462,black
16860,2099,2153,4661,4521,4392,8913,asian
16860,8989,7003,7316,10873,12435,23308,latino
16940,19218,19960,46842,42655,43365,86020,white non-hispanic
16940,686,1052,865,1053,1550,2603,black
16940,276,437,458,616,555,1171,asian
16940,4557,3943,5339,6725,7114,13839,latino
16980,1349574,1420682,3532816,3186113,3116959,6303072,white non-hispanic
16980,401555,394451,803409,865137,734278,1599415,black
16980,123240,160706,321890,315256,290580,605836,asian
16980,690031,569820,821673,1019524,1062000,2081524,latino
17020,33437,48263,103521,94215,91006,185221,white non-hispanic
17020,678,984,1710,1463,1909,3372,black
17020,2612,3892,3670,5254,4920,10174,asian
17020,11043,11899,12503,17382,18063,35445,latino
17060,14918,13844,40886,34152,35496,69648,white non-hispanic
17060,388,1192,2392,810,3162,3972,black
17060,40,157,249,212,234,446,asian
17060,340,248,318,379,527,906,latino
17140,394387,388824,987138,898711,871638,1770349,white non-hispanic
17140,73541,66312,123593,138656,124790,263446,black
17140,12681,14727,23619,26245,24782,51027,asian
17140,26254,17613,21135,30868,34134,65002,latino
17200,36589,41151,127748,104177,101311,205488,white non-hispanic
17200,436,870,604,824,1086,1910,black
17200,606,1735,1487,2071,1757,3828,asian
17200,1118,1255,1450,2014,1809,3823,latino
17220,18425,17420,54190,45420,44615,90035,white non-hispanic
17220,331,453,720,615,889,1504,black
17220,167,165,284,363,253,616,asian
17220,346,384,446,644,532,1176,latino
17260,887,932,3428,2721,2526,5247,white non-hispanic
17260,5714,4696,8346,10254,8502,18756,black
17260,64,24,44,75,57,132,asian
17260,9,0,26,26,9,35,latino
17300,51070,60069,90876,98679,103336,202015,white non-hispanic
17300,15290,16971,21820,27309,26772,54081,black
17300,1036,1444,2770,3132,2118,5250,asian
17300,8756,9368,6260,11448,12936,24384,latino
17340,8284,8280,33277,25022,24819,49841,white non-hispanic
17340,383,301,809,753,740,1493,black
17340,175,277,501,635,318,953,asian
17340,4477,3119,4849,6007,6438,12445,latino
17380,2090,2698,6087,5462,5413,10875,white non-hispanic
17380,5899,5431,9946,11610,9666,21276,black
17380,42,94,173,178,131,309,asian
17380,232,63,401,283,413,696,latino
17420,23748,23407,63640,56825,53970,110795,white non-hispanic
17420,1461,1374,2341,2505,2671,5176,black
17420,283,326,612,689,532,1221,asian
17420,2463,1709,2168,2950,3390,6340,latino
17460,296212,300077,925765,780375,741679,1522054,white non-hispanic
17460,105967,98812,205878,221831,188826,410657,black
17460,8155,13767,22442,23568,20796,44364,asian
17460,39204,31281,42945,56582,56848,113430,latino
17500,7838,7125,15378,14157,16184,30341,white non-hispanic
17500,1121,1042,2281,2155,2289,4444,black
17500,89,116,137,159,183,342,asian
17500,6516,5589,8153,8993,11265,20258,latino
17540,9673,8167,26754,22756,21838,44594,white non-hispanic
17540,282,444,497,584,639,1223,black
17540,93,82,158,198,135,333,asian
17540,654,368,426,732,716,1448,latino
17580,8138,10097,16027,16664,17598,34262,white non-hispanic
17580,806,991,1161,1322,1636,2958,black
17580,107,333,304,501,243,744,asian
17580,7222,5834,7546,10038,10564,20602,latino
17620,6084,6087,14012,13767,12416,26183,white non-hispanic
17620,1581,1417,5498,4225,4271,8496,black
17620,0,0,0,0,0,0,asian
17620,8752,8546,22301,20388,19211,39599,latino
17640,3822,3719,9071,8736,7876,16612,white non-hispanic
17640,1782,1661,4445,3756,4132,7888,black
17640,0,9,120,68,61,129,asian
17640,6869,6490,15748,15016,14091,29107,latino
17660,32400,28568,80559,71561,69966,141527,white non-hispanic
17660,315,136,213,337,327,664,black
17660,239,329,502,691,379,1070,asian
17660,2382,1703,2475,3300,3260,6560,latino
17700,6304,5521,16662,14563,13924,28487,white non-hispanic
17700,414,617,745,836,940,1776,black
17700,42,103,199,118,226,344,asian
17700,842,550,684,989,1087,2076,latino
17740,9569,7855,23456,20152,20728,40880,white non-hispanic
17740,46,195,804,82,963,1045,black
17740,38,74,118,156,74,230,asian
17740,799,513,631,904,1039,1943,latino
17780,35570,76794,74551,92801,94114,186915,white non-hispanic
17780,7724,8499,11507,14395,13335,27730,black
17780,2207,6994,3833,5864,7170,13034,asian
17780,18935,22944,18736,29489,31126,60615,latino
17820,126575,140625,292048,277778,281470,559248,white non-hispanic
17820,10696,13196,17723,19786,21829,41615,black
17820,4036,4815,9944,10882,7913,18795,asian
17820,40136,34418,38244,55940,56858,112798,latino
17860,25915,50455,65761,73131,69000,142131,white non-hispanic
17860,3640,5383,5878,7777,7124,14901,black
17860,1423,3159,2837,4031,3388,7419,asian
17860,1866,2174,1689,2652,3077,5729,latino
17900,96267,118120,272056,246152,240291,486443,white non-hispanic
17900,66899,74181,128081,143743,125418,269161,black
17900,3383,5469,7321,8480,7693,16173,asian
17900,14912,13982,14625,20175,23344,43519,latino
17980,33005,40873,83254,76710,80422,157132,white non-hispanic
17980,31807,32920,61278,65620,60385,126005,black
17980,1178,1631,3084,3146,2747,5893,asian
17980,6893,7465,6514,9586,11286,20872,latino
18020,15750,13893,39594,35046,34191,69237,white non-hispanic
18020,380,436,742,614,944,1558,black
18020,1129,2158,1779,2160,2906,5066,asian
18020,2116,1377,1760,2280,2973,5253,latino
18060,6723,7264,18112,16245,15854,32099,white non-hispanic
18060,6882,6561,12482,14060,11865,25925,black
18060,147,133,316,240,356,596,asian
18060,414,300,487,539,662,1201,latino
18100,8092,6268,17035,15553,15842,31395,white non-hispanic
18100,34,34,76,25,119,144,black
18100,53,113,39,113,92,205,asian
18100,2363,1585,1836,2689,3095,5784,latino
18140,336210,372170,842247,786488,764139,1550627,white non-hispanic
18140,90139,79461,135814,157425,147989,305414,black
18140,18068,25109,34298,40017,37458,77475,asian
18140,31138,23344,25167,38417,41232,79649,latino
18180,26812,28738,84370,71145,68775,139920,white non-hispanic
18180,546,566,701,759,1054,1813,black
18180,627,946,1055,1362,1266,2628,asian
18180,951,962,1023,1494,1442,2936,latino
18220,4986,4053,13499,11431,11107,22538,white non-hispanic
18220,125,152,312,339,250,589,black
18220,10,0,21,7,24,31,asian
18220,15,110,115,120,120,240,latino
18260,21477,25084,57107,52367,51301,103668,white non-hispanic
18260,543,720,688,814,1137,1951,black
18260,221,438,414,580,493,1073,asian
18260,2103,1413,1530,2372,2674,5046,latino
18300,9385,9586,36634,28186,27419,55605,white non-hispanic
18300,281,263,194,402,336,738,black
18300,170,194,342,489,217,706,asian
18300,1425,1103,1426,2019,1935,3954,latino
18380,2345,2206,7762,6418,5895,12313,white non-hispanic
18380,2988,2488,4455,5448,4483,9931,black
18380,146,14,122,111,171,282,asian
18380,307,317,121,412,333,745,latino
18420,7119,6142,18449,16128,15582,31710,white non-hispanic
18420,1011,1253,2110,2176,2198,4374,black
18420,32,9,66,81,26,107,asian
18420,429,379,316,444,680,1124,latino
18460,8023,7667,22187,19782,18095,37877,white non-hispanic
18460,163,513,705,1027,354,1381,black
18460,253,240,536,533,496,1029,asian
18460,2562,1683,1965,2955,3255,6210,latino
18500,20041,17796,54754,46770,45821,92591,white non-hispanic
18500,351,335,918,685,919,1604,black
18500,341,412,709,770,692,1462,asian
18500,548,479,525,731,821,1552,latino
18580,100135,95714,205547,202811,198585,401396,white non-hispanic
18580,3753,4319,7050,7241,7881,15122,black
18580,1674,1947,4602,4471,3752,8223,asian
18580,79419,69305,121805,137478,133051,270529,latino
18620,8941,7043,20513,18657,17840,36497,white non-hispanic
18620,1647,1387,3405,3361,3078,6439,black
18620,63,101,138,113,189,302,asian
18620,5061,3175,4411,6204,6443,12647,latino
18660,8736,13126,23914,23329,22447,45776,white non-hispanic
18660,172,330,367,520,349,869,black
18660,57,162,173,248,144,392,asian
18660,319,542,405,588,678,1266,latino
18700,12427,25624,38393,38148,38296,76444,white non-hispanic
18700,218,284,379,301,580,881,black
18700,802,3071,1984,2902,2955,5857,asian
18700,1898,2562,1847,3138,3169,6307,latino
18740,8227,6710,20508,17922,17523,35445,white non-hispanic
18740,74,67,255,162,234,396,black
18740,23,51,49,53,70,123,asian
18740,161,73,127,213,148,361,latino
18780,3185,2383,6818,5981,6405,12386,white non-hispanic
18780,44,11,71,50,76,126,black
18780,0,7,16,8,15,23,asian
18780,711,309,928,842,1106,1948,latino
18820,8226,7553,20963,18163,18579,36742,white non-hispanic
18820,86,51,171,119,189,308,black
18820,79,45,171,66,229,295,asian
18820,745,403,659,864,943,1807,latino
18860,3734,4496,12843,9580,11493,21073,white non-hispanic
18860,7,234,252,44,449,493,black
18860,193,215,368,476,300,776,asian
18860,1441,1827,2013,1842,3439,5281,latino
18880,41691,47757,121072,103766,106754,210520,white non-hispanic
18880,5432,6972,10031,10236,12199,22435,black
18880,971,1565,4042,4251,2327,6578,asian
18880,6894,6977,7052,9862,11061,20923,latino
18900,10006,9019,37392,28926,27491,56417,white non-hispanic
18900,113,84,186,110,273,383,black
18900,0,34,302,225,111,336,asian
18900,670,452,518,711,929,1640,latino
18980,17304,15742,45010,39516,38540,78056,white non-hispanic
18980,174,372,402,435,513,948,black
18980,183,90,255,355,173,528,asian
18980,1439,875,1152,1550,1916,3466,latino
19000,5268,10357,19252,17981,16896,34877,white non-hispanic
19000,375,614,242,740,491,1231,black
19000,137,152,125,189,225,414,asian
19000,897,936,458,1252,1039,2291,latino
19060,16668,19406,54121,45469,44726,90195,white non-hispanic
19060,890,3180,2766,1733,5103,6836,black
19060,99,278,318,402,293,695,asian
19060,463,520,512,628,867,1495,latino
19100,1243184,1131617,2555762,2486923,2443640,4930563,white non-hispanic
19100,298770,282903,511539,581155,512057,1093212,black
19100,109831,115486,223117,230604,217830,448434,asian
19100,724270,554039,740195,991376,1027128,2018504,latino
19140,33235,28736,68098,65569,64500,130069,white non-hispanic
19140,1192,1106,2185,2162,2321,4483,black
19140,476,319,787,903,679,1582,asian
19140,15933,11445,13796,19863,21311,41174,latino
19180,14071,12396,38986,33214,32239,65453,white non-hispanic
19180,3742,3068,4265,5324,5751,11075,black
19180,128,131,432,325,366,691,asian
19180,1544,1140,1152,1840,1996,3836,latino
19220,10460,10419,28584,25093,24370,49463,white non-hispanic
19220,446,717,1498,1220,1441,2661,black
19220,36,169,32,178,59,237,asian
19220,543,350,450,579,764,1343,latino
19260,12043,11116,42434,33883,31710,65593,white non-hispanic
19260,7659,7282,18786,17976,15751,33727,black
19260,132,158,348,380,258,638,asian
19260,1264,927,976,1546,1621,3167,latino
19300,36925,31685,107351,89824,86137,175961,white non-hispanic
19300,5477,4856,9081,10058,9356,19414,black
19300,334,86,985,858,547,1405,asian
19300,3332,2349,3348,4082,4947,9029,latino
19340,68882,66597,193025,167697,160807,328504,white non-hispanic
19340,9792,7519,11781,14260,14832,29092,black
19340,2276,2262,3669,4092,4115,8207,asian
19340,11977,8774,11717,15964,16504,32468,latino
19380,128334,137806,363268,321586,307822,629408,white non-hispanic
19380,30847,31742,60778,65758,57609,123367,black
19380,3410,4615,8947,9330,7642,16972,asian
19380,7292,5950,7284,9929,10597,20526,latino
19420,6862,6205,17684,15575,15176,30751,white non-hispanic
19420,155,232,333,432,288,720,black
19420,18,37,75,103,27,130,asian
19420,670,442,389,653,848,1501,latino
19460,26151,23766,72809,62300,60426,122726,white non-hispanic
19460,4565,4534,9492,9781,8810,18591,black
19460,253,278,266,376,421,797,asian
19460,4238,2939,3009,4667,5519,10186,latino
19500,16146,16648,51294,43696,40392,84088,white non-hispanic
19500,4472,3876,6673,8136,6885,15021,black
19500,278,351,594,720,503,1223,asian
19500,930,722,675,1244,1083,2327,latino
19540,10547,6755,16633,17095,16840,33935,white non-hispanic
19540,176,141,11,142,186,328,black
19540,36,54,42,97,35,132,asian
19540,588,405,561,779,775,1554,latino
19580,7824,7011,20031,17532,17334,34866,white non-hispanic
19580,220,255,266,317,424,741,black
19580,32,12,109,79,74,153,asian
19580,1343,927,1424,1779,1915,3694,latino
19620,13199,11277,20841,22246,23071,45317,white non-hispanic
19620,126,195,343,369,295,664,black
19620,48,98,137,184,99,283,asian
19620,12447,9625,17783,19976,19879,39855,latino
19660,83153,89815,343879,265006,251841,516847,white non-hispanic
19660,16326,18429,31245,34508,31492,66000,black
19660,2210,2881,6892,6560,5423,11983,asian
19660,21827,19022,36390,39126,38113,77239,latino
19700,5861,4609,11798,11358,10910,22268,white non-hispanic
19700,157,49,123,154,175,329,black
19700,0,62,68,41,89,130,asian
19700,5232,3900,6899,8016,8015,16031,latino
19740,503131,544749,1237454,1145110,1140224,2285334,white non-hispanic
19740,41345,40428,75008,76061,80720,156781,black
19740,25753,30739,56934,61311,52115,113426,asian
19740,217173,176523,247292,316991,323997,640988,latino
19760,7479,6297,16601,15091,15286,30377,white non-hispanic
19760,1071,1317,2249,2013,2624,4637,black
19760,5,48,87,122,18,140,asian
19760,494,371,478,697,646,1343,latino
19780,129407,123270,289181,276208,265650,541858,white non-hispanic
19780,10295,9262,11978,15193,16342,31535,black
19780,6657,7419,10129,12277,11928,24205,asian
19780,18311,12420,13956,21479,23208,44687,latino
19820,621322,598071,1780856,1520155,1480094,3000249,white non-hispanic
19820,244357,233506,482975,518818,442020,960838,black
19820,42695,44246,88027,88284,86684,174968,asian
19820,66934,47494,69530,91342,92616,183958,latino
19860,6717,7172,14054,13478,14465,27943,white non-hispanic
19860,89,269,180,101,437,538,black
19860,44,259,67,225,145,370,asian
19860,617,400,516,673,860,1533,latino
19940,6225,6091,19178,15415,16079,31494,white non-hispanic
19940,181,638,995,226,1588,1814,black
19940,38,50,147,105,130,235,asian
19940,618,648,775,881,1160,2041,latino
19980,9348,7460,14085,15129,15764,30893,white non-hispanic
19980,139,404,244,357,430,787,black
19980,63,142,288,184,309,493,asian
19980,7322,5111,6240,8795,9878,18673,latino
20020,22432,20280,64717,55057,52372,107429,white non-hispanic
20020,9530,8418,17098,18875,16171,35046,black
20020,212,267,526,565,440,1005,asian
20020,1789,1311,1705,2275,2530,4805,latino
20060,6871,6535,15672,14462,14616,29078,white non-hispanic
20060,3072,3483,5511,5740,6326,12066,black
20060,72,58,182,171,141,312,asian
20060,1864,1388,1618,2143,2727,4870,latino
20100,24430,25567,65734,59061,56670,115731,white non-hispanic
20100,10835,12244,20011,23055,20035,43090,black
20100,579,803,2102,1884,1600,3484,asian
20100,4091,3572,4157,5836,5984,11820,latino
20140,7415,6520,20795,17521,17209,34730,white non-hispanic
20140,5624,4803,10372,10833,9966,20799,black
20140,145,129,265,262,277,539,asian
20140,661,503,281,707,738,1445,latino
20180,14467,14486,47725,37716,38962,76678,white non-hispanic
20180,118,930,1163,216,1995,2211,black
20180,49,85,330,255,209,464,asian
20180,258,777,1295,506,1824,2330,latino
20220,19622,20133,50264,45728,44291,90019,white non-hispanic
20220,1146,950,695,1350,1441,2791,black
20220,264,505,440,609,600,1209,asian
20220,865,803,560,1026,1202,2228,latino
20260,48027,58550,150622,127937,129262,257199,white non-hispanic
20260,1268,1590,1429,1530,2757,4287,black
20260,515,1257,1067,1546,1293,2839,asian
20260,1616,1394,1372,2042,2340,4382,latino
20300,5040,3749,8056,8256,8589,16845,white non-hispanic
20300,280,398,258,356,580,936,black
20300,673,645,417,714,1021,1735,asian
20300,4415,3120,4385,5733,6187,11920,latino
20340,8164,7044,21989,19008,18189,37197,white non-hispanic
20340,176,166,452,379,415,794,black
20340,90,29,178,198,99,297,asian
20340,1297,847,1064,1602,1606,3208,latino
20380,21244,21054,44562,44004,42856,86860,white non-hispanic
20380,7425,6626,13192,13802,13441,27243,black
20380,337,392,673,891,511,1402,asian
20380,6599,4530,4667,7485,8311,15796,latino
20420,9027,10830,28442,23702,24597,48299,white non-hispanic
20420,74,124,76,98,176,274,black
20420,81,142,123,267,79,346,asian
20420,2133,1896,2817,3399,3447,6846,latino
20460,6762,7446,19411,17398,16221,33619,white non-hispanic
20460,236,301,297,396,438,834,black
20460,23,85,106,124,90,214,asian
20460,1055,762,726,1264,1279,2543,latino
20500,64759,86237,189658,175477,165177,340654,white non-hispanic
20500,33277,39522,74929,79757,67971,147728,black
20500,4866,10182,11204,13704,12548,26252,asian
20500,24076,17139,21290,29418,33087,62505,latino
20540,6871,6006,18230,16014,15093,31107,white non-hispanic
20540,1537,1128,2466,2787,2344,5131,black
20540,54,77,138,176,93,269,asian
20540,536,205,493,510,724,1234,latino
20580,17396,13149,23104,27078,26571,53649,white non-hispanic
20580,61,78,73,61,151,212,black
20580,50,38,165,106,147,253,asian
20580,17566,13462,23739,27672,27095,54767,latino
20660,5333,4876,20928,16510,14627,31137,white non-hispanic
20660,851,919,2572,2366,1976,4342,black
20660,137,134,263,287,247,534,asian
20660,898,704,825,1339,1088,2427,latino
20700,23924,26710,78112,65432,63314,128746,white non-hispanic
20700,5773,5778,12078,11693,11936,23629,black
20700,753,718,2317,2107,1681,3788,asian
20700,7734,6417,10829,12621,12359,24980,latino
20740,31579,40129,83218,77597,77329,154926,white non-hispanic
20740,229,711,768,433,1275,1708,black
20740,1236,1687,1502,2413,2012,4425,asian
20740,1310,1171,963,1603,1841,3444,latino
20780,10081,11198,26469,22237,25511,47748,white non-hispanic
20780,16,346,99,119,342,461,black
20780,94,175,199,267,201,468,asian
20780,5511,4242,6131,7575,8309,15884,latino
20820,7820,6922,18492,16717,16517,33234,white non-hispanic
20820,57,72,61,93,97,190,black
20820,17,31,33,43,38,81,asian
20820,254,174,233,313,348,661,latino
20900,8778,6983,17956,17022,16695,33717,white non-hispanic
20900,1566,1273,3078,3156,2761,5917,black
20900,0,22,16,14,24,38,asian
20900,5756,4219,6707,8248,8434,16682,latino
20940,34197,26522,56469,59971,57217,117188,white non-hispanic
20940,622,1728,2435,959,3826,4785,black
20940,529,526,1529,1258,1326,2584,asian
20940,46665,39018,64425,75454,74654,150108,latino
20980,5570,4950,15288,13023,12785,25808,white non-hispanic
20980,3592,2918,6577,6936,6151,13087,black
20980,11,111,95,135,82,217,asian
20980,660,507,349,756,760,1516,latino
21020,8660,7870,25136,21156,20510,41666,white non-hispanic
21020,4089,5114,9878,10127,8954,19081,black
21020,216,215,478,494,415,909,asian
21020,949,663,931,1379,1164,2543,latino
21060,29106,27606,68438,62594,62556,125150,white non-hispanic
21060,3307,3606,6995,6422,7486,13908,black
21060,460,564,1392,1527,889,2416,asian
21060,2752,2372,2435,3555,4004,7559,latino
21120,4780,4251,10095,9356,9770,19126,white non-hispanic
21120,65,336,371,141,631,772,black
21120,55,50,111,136,80,216,asian
21120,979,1256,1037,1167,2105,3272,latino
21140,46211,37442,94038,90162,87529,177691,white non-hispanic
21140,3530,2890,4728,5309,5839,11148,black
21140,393,699,999,1155,936,2091,asian
21140,13260,7988,9931,14816,16363,31179,latino
21180,5352,5689,17154,13791,14404,28195,white non-hispanic
21180,134,324,101,199,360,559,black
21180,60,47,43,134,16,150,asian
21180,83,136,33,154,98,252,latino
21220,12799,11165,23485,22552,24897,47449,white non-hispanic
21220,196,116,197,126,383,509,black
21220,105,119,299,355,168,523,asian
21220,4688,3489,4539,5913,6803,12716,latino
21260,6710,12455,19741,19345,19561,38906,white non-hispanic
21260,65,218,195,175,303,478,black
21260,120,343,368,431,400,831,asian
21260,1251,1519,1008,1927,1851,3778,latino
21300,15637,15578,45473,39415,37273,76688,white non-hispanic
21300,1077,1465,2680,1835,3387,5222,black
21300,435,370,583,713,675,1388,asian
21300,903,799,878,1132,1448,2580,latino
21340,188609,173127,318146,349854,330028,679882,white non-hispanic
21340,8000,9561,11217,12148,16630,28778,black
21340,1887,2892,4849,4870,4758,9628,asian
21340,203544,176049,309481,359365,329709,689074,latino
21380,6385,8486,14613,15303,14181,29484,white non-hispanic
21380,64,335,329,328,400,728,black
21380,140,314,252,413,293,706,asian
21380,2513,2020,2420,3468,3485,6953,latino
21420,11671,11295,28204,26023,25147,51170,white non-hispanic
21420,645,436,888,922,1047,1969,black
21420,126,77,284,321,166,487,asian
21420,3037,2116,2114,3512,3755,7267,latino
21460,8697,8063,22196,19483,19473,38956,white non-hispanic
21460,2169,2024,4641,4450,4384,8834,black
21460,84,107,468,443,216,659,asian
21460,1300,943,1159,1574,1828,3402,latino
21500,47411,54735,139917,123339,118724,242063,white non-hispanic
21500,5947,5991,7912,9584,10266,19850,black
21500,1265,1490,1732,2266,2221,4487,asian
21500,4462,3267,3423,5446,5706,11152,latino
21540,6573,5618,21975,17220,16946,34166,white non-hispanic
21540,13,48,35,17,79,96,black
21540,20,27,85,69,63,132,asian
21540,183,100,152,199,236,435,latino
21580,4822,3943,13320,11037,11048,22085,white non-hispanic
21580,70,74,84,105,123,228,black
21580,36,80,45,92,69,161,asian
21580,7135,5831,15209,14203,13972,28175,latino
21640,2119,2340,8650,6227,6882,13109,white non-hispanic
21640,3176,3571,6927,6471,7203,13674,black
21640,83,63,125,149,122,271,asian
21640,442,408,266,434,682,1116,latino
21660,56770,77291,184692,161938,156815,318753,white non-hispanic
21660,731,1713,1705,1676,2473,4149,black
21660,1285,4334,3705,5159,4165,9324,asian
21660,10723,9655,10275,15006,15647,30653,latino
21700,18631,27252,63463,54666,54680,109346,white non-hispanic
21700,165,758,686,664,945,1609,black
21700,1172,1297,1457,2088,1838,3926,asian
21700,4847,5354,4785,7365,7621,14986,latino
21740,5628,3890,9998,9563,9953,19516,white non-hispanic
21740,0,11,18,9,20,29,black
21740,0,9,16,23,2,25,asian
21740,768,376,739,818,1065,1883,latino
21780,59015,61082,159321,143438,135980,279418,white non-hispanic
21780,5791,5434,10104,10868,10461,21329,black
21780,858,1262,1936,2219,1837,4056,asian
21780,2736,1947,2404,3385,3702,7087,latino
21820,16958,24092,35139,34576,41613,76189,white non-hispanic
21820,765,1745,1741,1618,2633,4251,black
21820,523,1155,1454,1676,1456,3132,asian
21820,2434,3235,2045,3524,4190,7714,latino
21840,2727,2702,9510,7415,7524,14939,white non-hispanic
21840,501,227,324,234,818,1052,black
21840,23,676,231,273,657,930,asian
21840,233,136,149,190,328,518,latino
21860,4161,3438,11893,9854,9638,19492,white non-hispanic
21860,36,18,10,4,60,64,black
21860,53,68,64,117,68,185,asian
21860,322,337,170,336,493,829,latino
21900,10279,11877,30967,27029,26094,53123,white non-hispanic
21900,533,607,884,994,1030,2024,black
21900,130,43,204,243,134,377,asian
21900,235,159,286,309,371,680,latino
21980,4547,4275,11505,10113,10214,20327,white non-hispanic
21980,195,209,202,227,379,606,black
21980,65,195,326,372,214,586,asian
21980,1186,965,1063,1616,1598,3214,latino
22020,43875,64341,99627,103901,103942,207843,white non-hispanic
22020,3161,3718,2098,4385,4592,8977,black
22020,1124,2676,1907,2821,2886,5707,asian
22020,2755,2129,1994,3487,3391,6878,latino
22060,11928,14165,31290,28682,28701,57383,white non-hispanic
22060,881,1247,948,1203,1873,3076,black
22060,275,687,473,827,608,1435,asian
22060,2027,1508,1594,2381,2748,5129,latino
22100,13509,13539,34676,29881,31843,61724,white non-hispanic
22100,150,1546,1187,117,2766,2883,black
22100,0,195,164,31,328,359,asian
22100,339,308,346,442,551,993,latino
22140,16187,13552,37080,33855,32964,66819,white non-hispanic
22140,229,245,247,250,471,721,black
22140,181,167,422,415,355,770,asian
22140,9523,6209,9736,12531,12937,25468,latino
22180,43523,61659,88569,93363,100388,193751,white non-hispanic
22180,35816,38362,65044,72629,66593,139222,black
22180,1729,2606,4689,5479,3545,9024,asian
22180,15245,16015,12816,21186,22890,44076,latino
22220,103687,106192,221200,218057,213022,431079,white non-hispanic
22220,3903,4392,4155,5490,6960,12450,black
22220,4019,5359,5765,7451,7692,15143,asian
22220,31863,23030,26394,39490,41797,81287,latino
22260,11382,9134,34527,27402,27641,55043,white non-hispanic
22260,336,222,277,431,404,835,black
22260,103,100,160,197,166,363,asian
22260,746,512,612,886,984,1870,latino
22280,9237,7832,27841,22122,22788,44910,white non-hispanic
22280,74,137,334,196,349,545,black
22280,54,77,440,403,168,571,asian
22280,2935,2206,3345,4004,4482,8486,latino
22300,15017,15564,39342,35637,34286,69923,white non-hispanic
22300,267,285,535,431,656,1087,black
22300,332,521,522,652,723,1375,asian
22300,1398,1078,1418,1972,1922,3894,latino
22340,2404,1939,6026,5345,5024,10369,white non-hispanic
22340,1845,1236,3176,3428,2829,6257,black
22340,12,15,0,15,12,27,asian
22340,487,161,396,489,555,1044,latino
22380,14842,30172,43133,44070,44077,88147,white non-hispanic
22380,351,1039,596,1073,913,1986,black
22380,434,1271,885,1469,1121,2590,asian
22380,5759,6992,6514,9549,9716,19265,latino
22420,64708,60250,182721,157760,149919,307679,white non-hispanic
22420,22178,20046,40065,43976,38313,82289,black
22420,867,1012,2409,2390,1898,4288,asian
22420,4821,3712,5052,6877,6708,13585,latino
22500,23646,21831,68061,58918,54620,113538,white non-hispanic
22500,22728,20483,43032,47603,38640,86243,black
22500,436,616,1053,1024,1081,2105,asian
22500,1863,1217,1659,2527,2212,4739,latino
22520,24367,26196,73208,64339,59432,123771,white non-hispanic
22520,3884,4927,9227,9638,8400,18038,black
22520,192,137,571,546,354,900,asian
22520,1419,1041,1138,1727,1871,3598,latino
22540,19502,18920,56622,48340,46704,95044,white non-hispanic
22540,338,453,456,675,572,1247,black
22540,524,345,555,924,500,1424,asian
22540,2121,1460,1491,2560,2512,5072,latino
22580,11196,9969,36101,29435,27831,57266,white non-hispanic
22580,1633,1530,3572,3459,3276,6735,black
22580,38,72,196,200,106,306,asian
22580,1095,677,967,1270,1469,2739,latino
22620,1860,2085,7071,4914,6102,11016,white non-hispanic
22620,3820,3866,7140,6916,7910,14826,black
22620,59,48,33,28,112,140,asian
22620,113,217,374,132,572,704,latino
22660,58319,85158,158531,151435,150573,302008,white non-hispanic
22660,498,1481,1074,1195,1858,3053,black
22660,1241,2529,3027,3704,3093,6797,asian
22660,12411,11984,12598,18101,18892,36993,latino
22700,7034,7612,19313,16735,17224,33959,white non-hispanic
22700,547,585,595,680,1047,1727,black
22700,147,103,237,230,257,487,asian
22700,650,486,531,738,929,1667,latino
22780,8417,15636,15789,17212,22630,39842,white non-hispanic
22780,1366,3221,2033,2930,3690,6620,black
22780,59,684,641,732,652,1384,asian
22780,1552,3013,1205,2302,3468,5770,latino
22800,12107,10197,34713,28618,28399,57017,white non-hispanic
22800,210,219,582,319,692,1011,black
22800,74,55,168,112,185,297,asian
22800,540,319,667,676,850,1526,latino
22820,6131,5240,13230,12463,12138,24601,white non-hispanic
22820,235,234,398,363,504,867,black
22820,21,46,85,84,68,152,asian
22820,3663,2687,3705,4867,5188,10055,latino
22840,13777,11901,35737,31331,30084,61415,white non-hispanic
22840,225,214,601,612,428,1040,black
22840,5,147,56,90,118,208,asian
22840,4586,2739,2853,4798,5380,10178,latino
22860,9832,12179,17527,18572,20966,39538,white non-hispanic
22860,2023,2755,2825,3588,4015,7603,black
22860,165,314,483,543,419,962,asian
22860,1502,2175,1180,2103,2754,4857,latino
22900,48257,45135,125853,111914,107331,219245,white non-hispanic
22900,3333,2746,5300,5683,5696,11379,black
22900,1537,1855,3742,3796,3338,7134,asian
22900,10848,7393,8798,13003,14036,27039,latino
23060,82853,76043,192639,179287,172248,351535,white non-hispanic
23060,13050,10884,18531,22268,20197,42465,black
23060,4095,3669,5459,6815,6408,13223,asian
23060,11335,7369,9249,13793,14160,27953,latino
23140,7979,5925,16907,15661,15150,30811,white non-hispanic
23140,96,93,107,107,189,296,black
23140,8,33,49,63,27,90,asian
23140,2208,1258,1466,2312,2620,4932,latino
23180,13136,11709,37493,32387,29951,62338,white non-hispanic
23180,849,2299,2356,2795,2709,5504,black
23180,349,348,377,470,604,1074,asian
23180,748,548,591,894,993,1887,latino
23240,4607,3249,16175,12301,11730,24031,white non-hispanic
23240,0,15,19,1,33,34,black
23240,0,1,30,5,26,31,asian
23240,2013,1335,2501,2785,3064,5849,latino
23300,7623,6708,25030,20212,19149,39361,white non-hispanic
23300,1306,1047,2018,2202,2169,4371,black
23300,108,84,162,239,115,354,asian
23300,707,368,592,811,856,1667,latino
23340,7837,6851,19755,17647,16796,34443,white non-hispanic
23340,93,220,52,222,143,365,black
23340,71,13,141,157,68,225,asian
23340,1868,1113,1319,1942,2358,4300,latino
23380,11374,10095,32055,27042,26482,53524,white non-hispanic
23380,390,517,788,791,904,1695,black
23380,41,48,102,143,48,191,asian
23380,2120,1317,2340,2869,2908,5777,latino
23420,166875,147103,303344,312790,304532,617322,white non-hispanic
23420,14020,13337,20358,23228,24487,47715,black
23420,27199,29383,41384,50030,47936,97966,asian
23420,178090,142084,189268,251383,258059,509442,latino
23460,17254,16054,50128,42826,40610,83436,white non-hispanic
23460,4076,3968,7995,8608,7431,16039,black
23460,110,100,496,399,307,706,asian
23460,1617,1024,1153,1754,2040,3794,latino
23500,9225,8779,24365,21469,20900,42369,white non-hispanic
23500,2931,2978,5343,6262,4990,11252,black
23500,91,81,184,262,94,356,asian
23500,936,640,747,960,1363,2323,latino
23540,29709,70920,95856,100626,95859,196485,white non-hispanic
23540,13813,18109,21488,28342,25068,53410,black
23540,2421,7050,5811,7541,7741,15282,asian
23540,4976,12270,7760,12781,12225,25006,latino
23580,40879,34528,86807,81715,80499,162214,white non-hispanic
23580,3677,3863,6881,7413,7008,14421,black
23580,692,701,1935,1770,1558,3328,asian
23580,21138,14738,17768,25440,28204,53644,latino
23620,8274,7333,20220,18018,17809,35827,white non-hispanic
23620,254,220,508,525,457,982,black
23620,27,143,167,217,120,337,asian
23620,2743,1829,2202,3216,3558,6774,latino
23660,8062,8730,27484,22648,21628,44276,white non-hispanic
23660,1150,1771,1648,1560,3009,4569,black
23660,136,213,189,223,315,538,asian
23660,886,847,1110,1125,1718,2843,latino
23700,2718,2269,6854,6032,5809,11841,white non-hispanic
23700,128,75,194,180,217,397,black
23700,126,196,391,396,317,713,asian
23700,3889,2226,4182,5001,5296,10297,latino
23780,9096,7324,15409,16053,15776,31829,white non-hispanic
23780,151,375,315,183,658,841,black
23780,457,381,635,755,718,1473,asian
23780,7608,5091,6678,9404,9973,19377,latino
23820,6783,6402,28850,20863,21172,42035,white non-hispanic
23820,21,45,222,137,151,288,black
23820,122,192,394,491,217,708,asian
23820,1874,1396,2576,2709,3137,5846,latino
23860,6217,5266,27650,20337,18796,39133,white non-hispanic
23860,4543,4090,10571,10292,8912,19204,black
23860,61,24,145,140,90,230,asian
23860,715,552,571,837,1001,1838,latino
23900,17916,18482,57451,47840,46009,93849,white non-hispanic
23900,363,352,754,648,821,1469,black
23900,168,162,397,379,348,727,asian
23900,2791,1861,2239,3157,3734,6891,latino
23940,12628,11289,21610,21844,23683,45527,white non-hispanic
23940,50,49,44,70,73,143,black
23940,0,75,154,107,122,229,asian
23940,1683,1193,1176,1790,2262,4052,latino
23980,11581,9735,28723,25728,24311,50039,white non-hispanic
23980,406,346,1013,870,895,1765,black
23980,80,64,112,149,107,256,asian
23980,568,424,475,586,881,1467,latino
24020,22877,22714,74837,60793,59635,120428,white non-hispanic
24020,333,1272,1244,453,2396,2849,black
24020,242,257,488,615,372,987,asian
24020,885,1012,1255,1244,1908,3152,latino
24060,14740,14247,38142,32389,34740,67129,white non-hispanic
24060,136,232,139,75,432,507,black
24060,165,247,301,534,179,713,asian
24060,6704,5055,6259,8643,9375,18018,latino
24100,10256,9785,31069,25907,25203,51110,white non-hispanic
24100,260,280,458,349,649,998,black
24100,76,111,201,201,187,388,asian
24100,548,411,569,685,843,1528,latino
24140,16420,17464,42037,37899,38022,75921,white non-hispanic
24140,8517,8984,20386,20005,17882,37887,black
24140,216,388,875,852,627,1479,asian
24140,5738,4005,4266,6652,7357,14009,latino
24220,18272,28617,43947,44517,46319,90836,white non-hispanic
24220,829,1387,754,931,2039,2970,black
24220,368,842,842,1002,1050,2052,asian
24220,1791,1761,1200,2233,2519,4752,latino
24260,19393,15116,42537,38663,38383,77046,white non-hispanic
24260,555,512,428,668,827,1495,black
24260,198,132,455,373,412,785,asian
24260,6852,4681,5624,7977,9180,17157,latino
24300,30553,31805,77555,70755,69158,139913,white non-hispanic
24300,210,459,427,464,632,1096,black
24300,164,234,669,671,396,1067,asian
24300,7304,6088,7785,10417,10760,21177,latino
24330,8369,6853,26843,20818,21247,42065,white non-hispanic
24330,86,68,38,75,117,192,black
24330,55,40,94,95,94,189,asian
24330,255,90,253,270,328,598,latino
24340,199232,209872,471093,446066,434131,880197,white non-hispanic
24340,20295,19111,27900,33894,33412,67306,black
24340,6448,7935,12001,13937,12447,26384,asian
24340,38221,26353,31041,46671,48944,95615,latino
24380,2393,2721,7216,6023,6307,12330,white non-hispanic
24380,69,123,131,127,196,323,black
24380,0,15,115,123,7,130,asian
24380,2518,2640,5111,4658,5611,10269,latino
24420,14382,12551,50947,39940,37940,77880,white non-hispanic
24420,29,103,202,77,257,334,black
24420,43,122,382,413,134,547,asian
24420,2026,1459,2546,2871,3160,6031,latino
24460,5918,5096,14077,12668,12423,25091,white non-hispanic
24460,57,123,193,165,208,373,black
24460,0,9,39,38,10,48,asian
24460,1673,1053,1189,1791,2124,3915,latino
24500,15261,16570,40544,35799,36576,72375,white non-hispanic
24500,246,592,259,384,713,1097,black
24500,88,229,417,418,316,734,asian
24500,1234,1307,920,1602,1859,3461,latino
24540,65532,60475,127735,126467,127275,253742,white non-hispanic
24540,937,1312,950,1188,2011,3199,black
24540,1053,1110,1717,2022,1858,3880,asian
24540,29969,22827,30124,40450,42470,82920,latino
24580,58641,57649,159416,138791,136915,275706,white non-hispanic
24580,1823,2041,2262,2479,3647,6126,black
24580,2745,2750,2721,4202,4014,8216,asian
24580,9842,5978,6851,10853,11818,22671,latino
24620,12417,11944,40513,33052,31822,64874,white non-hispanic
24620,443,367,825,823,812,1635,black
24620,34,66,152,143,109,252,asian
24620,748,509,599,939,917,1856,latino
24640,11287,12350,42719,34063,32293,66356,white non-hispanic
24640,341,303,379,455,568,1023,black
24640,232,376,525,585,548,1133,asian
24640,947,790,932,1163,1506,2669,latino
24660,94434,95901,290424,247576,233183,480759,white non-hispanic
24660,49573,55674,95208,108339,92116,200455,black
24660,7381,7449,12040,13811,13059,26870,asian
24660,24619,16011,20608,29565,31673,61238,latino
24700,6265,5070,14101,12788,12648,25436,white non-hispanic
24700,46,59,72,64,113,177,black
24700,43,184,192,203,216,419,asian
24700,210,98,189,208,289,497,latino
24740,2327,2212,7903,6332,6110,12442,white non-hispanic
24740,10046,8152,16294,18689,15803,34492,black
24740,44,31,236,120,191,311,asian
24740,282,111,304,270,427,697,latino
24780,17337,34721,49789,52442,49405,101847,white non-hispanic
24780,16106,17430,27569,33641,27464,61105,black
24780,583,1030,1443,1530,1526,3056,asian
24780,4094,3078,3499,5125,5546,10671,latino
24820,12092,9061,29455,25697,24911,50608,white non-hispanic
24820,176,82,149,183,224,407,black
24820,54,30,96,96,84,180,asian
24820,315,137,310,359,403,762,latino
24860,143306,150743,384231,347069,331211,678280,white non-hispanic
24860,37020,37053,71336,77189,68220,145409,black
24860,3506,4412,7239,8155,7002,15157,asian
24860,20689,15741,20987,27250,30167,57417,latino
24900,2745,2462,8780,7142,6845,13987,white non-hispanic
24900,7407,6747,11323,13588,11889,25477,black
24900,114,0,171,95,190,285,asian
24900,333,270,220,470,353,823,latino
24940,12703,12311,37011,32336,29689,62025,white non-hispanic
24940,6985,7039,14950,15685,13289,28974,black
24940,140,155,424,387,332,719,asian
24940,1883,1134,1399,2281,2135,4416,latino
24980,2556,2073,7213,6242,5600,11842,white non-hispanic
24980,2355,2197,4698,4860,4390,9250,black
24980,0,0,0,0,0,0,asian
24980,32,33,27,43,49,92,latino
25020,11574,11545,26481,25207,24393,49600,white non-hispanic
25020,3639,4105,11822,10041,9525,19566,black
25020,0,31,64,92,3,95,asian
25020,17202,18126,43009,40218,38119,78337,latino
25060,60278,60277,158687,140397,138845,279242,white non-hispanic
25060,24243,21269,38350,44308,39554,83862,black
25060,1833,2373,4934,4884,4256,9140,asian
25060,6839,6167,7794,9712,11088,20800,latino
25100,3060,2982,7090,6377,6755,13132,white non-hispanic
25100,97,482,285,131,733,864,black
25100,170,135,332,252,385,637,asian
25100,3502,2733,3414,4466,5183,9649,latino
25180,47488,44456,129470,112424,108990,221414,white non-hispanic
25180,5412,7214,11421,9616,14431,24047,black
25180,1074,814,1970,2254,1604,3858,asian
25180,4174,2932,4078,5317,5867,11184,latino
25200,6327,4453,15228,12827,13181,26008,white non-hispanic
25200,0,58,6,6,58,64,black
25200,37,44,175,162,94,256,asian
25200,2434,1613,2147,2988,3206,6194,latino
25220,18494,20978,47083,43784,42771,86555,white non-hispanic
25220,11625,10714,15656,20377,17618,37995,black
25220,236,308,417,589,372,961,asian
25220,1747,1617,1910,2210,3064,5274,latino
25260,27549,26281,45287,46893,52224,99117,white non-hispanic
25260,1721,3069,4807,2876,6721,9597,black
25260,1130,1459,3105,2994,2700,5694,asian
25260,27260,23771,29684,36796,43919,80715,latino
25300,7907,7177,20966,18415,17635,36050,white non-hispanic
25300,452,453,749,874,780,1654,black
25300,74,37,143,125,129,254,asian
25300,193,211,188,310,282,592,latino
25420,88130,95700,274052,234159,223723,457882,white non-hispanic
25420,17527,16073,27105,30383,30322,60705,black
25420,4921,6007,9658,10652,9934,20586,asian
25420,12160,9604,11058,16100,16722,32822,latino
25460,9526,8034,25828,21933,21455,43388,white non-hispanic
25460,4,91,49,100,44,144,black
25460,126,11,94,203,28,231,asian
25460,355,223,396,539,435,974,latino
25500,22260,36114,58634,60870,56138,117008,white non-hispanic
25500,1192,2306,2225,2686,3037,5723,black
25500,459,1241,1024,1373,1351,2724,asian
25500,5143,4661,5217,7359,7662,15021,latino
25540,170532,193180,560623,475305,449030,924335,white non-hispanic
25540,33106,36209,65735,68830,66220,135050,black
25540,12987,18133,26000,29026,28094,57120,asian
25540,54624,50066,67759,87446,85003,172449,latino
25580,6702,6777,15966,14730,14715,29445,white non-hispanic
25580,99,89,39,76,151,227,black
25580,130,155,157,184,258,442,asian
25580,1248,813,911,1314,1658,2972,latino
25620,21883,25198,53606,51603,49084,100687,white non-hispanic
25620,12003,13425,16958,23239,19147,42386,black
25620,236,742,535,834,679,1513,asian
25620,1514,1321,1188,1959,2064,4023,latino
25700,5833,8433,13088,13679,13675,27354,white non-hispanic
25700,95,133,41,94,175,269,black
25700,0,359,45,270,134,404,asian
25700,639,731,239,695,914,1609,latino
25720,8999,5542,13481,13826,14196,28022,white non-hispanic
25720,6,20,0,0,26,26,black
25720,100,146,136,267,115,382,asian
25720,1717,884,1359,1924,2036,3960,latino
25740,15264,14311,43628,36866,36337,73203,white non-hispanic
25740,36,41,149,61,165,226,black
25740,79,207,178,261,203,464,asian
25740,828,667,815,1142,1168,2310,latino
25760,1391,1246,4436,3529,3544,7073,white non-hispanic
25760,3710,2612,5928,6670,5580,12250,black
25760,0,0,10,5,5,10,asian
25760,127,157,54,160,178,338,latino
25780,3839,3425,12286,10055,9495,19550,white non-hispanic
25780,5526,5111,11573,12230,9980,22210,black
25780,75,0,163,158,80,238,asian
25780,1468,878,903,1404,1845,3249,latino
25820,5300,3588,7656,8140,8404,16544,white non-hispanic
25820,48,68,105,60,161,221,black
25820,40,0,54,34,60,94,asian
25820,4987,3436,5151,6731,6843,13574,latino
25840,18761,16066,40299,36379,38747,75126,white non-hispanic
25840,74,236,320,129,501,630,black
25840,77,139,456,409,263,672,asian
25840,9222,6730,7899,11042,12809,23851,latino
25860,58042,54997,190922,155315,148646,303961,white non-hispanic
25860,5130,5806,13214,11759,12391,24150,black
25860,3405,3394,3798,5235,5362,10597,asian
25860,10409,6626,8626,12150,13511,25661,latino
25880,9705,8917,25890,22353,22159,44512,white non-hispanic
25880,124,80,142,80,266,346,black
25880,28,83,59,112,58,170,asian
25880,412,277,319,492,516,1008,latino
25900,8083,10310,48099,32454,34038,66492,white non-hispanic
25900,85,467,660,400,812,1212,black
25900,6226,6839,30577,23555,20087,43642,asian
25900,9862,6027,8634,12225,12298,24523,latino
25940,25009,29317,93717,74123,73920,148043,white non-hispanic
25940,11012,11734,22403,23728,21421,45149,black
25940,321,764,1319,1273,1131,2404,asian
25940,8614,7179,8031,10923,12901,23824,latino
25980,10764,13157,16706,19872,20755,40627,white non-hispanic
25980,8346,8893,12575,14893,14921,29814,black
25980,311,496,729,804,732,1536,asian
25980,3298,3806,2662,4586,5180,9766,latino
26020,18455,15037,27791,29701,31582,61283,white non-hispanic
26020,512,817,1295,1151,1473,2624,black
26020,0,0,31,13,18,31,asian
26020,14571,10785,14145,18909,20592,39501,latino
26090,25920,20561,61232,53949,53764,107713,white non-hispanic
26090,576,322,695,857,736,1593,black
26090,193,174,267,354,280,634,asian
26090,3349,2082,2794,4007,4218,8225,latino
26140,18801,17142,95656,68068,63531,131599,white non-hispanic
26140,896,792,2477,1934,2231,4165,black
26140,422,318,1614,1378,976,2354,asian
26140,1988,1452,4088,3759,3769,7528,latino
26220,4814,3945,11290,9973,10076,20049,white non-hispanic
26220,14,0,13,27,0,27,black
26220,69,115,245,224,205,429,asian
26220,2633,1960,2543,3338,3798,7136,latino
26260,4072,3156,11413,9362,9279,18641,white non-hispanic
26260,2583,1918,4914,5109,4306,9415,black
26260,40,52,49,77,64,141,asian
26260,1268,598,932,1445,1353,2798,latino
26300,15553,14798,53604,43575,40380,83955,white non-hispanic
26300,2166,1902,3933,3995,4006,8001,black
26300,165,130,203,325,173,498,asian
26300,2057,1380,1826,2501,2762,5263,latino
26340,7305,10526,18210,16729,19312,36041,white non-hispanic
26340,20,159,135,61,253,314,black
26340,104,659,298,333,728,1061,asian
26340,146,246,165,242,315,557,latino
26380,34901,35150,87574,79852,77773,157625,white non-hispanic
26380,10441,9473,14704,18313,16305,34618,black
26380,448,451,886,907,878,1785,asian
26380,3580,2862,3537,4272,5707,9979,latino
26420,1153292,1021371,2184448,2171843,2187268,4359111,white non-hispanic
26420,306847,302626,532224,601748,539949,1141697,black
26420,112275,122307,261317,254007,241892,495899,asian
26420,824104,663299,945248,1191933,1240718,2432651,latino
26460,9186,9310,36614,27716,27394,55110,white non-hispanic
26460,631,688,1460,1141,1638,2779,black
26460,239,269,557,557,508,1065,asian
26460,985,720,1080,1264,1521,2785,latino
26500,8206,8412,25348,20837,21129,41966,white non-hispanic
26500,154,1135,1157,249,2197,2446,black
26500,33,83,119,144,91,235,asian
26500,172,336,341,215,634,849,latino
26540,7652,7662,19933,17879,17368,35247,white non-hispanic
26540,134,66,118,189,129,318,black
26540,104,22,174,193,107,300,asian
26540,264,282,254,387,413,800,latino
26580,71690,69564,200845,175134,166965,342099,white non-hispanic
26580,1769,2576,3976,3547,4774,8321,black
26580,293,744,1274,1127,1184,2311,asian
26580,1271,1513,1323,1682,2425,4107,latino
26620,67031,65590,184287,159228,157680,316908,white non-hispanic
26620,23283,28440,45651,50780,46594,97374,black
26620,1787,2701,5711,5626,4573,10199,asian
26620,8342,6236,7479,10519,11538,22057,latino
26660,9922,19343,34997,28608,35654,64262,white non-hispanic
26660,2766,5900,8938,6704,10900,17604,black
26660,111,491,325,402,525,927,asian
26660,3434,4997,5500,5712,8219,13931,latino
26700,3821,3007,8743,7719,7852,15571,white non-hispanic
26700,21,1,50,10,62,72,black
26700,759,525,403,875,812,1687,asian
26700,750,646,248,722,922,1644,latino
26740,13123,11839,33432,29464,28930,58394,white non-hispanic
26740,314,674,803,385,1406,1791,black
26740,69,115,171,212,143,355,asian
26740,2116,1608,2012,2731,3005,5736,latino
26780,7803,6651,19675,17176,16953,34129,white non-hispanic
26780,35,62,21,28,90,118,black
26780,38,119,57,116,98,214,asian
26780,899,583,578,1019,1041,2060,latino
26820,38794,26809,60367,63141,62829,125970,white non-hispanic
26820,204,242,188,260,374,634,black
26820,144,258,634,508,528,1036,asian
26820,7234,4660,5017,8142,8769,16911,latino
26860,14832,21339,45715,41266,40620,81886,white non-hispanic
26860,125,1324,552,669,1332,2001,black
26860,167,344,430,467,474,941,asian
26860,297,494,307,395,703,1098,latino
26900,353239,339717,845121,782551,755526,1538077,white non-hispanic
26900,84607,76927,135117,156489,140162,296651,black
26900,15791,15982,25693,29840,27626,57466,asian
26900,52298,34807,42549,62709,66945,129654,latino
26940,1048,1471,4196,3085,3630,6715,white non-hispanic
26940,5166,5660,9085,9525,10386,19911,black
26940,9,8,20,14,23,37,asian
26940,144,145,145,292,142,434,latino
26960,13884,12360,32409,28547,30106,58653,white non-hispanic
26960,432,1139,1616,538,2649,3187,black
26960,30,121,97,175,73,248,asian
26960,1114,859,1027,1231,1769,3000,latino
26980,27164,47633,66384,71321,69860,141181,white non-hispanic
26980,3250,3281,2899,4448,4982,9430,black
26980,1705,4543,2859,4844,4263,9107,asian
26980,3071,3459,2639,4590,4579,9169,latino
27020,5533,4953,18652,14516,14622,29138,white non-hispanic
27020,38,75,52,32,133,165,black
27020,20,54,73,101,46,147,asian
27020,168,135,99,212,190,402,latino
27060,12320,30101,41537,43134,40824,83958,white non-hispanic
27060,571,2092,1519,2071,2111,4182,black
27060,1335,7013,2448,5064,5732,10796,asian
27060,1003,2954,1068,2568,2457,5025,latino
27100,28804,28098,82145,69309,69738,139047,white non-hispanic
27100,3512,3820,5875,5341,7866,13207,black
27100,294,284,611,670,519,1189,asian
27100,1959,1558,1887,2605,2799,5404,latino
27140,58839,56007,161078,141279,134645,275924,white non-hispanic
27140,78460,77014,129025,151270,133229,284499,black
27140,1481,2019,3014,3518,2996,6514,asian
27140,4663,3802,4606,6096,6975,13071,latino
27160,7510,6342,17750,16134,15468,31602,white non-hispanic
27160,33,36,198,140,127,267,black
27160,0,0,35,23,12,35,asian
27160,119,99,113,152,179,331,latino
27180,17012,18214,49315,43806,40735,84541,white non-hispanic
27180,10550,10676,18785,21813,18198,40011,black
27180,273,365,512,501,649,1150,asian
27180,2372,1458,1632,2622,2840,5462,latino
27220,6226,6881,17186,14439,15854,30293,white non-hispanic
27220,95,14,57,39,127,166,black
27220,136,266,115,231,286,517,asian
27220,1921,1422,1928,2447,2824,5271,latino
27260,202750,223327,587280,512823,500534,1013357,white non-hispanic
27260,86836,81669,143111,165515,146101,311616,black
27260,11393,13243,30637,29999,25274,55273,asian
27260,35157,34165,49318,58969,59671,118640,latino
27300,6985,7657,21664,18431,17875,36306,white non-hispanic
27300,382,990,789,717,1444,2161,black
27300,39,106,102,134,113,247,asian
27300,297,324,242,264,599,863,latino
27340,32791,61265,49797,62425,81428,143853,white non-hispanic
27340,6123,10318,11177,12705,14913,27618,black
27340,797,1451,1832,2455,1625,4080,asian
27340,7239,11843,4392,9790,13684,23474,latino
27380,10707,8275,22925,20750,21157,41907,white non-hispanic
27380,1584,1760,3710,3317,3737,7054,black
27380,68,77,172,194,123,317,asian
27380,4688,3080,3837,5291,6314,11605,latino
27420,3904,4340,11465,9772,9937,19709,white non-hispanic
27420,37,99,99,68,167,235,black
27420,0,85,33,62,56,118,asian
27420,177,282,20,157,322,479,latino
27460,24074,25315,71970,61815,59544,121359,white non-hispanic
27460,736,1320,1403,1489,1970,3459,black
27460,143,347,291,467,314,781,asian
27460,3423,2849,3155,4574,4853,9427,latino
27500,31246,29358,82675,72794,70485,143279,white non-hispanic
27500,1943,1951,3226,3566,3554,7120,black
27500,440,556,903,1151,748,1899,asian
27500,5702,3621,4250,6508,7065,13573,latino
27540,11915,9666,30480,26206,25855,52061,white non-hispanic
27540,155,39,168,118,244,362,black
27540,185,17,194,160,236,396,asian
27540,1338,771,954,1338,1725,3063,latino
27580,3346,2816,6745,6643,6264,12907,white non-hispanic
27580,30,32,54,34,82,116,black
27580,0,4,0,4,0,4,asian
27580,3614,3660,8004,7569,7709,15278,latino
27600,13727,11044,31197,28410,27558,55968,white non-hispanic
27600,1053,1061,2319,2201,2232,4433,black
27600,271,271,560,592,510,1102,asian
27600,1697,1099,1720,2253,2263,4516,latino
27620,28965,28084,76039,66054,67034,133088,white non-hispanic
27620,2621,4209,4687,4561,6956,11517,black
27620,345,435,660,845,595,1440,asian
27620,1461,1064,1322,1802,2045,3847,latino
27660,6117,5236,13876,12847,12382,25229,white non-hispanic
27660,1348,1220,2547,2590,2525,5115,black
27660,56,19,64,81,58,139,asian
27660,257,232,220,276,433,709,latino
27700,5164,4532,12598,11029,11265,22294,white non-hispanic
27700,1633,1463,2870,2739,3227,5966,black
27700,19,33,86,63,75,138,asian
27700,607,551,699,833,1024,1857,latino
27740,35219,41469,110997,96206,91479,187685,white non-hispanic
27740,1263,1883,2782,2650,3278,5928,black
27740,587,756,964,1264,1043,2307,asian
27740,2201,1848,1841,2826,3064,5890,latino
27780,23140,24394,79871,65220,62185,127405,white non-hispanic
27780,1191,1223,2107,1926,2595,4521,black
27780,114,205,356,351,324,675,asian
27780,666,569,861,940,1156,2096,latino
27860,22817,24669,57182,53516,51152,104668,white non-hispanic
27860,4885,5672,4772,8077,7252,15329,black
27860,183,656,368,535,672,1207,asian
27860,2425,1407,1947,2613,3166,5779,latino
27900,38347,35041,86628,81834,78182,160016,white non-hispanic
27900,976,977,1177,1637,1493,3130,black
27900,522,629,948,1244,855,2099,asian
27900,5139,3301,3668,5969,6139,12108,latino
27920,7439,9108,8418,11739,13226,24965,white non-hispanic
27920,1755,2435,2005,2845,3350,6195,black
27920,136,338,645,662,457,1119,asian
27920,2134,2164,1304,2666,2936,5602,latino
27940,4048,5193,13119,10760,11600,22360,white non-hispanic
27940,32,123,188,127,216,343,black
27940,576,498,1307,1259,1122,2381,asian
27940,715,667,685,912,1155,2067,latino
27980,8529,10027,39737,28626,29667,58293,white non-hispanic
27980,131,260,542,336,597,933,black
27980,7371,8390,31857,24621,22997,47618,asian
27980,6771,4446,6917,8985,9149,18134,latino
28020,55811,71790,148921,140605,135917,276522,white non-hispanic
28020,8441,9330,12998,16172,14597,30769,black
28020,1257,2560,2888,3370,3335,6705,asian
28020,7900,6475,6268,10003,10640,20643,latino
28060,19885,16983,54199,45609,45458,91067,white non-hispanic
28060,33,45,181,25,234,259,black
28060,135,73,232,288,152,440,asian
28060,833,820,871,1260,1264,2524,latino
28100,19171,19153,50144,44993,43475,88468,white non-hispanic
28100,5110,4220,7506,8652,8184,16836,black
28100,266,226,589,545,536,1081,asian
28100,4296,3145,3701,5254,5888,11142,latino
28140,375249,350377,915438,834401,806663,1641064,white non-hispanic
28140,72234,63908,123982,136160,123964,260124,black
28140,14214,17149,25739,29221,27881,57102,asian
28140,69744,48669,65765,89799,94379,184178,latino
28180,3386,3753,16162,11764,11537,23301,white non-hispanic
28180,61,131,299,183,308,491,black
28180,4052,4575,16111,12867,11871,24738,asian
28180,3030,1806,2818,3834,3820,7654,latino
28260,11922,14238,25643,26223,25580,51803,white non-hispanic
28260,76,441,94,209,402,611,black
28260,47,276,318,274,367,641,asian
28260,1801,1458,1352,2242,2369,4611,latino
28300,12870,17182,42637,37257,35432,72689,white non-hispanic
28300,70,390,122,251,331,582,black
28300,231,349,390,493,477,970,asian
28300,430,511,361,644,658,1302,latino
28340,11603,9264,25166,22992,23041,46033,white non-hispanic
28340,48,55,80,33,150,183,black
28340,86,56,169,180,131,311,asian
28340,1987,1227,1611,2309,2516,4825,latino
28380,6057,4849,15212,13588,12530,26118,white non-hispanic
28380,955,797,1251,1574,1429,3003,black
28380,84,23,18,79,46,125,asian
28380,931,423,612,962,1004,1966,latino
28420,57093,47851,112015,107903,109056,216959,white non-hispanic
28420,1731,1234,2089,1979,3075,5054,black
28420,1537,1232,4038,3444,3363,6807,asian
28420,35779,24596,26118,42224,44269,86493,latino
28500,8722,8089,29163,24108,21866,45974,white non-hispanic
28500,201,186,362,332,417,749,black
28500,125,141,246,328,184,512,asian
28500,4314,3480,5469,6646,6617,13263,latino
28540,1713,1923,5598,4427,4807,9234,white non-hispanic
28540,8,23,44,12,63,75,black
28540,213,253,637,540,563,1103,asian
28540,231,135,289,316,339,655,latino
28580,9488,12514,46023,32293,35732,68025,white non-hispanic
28580,1263,1476,2790,2502,3027,5529,black
28580,159,237,541,560,377,937,asian
28580,4137,4377,9507,8693,9328,18021,latino
28620,6091,5755,22825,17407,17264,34671,white non-hispanic
28620,411,519,1288,804,1414,2218,black
28620,9,62,158,152,77,229,asian
28620,1062,691,1078,1323,1508,2831,latino
28660,71649,82129,134792,143248,145322,288570,white non-hispanic
28660,25565,27572,34726,43476,44387,87863,black
28660,2055,3358,5987,6669,4731,11400,asian
28660,34154,31246,32840,48314,49926,98240,latino
28700,55747,53151,182797,149835,141860,291695,white non-hispanic
28700,1319,1548,3143,2930,3080,6010,black
28700,354,301,884,937,602,1539,asian
28700,1924,1069,1757,2211,2539,4750,latino
28740,25828,31449,96785,78962,75100,154062,white non-hispanic
28740,1931,2991,5390,4355,5957,10312,black
28740,833,1280,1740,2140,1713,3853,asian
28740,5284,5303,7127,8329,9385,17714,latino
28780,7032,9324,11786,13956,14186,28142,white non-hispanic
28780,221,534,437,476,716,1192,black
28780,52,321,260,219,414,633,asian
28780,6357,7895,9066,11645,11673,23318,latino
28820,6389,6117,19388,16297,15597,31894,white non-hispanic
28820,5459,4404,12928,12339,10452,22791,black
28820,64,22,233,211,108,319,asian
28820,1684,1359,1321,1915,2449,4364,latino
28860,5365,9490,12937,14543,13249,27792,white non-hispanic
28860,113,465,76,225,429,654,black
28860,24,532,86,546,96,642,asian
28860,215,367,46,368,260,628,latino
28900,11829,11611,34791,29154,29077,58231,white non-hispanic
28900,195,102,207,229,275,504,black
28900,186,66,385,377,260,637,asian
28900,3060,2332,2734,3875,4251,8126,latino
28940,155307,167666,451201,396550,377624,774174,white non-hispanic
28940,12549,13587,23218,25197,24157,49354,black
28940,2661,3867,6063,6646,5945,12591,asian
28940,11718,9239,9851,14674,16134,30808,latino
29020,15522,13856,43036,37613,34801,72414,white non-hispanic
29020,1610,1500,2906,2907,3109,6016,black
29020,325,256,460,630,411,1041,asian
29020,945,756,901,1239,1363,2602,latino
29060,10948,10167,37246,29678,28683,58361,white non-hispanic
29060,44,49,197,121,169,290,black
29060,82,164,333,439,140,579,asian
29060,354,240,357,492,459,951,latino
29100,23721,33561,68067,64228,61121,125349,white non-hispanic
29100,561,617,536,740,974,1714,black
29100,1666,2130,1498,2758,2536,5294,asian
29100,789,865,630,1108,1176,2284,latino
29180,77585,80228,186725,174858,169680,344538,white non-hispanic
29180,35331,32346,52270,63195,56752,119947,black
29180,2156,2020,3958,4178,3956,8134,asian
29180,6108,5752,6940,8789,10011,18800,latino
29200,37208,60332,84938,90386,92092,182478,white non-hispanic
29200,2584,3871,2573,4611,4417,9028,black
29200,2178,9507,3246,6466,8465,14931,asian
29200,6192,5235,4930,7796,8561,16357,latino
29260,5129,5322,13351,12055,11747,23802,white non-hispanic
29260,52,109,58,120,99,219,black
29260,48,44,154,162,84,246,asian
29260,435,404,343,537,645,1182,latino
29300,9247,8589,23119,21097,19858,40955,white non-hispanic
29300,6730,6595,11147,13072,11400,24472,black
29300,273,327,783,643,740,1383,asian
29300,956,800,807,1278,1285,2563,latino
29340,33325,33330,79670,74640,71685,146325,white non-hispanic
29340,13922,12636,22751,25595,23714,49309,black
29340,598,873,1245,1484,1232,2716,asian
29340,2276,1783,2713,3254,3518,6772,latino
29380,10975,10634,31336,26155,26790,52945,white non-hispanic
29380,2801,3658,5738,5375,6822,12197,black
29380,137,89,414,406,234,640,asian
29380,1160,1175,1642,1827,2150,3977,latino
29420,32339,28816,123887,91831,93211,185042,white non-hispanic
29420,400,654,1154,857,1351,2208,black
29420,509,322,1697,1589,939,2528,asian
29420,9718,8575,14298,15535,17056,32591,latino
29460,105120,102745,302689,259763,250791,510554,white non-hispanic
29460,28315,25244,45796,51476,47879,99355,black
29460,1803,2296,6846,6116,4829,10945,asian
29460,45044,35213,54142,65865,68534,134399,latino
29500,2788,2262,5189,4937,5302,10239,white non-hispanic
29500,7,496,282,90,695,785,black
29500,73,19,20,71,41,112,asian
29500,2282,2092,3016,3425,3965,7390,latino
29540,107615,101672,265858,243361,231784,475145,white non-hispanic
29540,7374,6452,9074,10864,12036,22900,black
29540,2863,3174,5456,6140,5353,11493,asian
29540,19256,15217,19319,26786,27006,53792,latino
29620,72717,103998,204614,195752,185577,381329,white non-hispanic
29620,10210,13014,17195,20420,19999,40419,black
29620,3722,9816,7243,10591,10190,20781,asian
29620,9783,10012,11019,15392,15422,30814,latino
29660,5270,15045,13749,16204,17860,34064,white non-hispanic
29660,120,331,105,278,278,556,black
29660,128,703,304,553,582,1135,asian
29660,937,1358,1233,1681,1847,3528,latino
29700,87731,63240,105649,131701,124919,256620,white non-hispanic
29700,388,224,477,540,549,1089,black
29700,214,316,877,782,625,1407,asian
29700,88509,64202,104771,132262,125220,257482,latino
29740,47105,51872,89934,96329,92582,188911,white non-hispanic
29740,800,1325,1684,1640,2169,3809,black
29740,322,901,871,1189,905,2094,asian
29740,43733,41347,59702,74599,70183,144782,latino
29780,2772,2673,8700,6977,7168,14145,white non-hispanic
29780,149,180,47,123,253,376,black
29780,29,214,90,108,225,333,asian
29780,4716,4981,12182,10962,10917,21879,latino
29820,274162,281749,745132,640665,660378,1301043,white non-hispanic
29820,62828,62749,111966,120148,117395,237543,black
29820,33746,48087,121773,112291,91315,203606,asian
29820,215583,181331,251297,320741,327470,648211,latino
29860,12282,10800,31446,27460,27068,54528,white non-hispanic
29860,8290,7110,13378,15200,13578,28778,black
29860,66,131,168,177,188,365,asian
29860,1344,716,861,1199,1722,2921,latino
29900,2890,2978,10053,8135,7786,15921,white non-hispanic
29900,3462,3257,7007,6831,6895,13726,black
29900,71,74,110,134,121,255,asian
29900,351,226,427,430,574,1004,latino
29940,17454,36691,43613,49476,48282,97758,white non-hispanic
29940,993,2248,1599,2143,2697,4840,black
29940,778,3255,1684,2681,3036,5717,asian
29940,2109,3066,1934,3728,3381,7109,latino
29980,9942,7753,22844,20724,19815,40539,white non-hispanic
29980,270,161,385,272,544,816,black
29980,36,68,83,117,70,187,asian
29980,363,202,283,311,537,848,latino
30020,17242,23129,42434,39695,43110,82805,white non-hispanic
30020,5606,6892,8821,10124,11195,21319,black
30020,379,768,1775,1778,1144,2922,asian
30020,5592,5588,4866,7591,8455,16046,latino
30060,8236,6608,19137,17309,16672,33981,white non-hispanic
30060,44,36,108,51,137,188,black
30060,17,40,68,102,23,125,asian
30060,318,239,262,410,409,819,latino
30140,25040,22897,72144,61261,58820,120081,white non-hispanic
30140,915,783,1323,1317,1704,3021,black
30140,466,480,859,1041,764,1805,asian
30140,6532,4585,5678,8311,8484,16795,latino
30220,5353,5242,10238,10462,10371,20833,white non-hispanic
30220,237,227,410,427,447,874,black
30220,3,33,12,30,18,48,asian
30220,3684,3128,4109,5449,5472,10921,latino
30260,7409,9785,22190,19410,19974,39384,white non-hispanic
30260,81,923,1986,209,2781,2990,black
30260,177,387,219,407,376,783,asian
30260,347,1150,1064,544,2017,2561,latino
30280,6535,5690,16273,14530,13968,28498,white non-hispanic
30280,623,508,1283,1119,1295,2414,black
30280,20,10,109,71,68,139,asian
30280,644,411,513,701,867,1568,latino
30300,11391,11467,33848,28949,27757,56706,white non-hispanic
30300,107,58,96,133,128,261,black
30300,92,216,255,321,242,563,asian
30300,851,755,692,1409,889,2298,latino
30340,19714,20357,58651,50480,48242,98722,white non-hispanic
30340,860,512,532,957,947,1904,black
30340,188,384,324,496,400,896,asian
30340,755,451,721,987,940,1927,latino
30380,9988,8147,26972,23010,22097,45107,white non-hispanic
30380,81,114,111,77,229,306,black
30380,49,115,98,169,93,262,asian
30380,296,206,168,277,393,670,latino
30420,6235,4542,12677,11720,11734,23454,white non-hispanic
30420,400,699,316,525,890,1415,black
30420,2,3,14,17,2,19,asian
30420,3041,2051,2876,3819,4149,7968,latino
30460,82677,106694,217232,208452,198151,406603,white non-hispanic
30460,14256,14477,25857,27755,26835,54590,black
30460,2554,4341,5887,6790,5992,12782,asian
30460,11654,8829,9378,13471,16390,29861,latino
30580,4086,3611,6165,6893,6969,13862,white non-hispanic
30580,325,389,354,530,538,1068,black
30580,168,129,380,347,330,677,asian
30580,5292,3917,4473,6491,7191,13682,latino
30620,18576,18786,49145,43028,43479,86507,white non-hispanic
30620,3332,2940,5988,5821,6439,12260,black
30620,153,199,404,477,279,756,asian
30620,1073,970,952,1267,1728,2995,latino
30660,5229,5633,15186,13235,12813,26048,white non-hispanic
30660,22,836,1140,1075,923,1998,black
30660,57,23,157,107,130,237,asian
30660,211,403,388,471,531,1002,latino
30700,60182,80284,141042,140923,140585,281508,white non-hispanic
30700,3770,4409,4326,5489,7016,12505,black
30700,2926,5099,5061,6537,6549,13086,asian
30700,8153,6601,6293,10122,10925,21047,latino
30780,110977,118157,290017,264050,255101,519151,white non-hispanic
30780,48040,45380,74755,90642,77533,168175,black
30780,2467,3438,5838,6299,5444,11743,asian
30780,14585,11063,11795,17138,20305,37443,latino
30820,7714,9671,20464,19378,18471,37849,white non-hispanic
30820,55,333,206,163,431,594,black
30820,68,51,158,153,124,277,asian
30820,167,241,152,233,327,560,latino
30860,37080,38261,45668,60477,60532,121009,white non-hispanic
30860,367,324,297,340,648,988,black
30860,542,1133,866,1168,1373,2541,asian
30860,5605,4215,3717,6673,6864,13537,latino
30880,6723,6172,20345,16861,16379,33240,white non-hispanic
30880,78,37,464,247,332,579,black
30880,42,37,54,51,82,133,asian
30880,88,68,133,143,146,289,latino
30900,6660,5876,19309,16266,15579,31845,white non-hispanic
30900,130,180,216,175,351,526,black
30900,103,243,257,404,199,603,asian
30900,2270,1458,1839,2636,2931,5567,latino
30940,29144,26328,68042,63162,60352,123514,white non-hispanic
30940,271,392,585,420,828,1248,black
30940,155,84,240,289,190,479,asian
30940,721,520,437,772,906,1678,latino
30980,39757,36692,91602,83871,84180,168051,white non-hispanic
30980,9668,9403,18767,19199,18639,37838,black
30980,532,516,981,1001,1028,2029,asian
30980,13767,9373,11131,16053,18218,34271,latino
31020,20209,17806,55554,47317,46252,93569,white non-hispanic
31020,169,248,405,343,479,822,black
31020,290,231,834,769,586,1355,asian
31020,3895,2381,2660,4320,4616,8936,latino
31060,3541,2421,9649,7787,7824,15611,white non-hispanic
31060,0,12,43,22,33,55,black
31060,287,253,534,513,561,1074,asian
31060,955,684,1471,1622,1488,3110,latino
31080,1511346,1751618,3930355,3606511,3586808,7193319,white non-hispanic
31080,181261,227227,473755,464131,418112,882243,black
31080,352149,502733,1226804,1105345,976341,2081686,asian
31080,1742284,1688340,2542127,2990913,2981838,5972751,latino
31140,215253,218523,592994,522738,504032,1026770,white non-hispanic
31140,49638,44841,86635,94955,86159,181114,black
31140,6322,7114,10931,12855,11512,24367,asian
31140,21038,15553,20643,27013,30221,57234,latino
31180,57571,78236,113901,127472,122236,249708,white non-hispanic
31180,6275,7004,8745,10914,11110,22024,black
31180,1165,2627,2596,3106,3282,6388,asian
31180,35560,33457,39747,54385,54379,108764,latino
31220,5442,4824,17234,13883,13617,27500,white non-hispanic
31220,123,75,75,120,153,273,black
31220,36,38,65,78,61,139,asian
31220,510,301,475,642,644,1286,latino
31260,17258,14305,36905,34767,33701,68468,white non-hispanic
31260,3588,3247,6178,6899,6114,13013,black
31260,244,124,565,553,380,933,asian
31260,7239,4920,6712,9216,9655,18871,latino
31300,7667,8039,23183,20109,18780,38889,white non-hispanic
31300,8056,8126,16126,17009,15299,32308,black
31300,270,256,370,456,440,896,asian
31300,5431,2716,3291,5370,6068,11438,latino
31340,37695,48578,116090,104494,97869,202363,white non-hispanic
31340,10294,11640,22443,23381,20996,44377,black
31340,887,1256,1759,2179,1723,3902,asian
31340,1952,2629,2001,3386,3196,6582,latino
31380,4591,9856,14075,14422,14100,28522,white non-hispanic
31380,157,1158,232,806,741,1547,black
31380,138,300,251,370,319,689,asian
31380,170,551,130,474,377,851,latino
31420,23368,23885,70867,60197,57923,118120,white non-hispanic
31420,28721,25343,49248,55081,48231,103312,black
31420,731,889,1869,1862,1627,3489,asian
31420,2085,1617,2328,2873,3157,6030,latino
31460,33287,26612,58491,60891,57499,118390,white non-hispanic
31460,793,1285,2860,3400,1538,4938,black
31460,753,845,1705,1580,1723,3303,asian
31460,31208,24681,31963,43918,43934,87852,latino
31500,6242,6812,17730,15980,14804,30784,white non-hispanic
31500,178,198,286,447,215,662,black
31500,93,35,135,150,113,263,asian
31500,252,359,235,483,363,846,latino
31540,107606,143233,300582,278164,273257,551421,white non-hispanic
31540,8734,8909,10153,13388,14408,27796,black
31540,6693,13403,10257,15349,15004,30353,asian
31540,13799,11142,11330,17138,19133,36271,latino
31580,9011,7997,24392,21195,20205,41400,white non-hispanic
31580,552,763,1559,1437,1437,2874,black
31580,119,45,87,230,21,251,asian
31580,391,235,269,406,489,895,latino
31620,2705,3896,7955,7451,7105,14556,white non-hispanic
31620,2138,2380,3868,4479,3907,8386,black
31620,73,83,108,136,128,264,asian
31620,191,195,224,360,250,610,latino
31660,8343,9183,24613,20214,21925,42139,white non-hispanic
31660,74,1702,1249,294,2731,3025,black
31660,33,34,160,154,73,227,asian
31660,288,560,892,256,1484,1740,latino
31680,5781,5797,16841,13759,14660,28419,white non-hispanic
31680,747,1058,1861,1676,1990,3666,black
31680,17,42,34,17,76,93,asian
31680,421,335,371,477,650,1127,latino
31700,74187,77960,214817,185053,181911,366964,white non-hispanic
31700,3167,2832,4310,4750,5559,10309,black
31700,3581,4373,7469,7929,7494,15423,asian
31700,8870,7468,9091,12521,12908,25429,latino
31740,15914,36631,31635,39793,44387,84180,white non-hispanic
31740,996,2623,1434,2124,2929,5053,black
31740,531,2319,1067,2016,1901,3917,asian
31740,2081,3560,1722,3263,4100,7363,latino
31820,15055,13196,47078,37876,37453,75329,white non-hispanic
31820,192,226,153,238,333,571,black
31820,756,726,614,1081,1015,2096,asian
31820,1322,761,862,1344,1601,2945,latino
31860,17711,29210,44356,45602,45675,91277,white non-hispanic
31860,987,1182,1044,1499,1714,3213,black
31860,393,961,598,1080,872,1952,asian
31860,1248,1313,1001,1690,1872,3562,latino
31900,22167,20255,63079,53380,52121,105501,white non-hispanic
31900,1821,2978,4679,3611,5867,9478,black
31900,194,242,516,532,420,952,asian
31900,743,679,729,991,1160,2151,latino
31930,11587,11496,35443,29792,28734,58526,white non-hispanic
31930,167,176,394,382,355,737,black
31930,54,192,121,120,247,367,asian
31930,225,165,236,223,403,626,latino
31940,11460,10087,39948,30544,30951,61495,white non-hispanic
31940,122,110,108,130,210,340,black
31940,88,93,148,154,175,329,asian
31940,375,248,396,525,494,1019,latino
31980,11475,14001,34029,31289,28216,59505,white non-hispanic
31980,1428,1140,2528,2617,2479,5096,black
31980,106,247,225,326,252,578,asian
31980,1056,822,924,1424,1378,2802,latino
32000,8052,7404,25676,20777,20355,41132,white non-hispanic
32000,356,569,810,667,1068,1735,black
32000,61,41,225,226,101,327,asian
32000,1221,563,932,1107,1609,2716,latino
32020,12077,12100,34643,28702,30118,58820,white non-hispanic
32020,186,1264,2008,690,2768,3458,black
32020,50,57,237,164,180,344,asian
32020,674,494,470,670,968,1638,latino
32100,11016,16711,34928,31424,31231,62655,white non-hispanic
32100,44,617,442,193,910,1103,black
32100,152,186,246,352,232,584,asian
32100,324,337,303,456,508,964,latino
32140,5128,5288,12303,11495,11224,22719,white non-hispanic
32140,349,259,254,355,507,862,black
32140,331,386,252,405,564,969,asian
32140,676,473,455,815,789,1604,latino
32180,4144,4290,11227,9938,9723,19661,white non-hispanic
32180,197,442,445,524,560,1084,black
32180,32,47,115,90,104,194,asian
32180,837,561,833,1153,1078,2231,latino
32220,12047,9670,26900,24560,24057,48617,white non-hispanic
32220,3445,3353,7394,7577,6615,14192,black
32220,206,20,242,248,220,468,asian
32220,3707,2211,2549,4107,4360,8467,latino
32260,7877,6381,19811,17107,16962,34069,white non-hispanic
32260,92,174,166,201,231,432,black
32260,368,527,431,649,677,1326,asian
32260,3725,2231,2439,3968,4427,8395,latino
32280,5637,7821,16379,15279,14558,29837,white non-hispanic
32280,561,1220,1152,1601,1332,2933,black
32280,5,0,38,8,35,43,asian
32280,270,291,209,308,462,770,latino
32300,7746,7155,29021,22948,20974,43922,white non-hispanic
32300,3960,3512,10224,9485,8211,17696,black
32300,120,16,234,184,186,370,asian
32300,1506,882,991,1616,1763,3379,latino
32340,3565,8182,9599,10750,10596,21346,white non-hispanic
32340,59,383,164,263,343,606,black
32340,32,202,153,272,115,387,asian
32340,77,223,65,143,222,365,latino
32380,9545,9066,29406,24557,23460,48017,white non-hispanic
32380,354,258,202,348,466,814,black
32380,129,57,323,251,258,509,asian
32380,787,555,851,1042,1151,2193,latino
32420,5146,7377,22999,18370,17152,35522,white non-hispanic
32420,533,644,2535,2049,1663,3712,black
32420,0,1,76,36,41,77,asian
32420,17656,24509,53324,50180,45309,95489,latino
32460,7697,6404,19625,17207,16519,33726,white non-hispanic
32460,582,404,756,939,803,1742,black
32460,96,13,67,62,114,176,asian
32460,1002,581,690,987,1286,2273,latino
32500,3423,3026,9024,7996,7477,15473,white non-hispanic
32500,283,230,490,464,539,1003,black
32500,28,26,62,45,71,116,asian
32500,8,98,20,6,120,126,latino
32540,5969,6194,20100,16100,16163,32263,white non-hispanic
32540,264,377,780,493,928,1421,black
32540,30,47,108,147,38,185,asian
32540,805,625,694,938,1186,2124,latino
32580,254685,181430,310096,384139,362072,746211,white non-hispanic
32580,1538,1206,2053,1756,3041,4797,black
32580,2067,1736,4492,4245,4050,8295,asian
32580,269238,193316,308240,395906,374888,770794,latino
32620,5333,4254,15438,12804,12221,25025,white non-hispanic
32620,7723,6109,12639,14150,12321,26471,black
32620,12,41,168,93,128,221,asian
32620,368,124,159,259,392,651,latino
32660,8410,7225,21392,18761,18266,37027,white non-hispanic
32660,79,82,344,211,294,505,black
32660,60,87,84,125,106,231,asian
32660,1458,945,1105,1462,2046,3508,latino
32700,6203,5499,15604,13874,13432,27306,white non-hispanic
32700,9,179,112,98,202,300,black
32700,0,52,88,103,37,140,asian
32700,462,388,307,476,681,1157,latino
32740,17242,16531,49337,42277,40833,83110,white non-hispanic
32740,413,539,730,892,790,1682,black
32740,43,166,151,226,134,360,asian
32740,379,355,312,527,519,1046,latino
32780,38506,38269,117071,99341,94505,193846,white non-hispanic
32780,374,345,637,450,906,1356,black
32780,363,575,1607,1565,980,2545,asian
32780,9738,7399,8791,12478,13450,25928,latino
32820,134094,130834,366605,321219,310314,631533,white non-hispanic
32820,173929,161936,291380,335669,291576,627245,black
32820,6519,6795,13614,14407,12521,26928,asian
32820,29323,19447,22715,32834,38651,71485,latino
32860,7954,12373,21291,20705,20913,41618,white non-hispanic
32860,52,210,8,146,124,270,black
32860,435,577,164,608,568,1176,asian
32860,286,323,192,389,412,801,latino
32900,41885,36448,75316,76628,77021,153649,white non-hispanic
32900,1920,2367,4334,3985,4636,8621,black
32900,5298,6769,8157,10219,10005,20224,asian
32900,55903,43096,56651,76338,79312,155650,latino
32940,11386,11079,34030,28493,28002,56495,white non-hispanic
32940,12063,11489,21694,23987,21259,45246,black
32940,25,222,278,258,267,525,asian
32940,751,598,711,892,1168,2060,latino
32980,5045,4461,17644,13480,13670,27150,white non-hispanic
32980,47,52,51,50,100,150,black
32980,19,19,66,48,56,104,asian
32980,176,89,139,166,238,404,latino
33020,5186,4830,13030,12456,10590,23046,white non-hispanic
33020,184,478,910,965,607,1572,black
33020,0,0,54,49,5,54,asian
33020,350,204,200,393,361,754,latino
33060,4398,4283,12974,11093,10562,21655,white non-hispanic
33060,85,196,53,141,193,334,black
33060,80,48,98,104,122,226,asian
33060,733,469,514,850,866,1716,latino
33100,783020,867169,2616103,2180522,2085770,4266292,white non-hispanic
33100,338236,334914,613265,676752,609663,1286415,black
33100,27708,36119,83997,78030,69794,147824,asian
33100,558678,613201,1491356,1371011,1292224,2663235,latino
33140,18553,18389,55214,45627,46529,92156,white non-hispanic
33140,2957,3825,5448,5050,7180,12230,black
33140,165,117,364,389,257,646,asian
33140,2578,1973,2384,3203,3732,6935,latino
33180,5433,5294,15289,13367,12649,26016,white non-hispanic
33180,199,263,450,456,456,912,black
33180,0,2,53,44,11,55,asian
33180,32,26,22,39,41,80,latino
33220,16452,15910,45682,39715,38329,78044,white non-hispanic
33220,310,421,489,588,632,1220,black
33220,495,352,1015,1075,787,1862,asian
33220,729,622,806,1060,1097,2157,latino
33260,37925,35903,63088,68734,68182,136916,white non-hispanic
33260,2695,2732,4557,4725,5259,9984,black
33260,914,824,1364,1660,1442,3102,asian
33260,24913,21513,25198,35216,36408,71624,latino
33300,3735,8516,14523,13015,13759,26774,white non-hispanic
33300,5667,6846,12696,11949,13260,25209,black
33300,133,182,419,432,302,734,asian
33300,279,375,501,557,598,1155,latino
33340,230055,250434,676963,588717,568735,1157452,white non-hispanic
33340,82384,69109,109936,140682,120747,261429,black
33340,15827,17314,22203,28047,27297,55344,asian
33340,61412,45749,57058,80206,84013,164219,latino
33420,5950,4922,14931,13107,12696,25803,white non-hispanic
33420,233,102,346,323,358,681,black
33420,4,63,110,81,96,177,asian
33420,2063,1461,2015,2726,2813,5539,latino
33460,590335,614346,1602688,1420316,1387053,2807369,white non-hispanic
33460,97085,78921,107171,140824,142353,283177,black
33460,65265,74184,85928,115531,109846,225377,asian
33460,77604,56788,67025,97453,103964,201417,latino
33500,15520,20531,33315,32950,36416,69366,white non-hispanic
33500,526,1253,799,1081,1497,2578,black
33500,199,519,342,570,490,1060,asian
33500,1418,1819,965,2052,2150,4202,latino
33540,19258,31126,54623,52047,52960,105007,white non-hispanic
33540,84,81,270,119,316,435,black
33540,270,618,751,947,692,1639,asian
33540,1134,1307,1092,1495,2038,3533,latino
33580,5048,4599,11895,10881,10661,21542,white non-hispanic
33580,85,75,115,158,117,275,black
33580,0,0,18,18,0,18,asian
33580,97,245,142,120,364,484,latino
33620,4813,5082,12666,11004,11557,22561,white non-hispanic
33620,228,485,729,445,997,1442,black
33620,40,16,95,109,42,151,asian
33620,172,80,239,284,207,491,latino
33660,51332,53312,140898,125876,119666,245542,white non-hispanic
33660,40534,36779,69110,79061,67362,146423,black
33660,1960,2320,3847,4123,4004,8127,asian
33660,3649,3172,4595,5477,5939,11416,latino
33700,104612,93900,202149,203827,196834,400661,white non-hispanic
33700,4026,4041,7054,7668,7453,15121,black
33700,6851,7428,15209,15471,14017,29488,asian
33700,85184,66248,89384,119399,121417,240816,latino
33740,23628,23821,62473,56266,53656,109922,white non-hispanic
33740,19664,17591,27105,34212,30148,64360,black
33740,361,500,763,890,734,1624,asian
33740,1529,1534,1398,1972,2489,4461,latino
33780,30397,27186,83829,71512,69900,141412,white non-hispanic
33780,890,869,1683,1729,1713,3442,black
33780,172,246,528,550,396,946,asian
33780,1831,1344,1987,2457,2705,5162,latino
33860,38568,38335,112826,96993,92736,189729,white non-hispanic
33860,42792,46507,76347,88670,76976,165646,black
33860,1750,1436,3358,3501,3043,6544,asian
33860,4803,3054,3625,5362,6120,11482,latino
33940,8230,6599,23458,19524,18763,38287,white non-hispanic
33940,47,8,118,124,49,173,black
33940,115,41,179,170,165,335,asian
33940,3049,2040,3278,4066,4301,8367,latino
33980,10398,10328,40656,31345,30037,61382,white non-hispanic
33980,682,918,2308,1739,2169,3908,black
33980,154,211,395,464,296,760,asian
33980,1120,719,1057,1349,1547,2896,latino
34020,7215,6277,18468,15965,15995,31960,white non-hispanic
34020,4291,3938,8133,8646,7716,16362,black
34020,79,209,442,309,421,730,asian
34020,1236,1013,1349,1336,2262,3598,latino
34060,20926,42511,61340,61694,63083,124777,white non-hispanic
34060,687,2130,2534,1597,3754,5351,black
34060,505,1701,1260,1628,1838,3466,asian
34060,615,1528,743,1254,1632,2886,latino
34100,21968,20622,63669,54414,51845,106259,white non-hispanic
34100,703,866,1933,1675,1827,3502,black
34100,279,154,524,592,365,957,asian
34100,4010,2446,2649,4254,4851,9105,latino
34140,6476,13742,15580,17444,18354,35798,white non-hispanic
34140,103,147,29,153,126,279,black
34140,239,638,156,543,490,1033,asian
34140,387,852,373,780,832,1612,latino
34180,16613,14290,34049,32277,32675,64952,white non-hispanic
34180,105,254,277,391,245,636,black
34180,238,196,590,526,498,1024,asian
34180,15658,10550,11815,18363,19660,38023,latino
34220,6893,5888,16722,15050,14453,29503,white non-hispanic
34220,3097,2558,4758,5450,4963,10413,black
34220,104,10,272,181,205,386,asian
34220,3363,2518,2802,3846,4837,8683,latino
34260,6870,5882,26847,20581,19018,39599,white non-hispanic
34260,14,24,36,22,52,74,black
34260,7,0,153,99,61,160,asian
34260,276,314,289,434,445,879,latino
34300,5827,6283,10663,10941,11832,22773,white non-hispanic
34300,173,366,232,365,406,771,black
34300,77,398,340,452,363,815,asian
34300,1622,1306,1372,1993,2307,4300,latino
34340,13817,11802,40549,34153,32015,66168,white non-hispanic
34340,559,528,1616,1442,1261,2703,black
34340,123,126,195,282,162,444,asian
34340,3137,1870,2347,3491,3863,7354,latino
34380,10108,25565,26749,32151,30271,62422,white non-hispanic
34380,266,1191,359,871,945,1816,black
34380,176,521,475,581,591,1172,asian
34380,843,1130,711,1311,1373,2684,latino
34420,6545,4941,12073,12101,11458,23559,white non-hispanic
34420,783,689,1518,1603,1387,2990,black
34420,68,53,156,134,143,277,asian
34420,5517,3661,4571,6770,6979,13749,latino
34460,10432,8560,25043,22201,21834,44035,white non-hispanic
34460,136,76,707,502,417,919,black
34460,7,42,14,50,13,63,asian
34460,419,311,242,299,673,972,latino
34500,6941,6591,20065,16529,17068,33597,white non-hispanic
34500,796,1052,1429,1247,2030,3277,black
34500,125,81,233,271,168,439,asian
34500,274,320,334,332,596,928,latino
34540,13380,13138,32333,30035,28816,58851,white non-hispanic
34540,102,251,268,249,372,621,black
34540,23,79,122,170,54,224,asian
34540,275,366,233,471,403,874,latino
34580,19912,19327,62008,51108,50139,101247,white non-hispanic
34580,278,400,344,458,564,1022,black
34580,278,427,1393,1303,795,2098,asian
34580,8945,6038,6868,10708,11143,21851,latino
34620,18018,31134,53417,53319,49250,102569,white non-hispanic
34620,2267,2833,3363,4322,4141,8463,black
34620,366,590,607,797,766,1563,asian
34620,834,1064,763,1398,1263,2661,latino
34660,6173,11082,18011,18306,16960,35266,white non-hispanic
34660,160,671,603,680,754,1434,black
34660,52,324,331,372,335,707,asian
34660,362,352,290,520,484,1004,latino
34700,9390,7895,21770,19676,19379,39055,white non-hispanic
34700,309,346,224,466,413,879,black
34700,101,204,172,279,198,477,asian
34700,2908,1935,2679,3713,3809,7522,latino
34740,30142,28422,80744,70198,69110,139308,white non-hispanic
34740,6244,6207,10975,11698,11728,23426,black
34740,142,186,581,572,337,909,asian
34740,3893,2492,3027,4609,4803,9412,latino
34780,7629,8119,25297,21179,19866,41045,white non-hispanic
34780,1768,1968,3778,3695,3819,7514,black
34780,126,90,276,245,247,492,asian
34780,1717,1063,1296,1923,2153,4076,latino
34820,56087,61632,235416,182747,170388,353135,white non-hispanic
34820,14242,14031,27331,29348,26256,55604,black
34820,857,975,2749,2421,2160,4581,asian
34820,8750,6625,9019,11133,13261,24394,latino
34860,11267,14973,23612,25679,24173,49852,white non-hispanic
34860,2788,4330,4485,6482,5121,11603,black
34860,363,273,538,696,478,1174,asian
34860,4927,3806,3639,6047,6325,12372,latino
34900,19718,19262,63438,51633,50785,102418,white non-hispanic
34900,652,801,1545,1366,1632,2998,black
34900,2298,2417,6435,5951,5199,11150,asian
34900,15558,13108,18881,22982,24565,47547,latino
34940,51655,49261,213356,159288,154984,314272,white non-hispanic
34940,7322,5929,11864,12647,12468,25115,black
34940,736,913,2903,2603,1949,4552,asian
34940,29207,25526,42215,46692,50256,96948,latino
34980,315911,334481,778313,726626,702079,1428705,white non-hispanic
34980,70898,79524,127667,147394,130695,278089,black
34980,11998,13332,22342,25060,22612,47672,asian
34980,49824,34800,43300,60501,67423,127924,latino
35020,5110,4408,15585,12258,12845,25103,white non-hispanic
35020,6637,5822,12649,13155,11953,25108,black
35020,92,93,55,129,111,240,asian
35020,862,525,1546,707,2226,2933,latino
35060,4239,5393,11462,10727,10367,21094,white non-hispanic
35060,4418,5087,6470,8465,7510,15975,black
35060,84,24,158,195,71,266,asian
35060,288,292,264,448,396,844,latino
35100,17162,21281,50238,43534,45147,88681,white non-hispanic
35100,6123,6893,14485,13992,13509,27501,black
35100,1077,579,1327,1482,1501,2983,asian
35100,2826,3330,2111,3562,4705,8267,latino
35140,4451,4392,14885,12030,11698,23728,white non-hispanic
35140,2977,2971,6034,6133,5849,11982,black
35140,0,44,30,66,8,74,asian
35140,1142,619,1012,1295,1478,2773,latino
35220,9623,8962,27627,22665,23547,46212,white non-hispanic
35220,90,535,493,184,934,1118,black
35220,60,79,89,65,163,228,asian
35220,264,264,285,315,498,813,latino
35260,15434,15112,51528,42451,39623,82074,white non-hispanic
35260,837,810,1504,1504,1647,3151,black
35260,114,97,189,241,159,400,asian
35260,434,305,412,576,575,1151,latino
35300,116339,136750,388089,332077,309101,641178,white non-hispanic
35300,28996,30114,53042,59164,52988,112152,black
35300,7051,10414,16582,18049,15998,34047,asian
35300,48681,43126,56639,75145,73301,148446,latino
35380,142030,162768,423963,369228,359533,728761,white non-hispanic
35380,115776,113313,212302,237446,203945,441391,black
35380,7911,10023,19042,18708,18268,36976,asian
35380,29991,31296,47938,51531,57694,109225,latino
35420,20174,17085,52327,45521,44065,89586,white non-hispanic
35420,275,117,482,340,534,874,black
35420,111,87,185,214,169,383,asian
35420,958,710,583,983,1268,2251,latino
35440,6295,6385,29017,21447,20250,41697,white non-hispanic
35440,17,116,80,109,104,213,black
35440,127,66,389,382,200,582,asian
35440,1655,1042,1491,1998,2190,4188,latino
35460,6712,5889,20861,17278,16184,33462,white non-hispanic
35460,150,146,440,281,455,736,black
35460,0,0,0,0,0,0,asian
35460,300,160,316,315,461,776,latino
35500,7774,6516,20881,17406,17765,35171,white non-hispanic
35500,40,339,211,149,441,590,black
35500,19,33,103,82,73,155,asian
35500,283,203,252,348,390,738,latino
35580,5134,4878,14221,12152,12081,24233,white non-hispanic
35580,21,14,36,24,47,71,black
35580,37,91,49,93,84,177,asian
35580,418,329,283,541,489,1030,latino
35620,2358541,2559297,6850431,6012884,5755385,11768269,white non-hispanic
35620,786212,875157,1794615,1872102,1583882,3455984,black
35620,433460,578562,1183304,1142054,1053272,2195326,asian
35620,1324034,1329988,2209580,2462483,2401119,4863602,latino
35660,23881,22138,75523,61780,59762,121542,white non-hispanic
35660,6563,5790,10476,12158,10671,22829,black
35660,554,1014,1482,1567,1483,3050,asian
35660,3092,2273,2715,3919,4161,8080,latino
35700,10974,7917,21064,20594,19361,39955,white non-hispanic
35700,13,103,120,92,144,236,black
35700,126,2,267,230,165,395,asian
35700,12054,8601,17998,20362,18291,38653,latino
35740,10656,9552,24768,22652,22324,44976,white non-hispanic
35740,254,110,257,273,348,621,black
35740,104,61,262,213,214,427,asian
35740,2268,1467,1795,2608,2922,5530,latino
35820,8455,6621,20191,17971,17296,35267,white non-hispanic
35820,101,221,94,166,250,416,black
35820,2,70,146,138,80,218,asian
35820,1124,804,1037,1477,1488,2965,latino
35840,103538,98900,477837,354068,326207,680275,white non-hispanic
35840,14329,12598,23565,26752,23740,50492,black
35840,2914,2690,8167,7401,6370,13771,asian
35840,31119,23442,38784,45931,47414,93345,latino
35860,6419,5382,15239,13445,13595,27040,white non-hispanic
35860,131,54,195,188,192,380,black
35860,34,37,52,63,60,123,asian
35860,281,119,245,262,383,645,latino
35900,12356,11035,39048,31729,30710,62439,white non-hispanic
35900,556,582,1755,1349,1544,2893,black
35900,38,185,131,229,125,354,asian
35900,1851,931,1413,1900,2295,4195,latino
35940,13206,10874,31132,28026,27186,55212,white non-hispanic
35940,369,169,393,349,582,931,black
35940,3,62,58,87,36,123,asian
35940,1467,1109,1063,1809,1830,3639,latino
35980,39531,47674,132552,110082,109675,219757,white non-hispanic
35980,3554,4641,7361,7552,8004,15556,black
35980,2192,2624,6394,5939,5271,11210,asian
35980,8853,8831,9502,13319,13867,27186,latino
36020,11601,13986,42568,34071,34084,68155,white non-hispanic
36020,780,1084,767,1052,1579,2631,black
36020,629,913,2092,2240,1394,3634,asian
36020,1829,2154,1750,2870,2863,5733,latino
36100,46809,45456,189498,146246,135517,281763,white non-hispanic
36100,11705,10994,21538,23531,20706,44237,black
36100,918,1040,3171,2647,2482,5129,asian
36100,12641,10251,19575,21117,21350,42467,latino
36140,14466,15322,56495,44445,41838,86283,white non-hispanic
36140,1046,951,2301,2091,2207,4298,black
36140,266,111,529,490,416,906,asian
36140,2566,2073,2315,3299,3655,6954,latino
36220,37338,34733,56100,63649,64522,128171,white non-hispanic
36220,1728,2003,3127,3215,3643,6858,black
36220,469,479,733,811,870,1681,asian
36220,32113,26956,32406,44812,46663,91475,latino
36260,179413,134967,264131,287752,290759,578511,white non-hispanic
36260,2105,2170,2985,2963,4297,7260,black
36260,1675,2856,4991,5369,4153,9522,asian
36260,30601,22310,26685,38780,40816,79596,latino
36300,21150,25590,56325,51430,51635,103065,white non-hispanic
36300,213,1656,768,718,1919,2637,black
36300,169,526,520,647,568,1215,asian
36300,532,1216,781,1027,1502,2529,latino
36340,10061,8899,32292,26037,25215,51252,white non-hispanic
36340,185,137,162,148,336,484,black
36340,22,67,107,135,61,196,asian
36340,226,171,177,233,341,574,latino
36380,7607,6908,20473,16611,18377,34988,white non-hispanic
36380,803,869,1720,980,2412,3392,black
36380,113,66,172,217,134,351,asian
36380,3421,2821,3810,4133,5919,10052,latino
36420,226184,241653,532953,506642,494148,1000790,white non-hispanic
36420,37160,39435,61767,71458,66904,138362,black
36420,8985,13041,20583,23084,19525,42609,asian
36420,69417,50768,52975,82952,90208,173160,latino
36460,15314,14148,42522,36322,35662,71984,white non-hispanic
36460,493,409,401,592,711,1303,black
36460,206,218,267,353,338,691,asian
36460,633,470,473,774,802,1576,latino
36500,44701,48355,128398,112673,108781,221454,white non-hispanic
36500,1720,2407,3911,3548,4490,8038,black
36500,3126,3714,8566,8689,6717,15406,asian
36500,8277,6975,7728,11221,11759,22980,latino
36540,187488,177479,409079,390484,383562,774046,white non-hispanic
36540,21222,18895,29653,35593,34177,69770,black
36540,6530,7809,9765,12578,11526,24104,asian
36540,37537,25508,28941,44267,47719,91986,latino
36580,9118,14654,33052,29349,27475,56824,white non-hispanic
36580,212,680,334,592,634,1226,black
36580,169,334,326,482,347,829,asian
36580,516,1048,582,1206,940,2146,latino
36620,12129,9711,25410,22787,24463,47250,white non-hispanic
36620,47,158,191,122,274,396,black
36620,110,126,418,383,271,654,asian
36620,5396,3992,4575,6497,7466,13963,latino
36660,11316,8983,26663,24211,22751,46962,white non-hispanic
36660,10360,8121,15801,18063,16219,34282,black
36660,164,31,63,205,53,258,asian
36660,679,262,742,935,748,1683,latino
36700,5682,4950,19738,15568,14802,30370,white non-hispanic
36700,12935,14525,27733,30001,25192,55193,black
36700,183,220,488,531,360,891,asian
36700,774,478,617,841,1028,1869,latino
36740,340095,400834,945587,857820,828696,1686516,white non-hispanic
36740,105835,107848,177788,204857,186614,391471,black
36740,19706,27222,53834,54320,46442,100762,asian
36740,189081,190404,314445,353389,340541,693930,latino
36780,31053,38437,87208,78559,78139,156698,white non-hispanic
36780,990,1361,1251,1237,2365,3602,black
36780,1127,1901,1402,2266,2164,4430,asian
36780,2729,1906,2019,3191,3463,6654,latino
36820,5012,4293,11951,10534,10722,21256,white non-hispanic
36820,56,205,82,130,213,343,black
36820,109,41,147,165,132,297,asian
36820,168,111,169,160,288,448,latino
36830,4296,2902,6298,6678,6818,13496,white non-hispanic
36830,40,17,56,63,50,113,black
36830,31,103,94,147,81,228,asian
36830,5200,3054,3738,5824,6168,11992,latino
36840,5691,4755,13323,12019,11750,23769,white non-hispanic
36840,126,92,170,226,162,388,black
36840,0,0,75,55,20,75,asian
36840,386,231,427,545,499,1044,latino
36860,29843,26915,84360,71034,70084,141118,white non-hispanic
36860,588,1364,1110,906,2156,3062,black
36860,287,340,521,816,332,1148,asian
36860,5056,3644,4873,6378,7195,13573,latino
36900,8968,7929,22892,20224,19565,39789,white non-hispanic
36900,258,431,383,412,660,1072,black
36900,105,80,175,191,169,360,asian
36900,1549,1073,1196,1836,1982,3818,latino
36940,7803,6310,19155,16813,16455,33268,white non-hispanic
36940,553,302,341,509,687,1196,black
36940,139,131,175,224,221,445,asian
36940,1198,807,728,1341,1392,2733,latino
36980,25191,21837,61123,55427,52724,108151,white non-hispanic
36980,1009,1345,2265,2157,2462,4619,black
36980,498,307,580,601,784,1385,asian
36980,1511,710,857,1367,1711,3078,latino
37020,14320,12931,39158,33602,32807,66409,white non-hispanic
37020,57,135,77,115,154,269,black
37020,101,66,142,230,79,309,asian
37020,658,512,786,973,983,1956,latino
37060,6085,15324,16405,19054,18760,37814,white non-hispanic
37060,2818,4525,5236,6763,5816,12579,black
37060,188,494,428,488,622,1110,asian
37060,335,634,345,662,652,1314,latino
37080,7066,6445,22221,17697,18035,35732,white non-hispanic
37080,3541,4107,10513,8891,9270,18161,black
37080,22,40,170,117,115,232,asian
37080,1714,1188,1549,2136,2315,4451,latino
37100,156605,151380,369025,341080,335930,677010,white non-hispanic
37100,2971,3967,7867,6570,8235,14805,black
37100,11237,12132,37617,33527,27459,60986,asian
37100,114232,99264,144748,177916,180328,358244,latino
37120,7590,8279,20333,17844,18358,36202,white non-hispanic
37120,2455,2407,4744,5239,4367,9606,black
37120,77,145,281,370,133,503,asian
37120,1025,1013,956,1259,1735,2994,latino
37140,17505,15763,52345,44210,41403,85613,white non-hispanic
37140,2339,1924,4208,4430,4041,8471,black
37140,146,166,251,455,108,563,asian
37140,805,497,884,990,1196,2186,latino
37220,5556,4780,25545,17667,18214,35881,white non-hispanic
37220,142,246,952,519,821,1340,black
37220,3,120,610,590,143,733,asian
37220,1981,1401,2757,3016,3123,6139,latino
37260,10976,9964,36680,28926,28694,57620,white non-hispanic
37260,3504,2820,5475,6291,5508,11799,black
37260,100,78,265,333,110,443,asian
37260,2734,1756,2589,3383,3696,7079,latino
37300,8147,9037,25132,17775,24541,42316,white non-hispanic
37300,1726,3344,7013,3133,8950,12083,black
37300,62,70,182,113,201,314,asian
37300,2715,3135,4131,3333,6648,9981,latino
37340,78304,81791,310699,239654,231140,470794,white non-hispanic
37340,14761,14040,28927,30524,27204,57728,black
37340,2790,2792,8261,7918,5925,13843,asian
37340,15525,13312,26205,28180,26862,55042,latino
37420,4861,4071,10588,9368,10152,19520,white non-hispanic
37420,73,333,633,257,782,1039,black
37420,81,41,40,118,44,162,asian
37420,2368,1712,2332,2860,3552,6412,latino
37460,31050,34477,94464,79432,80559,159991,white non-hispanic
37460,5507,6454,10584,10517,12028,22545,black
37460,1058,974,2255,2525,1762,4287,asian
37460,3649,3533,4400,5290,6292,11582,latino
37500,10205,9023,23051,21491,20788,42279,white non-hispanic
37500,95,209,157,199,262,461,black
37500,60,56,20,104,32,136,asian
37500,497,407,299,603,600,1203,latino
37540,5819,4965,18060,14908,13936,28844,white non-hispanic
37540,793,523,1573,1420,1469,2889,black
37540,0,1,32,21,12,33,asian
37540,291,174,289,392,362,754,latino
37580,8957,7966,23174,20640,19457,40097,white non-hispanic
37580,1623,1375,3141,3390,2749,6139,black
37580,76,134,227,208,229,437,asian
37580,1577,994,1118,1747,1942,3689,latino
37620,18282,16701,53480,45630,42833,88463,white non-hispanic
37620,338,182,528,569,479,1048,black
37620,137,72,261,280,190,470,asian
37620,339,306,320,594,371,965,latino
37660,4111,3540,10628,9288,8991,18279,white non-hispanic
37660,148,118,526,314,478,792,black
37660,0,46,11,11,46,57,asian
37660,323,264,315,478,424,902,latino
37740,6710,5877,28624,20657,20554,41211,white non-hispanic
37740,55,23,222,139,161,300,black
37740,109,62,296,306,161,467,asian
37740,2921,2143,4846,4906,5004,9910,latino
37780,2559,3112,5847,4532,6986,11518,white non-hispanic
37780,128,94,499,137,584,721,black
37780,39,8,121,82,86,168,asian
37780,2818,3098,5180,4681,6415,11096,latino
37800,7420,6671,17619,15972,15738,31710,white non-hispanic
37800,84,9,105,108,90,198,black
37800,61,129,188,205,173,378,asian
37800,240,216,158,444,170,614,latino
37860,68356,84379,202192,175368,179559,354927,white non-hispanic
37860,19404,21520,36225,38968,38181,77149,black
37860,2005,3152,7129,7091,5195,12286,asian
37860,7218,9127,9326,11662,14009,25671,latino
37900,68251,64969,186659,163468,156411,319879,white non-hispanic
37900,11310,9401,13944,17924,16731,34655,black
37900,2448,2479,3947,4373,4501,8874,asian
37900,4621,3610,4450,6065,6616,12681,latino
37940,7167,6558,19033,15723,17035,32758,white non-hispanic
37940,196,1033,604,633,1200,1833,black
37940,86,38,79,137,66,203,asian
37940,369,443,254,386,680,1066,latino
37980,802735,894365,2386183,2090437,1992846,4083283,white non-hispanic
37980,324272,325843,620711,680449,590377,1270826,black
37980,77330,98333,173363,181676,167350,349026,asian
37980,184964,160465,201251,269662,277018,546680,latino
38060,813440,791647,1962676,1796217,1771546,3567763,white non-hispanic
38060,67089,67407,106140,117596,123040,240636,black
38060,36512,45530,88959,90605,80396,171001,asian
38060,487839,395859,508123,688748,703073,1391821,latino
38100,10283,9050,26999,23378,22954,46332,white non-hispanic
38100,2000,1848,3246,3627,3467,7094,black
38100,0,8,180,180,8,188,asian
38100,502,357,776,763,872,1635,latino
38180,3978,3569,11147,9315,9379,18694,white non-hispanic
38180,14,36,36,5,81,86,black
38180,0,65,0,4,61,65,asian
38180,283,193,87,314,249,563,latino
38220,8292,8689,28424,21809,23596,45405,white non-hispanic
38220,11545,12284,21666,22504,22991,45495,black
38220,59,169,319,289,258,547,asian
38220,671,714,672,869,1188,2057,latino
38240,15572,13248,49084,40276,37628,77904,white non-hispanic
38240,2888,2422,6501,6487,5324,11811,black
38240,252,182,695,568,561,1129,asian
38240,2493,1553,1994,2925,3115,6040,latino
38260,7653,10506,17663,17955,17867,35822,white non-hispanic
38260,290,377,314,372,609,981,black
38260,72,520,103,375,320,695,asian
38260,786,755,524,1048,1017,2065,latino
38300,361964,423730,1255431,1048028,993097,2041125,white non-hispanic
38300,48071,50829,92288,101107,90081,191188,black
38300,11303,18472,22213,26536,25452,51988,asian
38300,11888,12400,13942,18606,19624,38230,latino
38340,18775,22010,75617,60514,55888,116402,white non-hispanic
38340,811,1265,1421,1634,1863,3497,black
38340,442,773,881,1198,898,2096,asian
38340,1804,1648,2009,2662,2799,5461,latino
38380,8346,7215,14022,14616,14967,29583,white non-hispanic
38380,324,616,755,502,1193,1695,black
38380,10,31,42,55,28,83,asian
38380,6986,5359,7946,9842,10449,20291,latino
38420,10189,14080,25640,24127,25782,49909,white non-hispanic
38420,128,338,212,144,534,678,black
38420,78,181,153,239,173,412,asian
38420,262,326,203,333,458,791,latino
38460,13818,18077,42052,37115,36832,73947,white non-hispanic
38460,301,1591,1556,761,2687,3448,black
38460,185,564,481,838,392,1230,asian
38460,424,1007,846,818,1459,2277,latino
38500,10384,8281,24526,21953,21238,43191,white non-hispanic
38500,149,91,91,114,217,331,black
38500,58,52,117,111,116,227,asian
38500,1805,1096,1616,2099,2418,4517,latino
38540,19733,19049,36824,37879,37727,75606,white non-hispanic
38540,129,256,148,339,194,533,black
38540,196,392,557,803,342,1145,asian
38540,2626,2137,2191,3419,3535,6954,latino
38580,11903,10548,32407,28268,26590,54858,white non-hispanic
38580,272,293,372,436,501,937,black
38580,96,55,85,153,83,236,asian
38580,98,270,204,324,248,572,latino
38620,7777,6967,20862,18046,17560,35606,white non-hispanic
38620,219,236,440,355,540,895,black
38620,57,33,156,215,31,246,asian
38620,1437,886,1107,1593,1837,3430,latino
38660,49743,51020,126837,120116,107484,227600,white non-hispanic
38660,2740,3445,9280,7664,7801,15465,black
38660,26,131,209,276,90,366,asian
38660,69720,71264,173980,163238,151726,314964,latino
38700,7467,6722,19981,17171,16999,34170,white non-hispanic
38700,109,600,790,292,1207,1499,black
38700,99,54,93,119,127,246,asian
38700,537,491,599,647,980,1627,latino
38740,8724,7777,22335,20039,18797,38836,white non-hispanic
38740,668,571,1066,1184,1121,2305,black
38740,44,80,169,182,111,293,asian
38740,371,277,212,406,454,860,latino
38780,3301,4268,6395,7057,6907,13964,white non-hispanic
38780,88,423,112,153,470,623,black
38780,0,66,28,63,31,94,asian
38780,2540,2474,2903,3910,4007,7917,latino
38820,10369,10323,43973,32748,31917,64665,white non-hispanic
38820,206,286,355,288,559,847,black
38820,158,310,634,683,419,1102,asian
38820,1657,1165,1597,2013,2406,4419,latino
38840,7214,6059,25655,19671,19257,38928,white non-hispanic
38840,119,49,277,216,229,445,black
38840,3,39,32,39,35,74,asian
38840,680,392,934,968,1038,2006,latino
38860,91095,99833,302262,253717,239473,493190,white non-hispanic
38860,3903,2938,3457,4600,5698,10298,black
38860,1976,2290,4511,4929,3848,8777,asian
38860,2935,3176,3388,4744,4755,9499,latino
38900,399744,437920,1107266,983091,961839,1944930,white non-hispanic
38900,17979,18529,31373,31990,35891,67881,black
38900,30133,38963,81915,81531,69480,151011,asian
38900,101903,79642,95372,133779,143138,276917,latino
38920,4704,3960,10223,9307,9580,18887,white non-hispanic
38920,119,90,371,374,206,580,black
38920,238,318,547,510,593,1103,asian
38920,3376,2711,4416,5156,5347,10503,latino
38940,59396,56654,240177,181394,174833,356227,white non-hispanic
38940,18442,15885,33203,34548,32982,67530,black
38940,1513,1501,4648,4470,3192,7662,asian
38940,23515,18307,32879,36128,38573,74701,latino
39020,15683,15378,41480,37256,35285,72541,white non-hispanic
39020,489,884,857,598,1632,2230,black
39020,72,66,170,156,152,308,asian
39020,423,317,239,450,529,979,latino
39060,26018,24613,84747,67774,67604,135378,white non-hispanic
39060,462,1506,2084,634,3418,4052,black
39060,191,105,421,400,317,717,asian
39060,2004,1719,1813,2204,3332,5536,latino
39140,32956,30869,139426,104188,99063,203251,white non-hispanic
39140,70,414,685,561,608,1169,black
39140,175,584,1363,1231,891,2122,asian
39140,10564,7956,12988,15410,16098,31508,latino
39220,4972,4074,9959,9648,9357,19005,white non-hispanic
39220,14,34,88,30,106,136,black
39220,0,55,27,60,22,82,asian
39220,959,718,1031,1362,1346,2708,latino
39260,3758,3183,13177,10173,9945,20118,white non-hispanic
39260,35,32,34,80,21,101,black
39260,0,1,71,54,18,72,asian
39260,592,483,566,771,870,1641,latino
39300,241538,292673,795912,687995,642128,1330123,white non-hispanic
39300,25099,26707,37865,44360,45311,89671,black
39300,10776,16927,20094,25566,22231,47797,asian
39300,65843,58667,70313,97282,97541,194823,latino
39340,184480,164747,191189,267761,272655,540416,white non-hispanic
39340,1400,1330,728,1595,1863,3458,black
39340,1787,3717,3124,4756,3872,8628,asian
39340,26201,19908,19917,32376,33650,66026,latino
39380,26719,25807,74445,65060,61911,126971,white non-hispanic
39380,884,1135,1601,1553,2067,3620,black
39380,305,443,695,754,689,1443,asian
39380,20777,17296,31736,35245,34564,69809,latino
39420,5839,18854,14898,19360,20231,39591,white non-hispanic
39420,187,531,261,519,460,979,black
39420,523,2256,1025,1945,1859,3804,asian
39420,614,1545,677,1271,1565,2836,latino
39460,18306,18315,119416,80355,75682,156037,white non-hispanic
39460,1714,2114,6012,4585,5255,9840,black
39460,189,333,1522,1339,705,2044,asian
39460,3084,2786,6003,5989,5884,11873,latino
39500,15558,14684,41492,36477,35257,71734,white non-hispanic
39500,871,876,1239,1392,1594,2986,black
39500,161,120,251,270,262,532,asian
39500,457,336,371,546,618,1164,latino
39540,32505,29739,94259,78950,77553,156503,white non-hispanic
39540,6229,5987,9234,10712,10738,21450,black
39540,447,519,1404,1409,961,2370,asian
39540,9587,6469,8707,12217,12546,24763,latino
39580,199523,190882,478204,440895,427714,868609,white non-hispanic
39580,64725,64753,124230,135506,118202,253708,black
39580,17018,16891,33812,34619,33102,67721,asian
39580,50758,35053,46719,64544,67986,132530,latino
39660,24985,26131,71148,60069,62195,122264,white non-hispanic
39660,427,766,627,638,1182,1820,black
39660,324,662,585,898,673,1571,asian
39660,2788,1746,2029,3154,3409,6563,latino
39700,5196,5774,9980,9716,11234,20950,white non-hispanic
39700,0,137,22,3,156,159,black
39700,0,0,22,0,22,22,asian
39700,4986,5622,8600,8792,10416,19208,latino
39740,69960,70430,203626,176443,167573,344016,white non-hispanic
39740,6174,5847,9068,10268,10821,21089,black
39740,1251,1630,2967,3167,2681,5848,asian
39740,30549,23066,27783,40575,40823,81398,latino
39780,12374,10276,31721,27384,26987,54371,white non-hispanic
39780,40,160,179,114,265,379,black
39780,254,110,543,473,434,907,asian
39780,5672,4102,5542,7408,7908,15316,latino
39820,31132,30697,93709,79329,76209,155538,white non-hispanic
39820,553,668,786,892,1115,2007,black
39820,1260,1794,2256,2849,2461,5310,asian
39820,5849,4799,6570,8586,8632,17218,latino
39860,9446,7848,26327,22037,21584,43621,white non-hispanic
39860,161,227,89,162,315,477,black
39860,56,46,150,147,105,252,asian
39860,618,371,490,723,756,1479,latino
39900,72720,82381,203253,177679,180675,358354,white non-hispanic
39900,2118,3197,4816,4404,5727,10131,black
39900,4233,5873,13873,13098,10881,23979,asian
39900,37197,30533,38984,52257,54457,106714,latino
39940,13072,18854,15982,23552,24356,47908,white non-hispanic
39940,22,231,24,157,120,277,black
39940,49,314,88,272,179,451,asian
39940,1595,1624,1108,2010,2317,4327,latino
39980,12695,11966,35644,31270,29035,60305,white non-hispanic
39980,886,812,1740,1567,1871,3438,black
39980,150,196,318,413,251,664,asian
39980,819,586,487,1017,875,1892,latino
40060,158717,169600,454250,398522,384045,782567,white non-hispanic
40060,87200,96596,194447,201052,177191,378243,black
40060,10158,13574,23320,24365,22687,47052,asian
40060,25250,22060,26759,34923,39146,74069,latino
40080,20435,26823,50262,50208,47312,97520,white non-hispanic
40080,684,1653,1540,1969,1908,3877,black
40080,182,305,305,464,328,792,asian
40080,822,599,760,946,1235,2181,latino
40100,20410,14820,25096,31222,29104,60326,white non-hispanic
40100,0,2,31,17,16,33,black
40100,17,5,46,44,24,68,asian
40100,20983,15463,26457,32364,30539,62903,latino
40140,676792,640654,1445727,1385206,1377967,2763173,white non-hispanic
40140,85070,86154,156410,166342,161292,327634,black
40140,60112,69175,165576,157069,137794,294863,asian
40140,737986,632606,868437,1116380,1122649,2239029,latino
40180,6149,5701,17714,14734,14830,29564,white non-hispanic
40180,11,73,134,54,164,218,black
40180,8,20,25,37,16,53,asian
40180,1134,672,930,1269,1467,2736,latino
40220,47673,49160,157594,131128,123299,254427,white non-hispanic
40220,10410,9546,21166,21604,19518,41122,black
40220,1674,1752,3215,3385,3256,6641,asian
40220,4219,3780,3520,5397,6122,11519,latino
40260,5082,4804,19265,14798,14353,29151,white non-hispanic
40260,8664,8173,22436,20723,18550,39273,black
40260,159,105,248,302,210,512,asian
40260,768,492,608,751,1117,1868,latino
40300,10838,9037,28848,24512,24211,48723,white non-hispanic
40300,184,91,290,200,365,565,black
40300,81,45,126,151,101,252,asian
40300,1925,1293,1861,2439,2640,5079,latino
40340,43476,38943,107062,96428,93053,189481,white non-hispanic
40340,3459,2463,2911,4504,4329,8833,black
40340,2356,2435,4358,4770,4379,9149,asian
40340,3612,2545,3001,4272,4886,9158,latino
40380,165292,194392,516574,448632,427626,876258,white non-hispanic
40380,36009,33744,54506,65569,58690,124259,black
40380,6970,11140,12892,16210,14792,31002,asian
40380,26432,22429,27065,38047,37879,75926,latino
40420,58980,53594,161314,140236,133652,273888,white non-hispanic
40420,12012,9820,15644,19261,18215,37476,black
40420,2015,1798,4130,4107,3836,7943,asian
40420,18094,12101,16123,22618,23700,46318,latino
40460,6082,5391,17051,14543,13981,28524,white non-hispanic
40460,3543,3456,7177,7285,6891,14176,black
40460,112,117,239,143,325,468,asian
40460,1128,808,902,1330,1508,2838,latino
40540,10946,10026,20377,20037,21312,41349,white non-hispanic
40540,73,172,117,188,174,362,black
40540,49,85,125,186,73,259,asian
40540,2587,1917,2623,3353,3774,7127,latino
40580,13559,12156,45081,36426,34370,70796,white non-hispanic
40580,16135,15408,36375,36893,31025,67918,black
40580,236,208,500,511,433,944,asian
40580,3649,2319,2681,4010,4639,8649,latino
40620,8559,11321,20943,19635,21188,40823,white non-hispanic
40620,300,609,314,568,655,1223,black
40620,323,824,495,644,998,1642,asian
40620,361,476,249,419,667,1086,latino
40660,16271,16691,42680,39165,36477,75642,white non-hispanic
40660,3805,3639,6533,7434,6543,13977,black
40660,361,354,769,752,732,1484,asian
40660,4017,3030,3177,4711,5513,10224,latino
40700,18806,17219,63533,50257,49301,99558,white non-hispanic
40700,148,150,152,225,225,450,black
40700,133,244,625,588,414,1002,asian
40700,2038,1535,2326,2988,2911,5899,latino
40740,14577,11713,27922,27869,26343,54212,white non-hispanic
40740,226,266,601,559,534,1093,black
40740,96,118,276,298,192,490,asian
40740,12209,9377,14779,18179,18186,36365,latino
40760,3151,2687,11958,9211,8585,17796,white non-hispanic
40760,0,96,25,58,63,121,black
40760,1,0,102,102,1,103,asian
40760,1803,1359,3062,3089,3135,6224,latino
40780,16484,18536,40204,38169,37055,75224,white non-hispanic
40780,486,1067,835,1293,1095,2388,black
40780,195,304,478,512,465,977,asian
40780,3705,2756,3196,4593,5064,9657,latino
40820,4812,8500,12276,12752,12836,25588,white non-hispanic
40820,4066,8613,6643,10540,8782,19322,black
40820,100,566,169,341,494,835,asian
40820,430,555,401,572,814,1386,latino
40860,10281,11413,35971,29240,28425,57665,white non-hispanic
40860,196,129,148,261,212,473,black
40860,155,169,308,378,254,632,asian
40860,251,310,256,370,447,817,latino
40900,311339,325570,855603,761215,731297,1492512,white non-hispanic
40900,39091,43480,77700,80904,79367,160271,black
40900,63565,80855,148022,153001,139441,292442,asian
40900,160208,136944,184701,240380,241473,481853,latino
40940,7936,7332,14514,13899,15883,29782,white non-hispanic
40940,30,261,459,145,605,750,black
40940,39,98,142,110,169,279,asian
40940,3671,3709,4884,5302,6962,12264,latino
40980,27901,30217,87359,74516,70961,145477,white non-hispanic
40980,9904,8993,17005,18894,17008,35902,black
40980,501,778,1078,1252,1105,2357,asian
40980,5693,3944,6415,8253,7799,16052,latino
41060,38298,45858,91549,87640,88065,175705,white non-hispanic
41060,3547,3338,2100,4044,4941,8985,black
41060,753,1723,1288,2053,1711,3764,asian
41060,2470,1820,1513,2767,3036,5803,latino
41100,37374,28430,75132,71348,69588,140936,white non-hispanic
41100,374,473,219,318,748,1066,black
41100,134,321,623,654,424,1078,asian
41100,6129,4153,5373,7565,8090,15655,latino
41140,24405,25229,63842,56325,57151,113476,white non-hispanic
41140,1221,2588,2986,2249,4546,6795,black
41140,173,291,509,457,516,973,asian
41140,2257,2042,2301,2976,3624,6600,latino
41180,442152,452510,1240589,1086753,1048498,2135251,white non-hispanic
41180,138363,130071,244969,279578,233825,513403,black
41180,14462,20177,33816,35924,32531,68455,asian
41180,28934,23233,29950,39506,42611,82117,latino
41220,8793,11074,18632,18304,20195,38499,white non-hispanic
41220,2657,2692,4342,5106,4585,9691,black
41220,148,262,322,439,293,732,asian
41220,1068,1189,1069,1448,1878,3326,latino
41260,5917,5004,19309,15028,15202,30230,white non-hispanic
41260,25,90,42,43,114,157,black
41260,49,49,39,90,47,137,asian
41260,117,43,73,51,182,233,latino
41400,20283,18004,61045,50117,49215,99332,white non-hispanic
41400,463,599,1287,645,1704,2349,black
41400,39,132,66,151,86,237,asian
41400,491,481,662,599,1035,1634,latino
41420,78758,76100,187776,174857,167777,342634,white non-hispanic
41420,1317,1294,2016,1810,2817,4627,black
41420,1662,2234,4243,4426,3713,8139,asian
41420,38233,27452,30959,46335,50309,96644,latino
41460,11936,11173,30851,27202,26758,53960,white non-hispanic
41460,304,560,893,745,1012,1757,black
41460,383,210,754,688,659,1347,asian
41460,2539,1689,1973,3034,3167,6201,latino
41500,69309,68254,143618,138079,143102,281181,white non-hispanic
41500,1755,2858,6665,3928,7350,11278,black
41500,3767,5532,15568,13258,11609,24867,asian
41500,86147,71032,93734,121220,129693,250913,latino
41540,51797,56157,193956,155537,146373,301910,white non-hispanic
41540,17101,19502,33629,35929,34303,70232,black
41540,1506,1687,3708,3611,3290,6901,asian
41540,10968,7475,9209,12990,14662,27652,latino
41620,250499,239459,454085,471885,472158,944043,white non-hispanic
41620,7094,5672,6653,8477,10942,19419,black
41620,9358,13947,20239,22476,21068,43544,asian
41620,77372,57853,70619,100483,105361,205844,latino
41660,22766,27196,50714,50727,49949,100676,white non-hispanic
41660,1194,2020,1888,2527,2575,5102,black
41660,283,561,577,852,569,1421,asian
41660,14158,13573,18040,23090,22681,45771,latino
41700,484985,467542,965229,972780,944976,1917756,white non-hispanic
41700,39812,44405,75450,78624,81043,159667,black
41700,11137,16523,28765,30789,25636,56425,asian
41700,392138,348800,567973,666037,642874,1308911,latino
41740,485379,607450,1232605,1149127,1176307,2325434,white non-hispanic
41740,37020,51256,76295,75769,88802,164571,black
41740,70228,106060,207866,204557,179597,384154,asian
41740,334144,327812,433502,552233,543225,1095458,latino
41760,7843,6044,25991,19956,19922,39878,white non-hispanic
41760,41,1,40,14,68,82,black
41760,83,53,165,214,87,301,asian
41760,420,208,582,612,598,1210,latino
41780,12039,11879,40943,33240,31621,64861,white non-hispanic
41780,1669,1499,3221,3255,3134,6389,black
41780,88,119,238,244,201,445,asian
41780,1122,884,1141,1493,1654,3147,latino
41820,10056,8572,24579,22107,21100,43207,white non-hispanic
41820,2905,2581,5922,6001,5407,11408,black
41820,175,79,367,425,196,621,asian
41820,4616,2998,3925,5525,6014,11539,latino
41860,417167,523847,1422157,1176225,1186946,2363171,white non-hispanic
41860,69626,85662,191493,180614,166167,346781,black
41860,202160,288651,681671,620606,551876,1172482,asian
41860,295883,287252,431294,499659,514770,1014429,latino
41900,14883,15534,43862,38713,35566,74279,white non-hispanic
41900,419,529,1838,1508,1278,2786,black
41900,10,0,0,10,0,10,asian
41900,26458,26952,76385,67689,62106,129795,latino
41940,187750,200105,529911,452310,465456,917766,white non-hispanic
41940,10749,13543,24464,23454,25302,48756,black
41940,139635,168119,365406,340861,332299,673160,asian
41940,166120,147907,218787,263180,269634,532814,latino
41980,318331,335854,869105,809601,713689,1523290,white non-hispanic
41980,47855,57846,152411,133886,124226,258112,black
41980,1004,1116,2995,3489,1626,5115,asian
41980,457080,491865,1221070,1144764,1025251,2170015,latino
42020,41634,62226,136724,120128,120456,240584,white non-hispanic
42020,663,2009,2721,1578,3815,5393,black
42020,1314,4375,4587,5405,4871,10276,asian
42020,18889,19484,23801,29553,32621,62174,latino
42100,38360,53354,119402,106763,104353,211116,white non-hispanic
42100,358,935,1131,969,1455,2424,black
42100,1067,5366,6114,6866,5681,12547,asian
42100,28487,28233,34376,45241,45855,91096,latino
42140,22140,21251,78879,63075,59195,122270,white non-hispanic
42140,169,342,607,346,772,1118,black
42140,282,528,1045,1009,846,1855,asian
42140,20087,17503,37924,37975,37539,75514,latino
42180,3112,2822,6605,7088,5451,12539,white non-hispanic
42180,1154,1278,3863,2696,3599,6295,black
42180,0,0,0,0,0,0,asian
42180,5478,5032,11884,11580,10814,22394,latino
42200,69895,89740,171192,166241,164586,330827,white non-hispanic
42200,1451,2646,4210,3740,4567,8307,black
42200,3251,10151,10525,12375,11552,23927,asian
42200,64726,60352,73478,97064,101492,198556,latino
42220,64757,75045,237599,194666,182735,377401,white non-hispanic
42220,1556,2121,4171,3625,4223,7848,black
42220,2892,4694,12019,11036,8569,19605,asian
42220,43899,37313,50806,64054,67964,132018,latino
42300,4356,6076,16625,12734,14323,27057,white non-hispanic
42300,124,967,1402,189,2304,2493,black
42300,110,83,179,162,210,372,asian
42300,199,239,234,307,365,672,latino
42340,45835,56337,122854,113537,111489,225026,white non-hispanic
42340,33177,36532,56711,67419,59001,126420,black
42340,1359,2825,4161,4358,3987,8345,asian
42340,7378,7380,7631,10458,11931,22389,latino
42380,12990,10672,36016,30163,29515,59678,white non-hispanic
42380,94,123,145,161,201,362,black
42380,68,92,205,256,109,365,asian
42380,325,192,364,456,425,881,latino
42420,8472,7208,19922,18336,17266,35602,white non-hispanic
42420,112,78,96,123,163,286,black
42420,64,37,130,130,101,231,asian
42420,3335,2148,3167,4292,4358,8650,latino
42460,9891,8785,28952,24197,23431,47628,white non-hispanic
42460,336,391,972,852,847,1699,black
42460,63,46,129,169,69,238,asian
42460,603,417,473,716,777,1493,latino
42540,93479,103266,309339,260281,245803,506084,white non-hispanic
42540,6176,6596,7203,8431,11544,19975,black
42540,2232,2665,4380,4943,4334,9277,asian
42540,18049,13888,14924,22969,23892,46861,latino
42620,16222,17314,38176,36856,34856,71712,white non-hispanic
42620,820,1061,1319,1580,1620,3200,black
42620,78,270,183,273,258,531,asian
42620,1309,1096,901,1535,1771,3306,latino
42660,507742,611661,1503289,1308512,1314180,2622692,white non-hispanic
42660,52734,57557,98264,98515,110040,208555,black
42660,91080,137181,251076,254875,224462,479337,asian
42660,131027,108856,124127,174750,189260,364010,latino
42680,19234,18082,89979,66599,60696,127295,white non-hispanic
42680,3912,3136,6399,6833,6614,13447,black
42680,321,373,1128,895,927,1822,asian
42680,5599,4365,7908,8797,9075,17872,latino
42700,11420,11662,58340,41893,39529,81422,white non-hispanic
42700,2598,1896,4976,4860,4610,9470,black
42700,370,225,957,903,649,1552,asian
42700,5667,4810,8416,8951,9942,18893,latino
42740,9184,8177,21021,19599,18783,38382,white non-hispanic
42740,232,354,617,577,626,1203,black
42740,34,45,157,134,102,236,asian
42740,1543,849,1234,1780,1846,3626,latino
42780,8382,8867,21948,19913,19284,39197,white non-hispanic
42780,68,233,60,79,282,361,black
42780,40,93,164,127,170,297,asian
42780,284,300,300,504,380,884,latino
42820,1960,1862,7675,5987,5510,11497,white non-hispanic
42820,8029,6550,14098,15634,13043,28677,black
42820,56,64,63,106,77,183,asian
42820,54,143,212,171,238,409,latino
42860,12812,12133,41849,33826,32968,66794,white non-hispanic
42860,1138,1297,3014,2623,2826,5449,black
42860,75,168,300,330,213,543,asian
42860,1521,1158,1226,1867,2038,3905,latino
42900,6531,6530,18872,15912,16021,31933,white non-hispanic
42900,123,772,822,173,1544,1717,black
42900,69,87,95,141,110,251,asian
42900,302,376,461,385,754,1139,latino
42940,18481,17600,54035,46080,44036,90116,white non-hispanic
42940,140,313,209,253,409,662,black
42940,187,167,380,444,290,734,asian
42940,2070,1480,1849,2485,2914,5399,latino
42980,9380,8177,22707,20307,19957,40264,white non-hispanic
42980,215,86,171,225,247,472,black
42980,178,157,477,364,448,812,asian
42980,1235,735,849,1233,1586,2819,latino
43020,7474,6092,23661,18542,18685,37227,white non-hispanic
43020,29,36,76,50,91,141,black
43020,50,45,74,90,79,169,asian
43020,637,313,399,627,722,1349,latino
43060,11563,11575,31330,28400,26068,54468,white non-hispanic
43060,676,738,869,1183,1100,2283,black
43060,122,111,285,295,223,518,asian
43060,1456,1009,1062,1778,1749,3527,latino
43100,21251,18891,62772,51506,51408,102914,white non-hispanic
43100,377,905,598,562,1318,1880,black
43100,2413,2044,1719,3132,3044,6176,asian
43100,2981,1872,2232,3364,3721,7085,latino
43140,14699,14325,43957,37658,35323,72981,white non-hispanic
43140,5267,4580,10350,10813,9384,20197,black
43140,193,189,557,425,514,939,asian
43140,1344,751,1121,1572,1644,3216,latino
43180,9408,8120,21897,20039,19386,39425,white non-hispanic
43180,593,819,1764,1659,1517,3176,black
43180,0,22,153,135,40,175,asian
43180,2411,1599,1518,2586,2942,5528,latino
43220,8721,8774,34370,25140,26725,51865,white non-hispanic
43220,170,436,343,559,390,949,black
43220,188,204,549,532,409,941,asian
43220,2362,1620,1712,2445,3249,5694,latino
43260,5907,5425,16943,14217,14058,28275,white non-hispanic
43260,118,98,83,82,217,299,black
43260,36,80,113,181,48,229,asian
43260,386,315,561,710,552,1262,latino
43300,24707,22065,63024,56049,53747,109796,white non-hispanic
43300,1757,1673,3625,3764,3291,7055,black
43300,458,518,701,860,817,1677,asian
43300,6350,4360,5289,7712,8287,15999,latino
43320,11578,8457,31613,25542,26106,51648,white non-hispanic
43320,133,349,407,273,616,889,black
43320,157,118,388,357,306,663,asian
43320,4097,3189,4768,5485,6569,12054,latino
43340,52504,54225,143404,126704,123429,250133,white non-hispanic
43340,48529,43893,80794,92998,80218,173216,black
43340,991,1401,2750,2822,2320,5142,asian
43340,5870,4958,5844,7838,8834,16672,latino
43380,11571,8865,25667,22975,23128,46103,white non-hispanic
43380,511,293,580,551,833,1384,black
43380,61,229,181,266,205,471,asian
43380,283,234,212,301,428,729,latino
43420,22320,22163,62299,52287,54495,106782,white non-hispanic
43420,901,1555,2330,2045,2741,4786,black
43420,175,631,1492,1443,855,2298,asian
43420,13847,11472,18956,22184,22091,44275,latino
43460,7424,6582,19186,16950,16242,33192,white non-hispanic
43460,1354,1135,1952,2393,2048,4441,black
43460,30,60,57,93,54,147,asian
43460,346,217,275,389,449,838,latino
43500,5542,4618,16356,13521,12995,26516,white non-hispanic
43500,110,76,91,85,192,277,black
43500,0,4,73,17,60,77,asian
43500,3909,3077,7204,7210,6980,14190,latino
43580,35544,30351,80537,74075,72357,146432,white non-hispanic
43580,1498,1591,1352,2173,2268,4441,black
43580,1057,860,1902,2090,1729,3819,asian
43580,10966,7270,8086,12764,13558,26322,latino
43620,53250,51894,117006,111488,110662,222150,white non-hispanic
43620,3673,2937,2872,4272,5210,9482,black
43620,1064,1325,1700,2049,2040,4089,asian
43620,4213,2830,2861,4661,5243,9904,latino
43660,4067,3342,7842,7147,8104,15251,white non-hispanic
43660,66,254,464,263,521,784,black
43660,0,30,8,4,34,38,asian
43660,2371,1815,2705,3068,3823,6891,latino
43700,13628,11638,36150,31450,29966,61416,white non-hispanic
43700,118,132,382,215,417,632,black
43700,78,232,154,290,174,464,asian
43700,662,431,448,665,876,1541,latino
43740,13427,12700,45971,35595,36503,72098,white non-hispanic
43740,54,946,1080,171,1909,2080,black
43740,46,111,135,191,101,292,asian
43740,227,346,504,320,757,1077,latino
43760,7607,8230,31344,23323,23858,47181,white non-hispanic
43760,46,451,478,97,878,975,black
43760,135,119,355,339,270,609,asian
43760,1656,1895,2834,2659,3726,6385,latino
43780,53781,57508,146680,131318,126651,257969,white non-hispanic
43780,11873,9335,16096,19465,17839,37304,black
43780,1176,2254,2806,3425,2811,6236,asian
43780,9818,6926,7555,11570,12729,24299,latino
43900,51419,48976,136186,120574,116007,236581,white non-hispanic
43900,17225,17867,34556,37389,32259,69648,black
43900,1770,1671,3271,3664,3048,6712,asian
43900,7565,5499,6627,9081,10610,19691,latino
43940,4069,5430,13830,11789,11540,23329,white non-hispanic
43940,71,138,30,99,140,239,black
43940,26,159,49,98,136,234,asian
43940,232,351,207,412,378,790,latino
43980,3469,2811,9453,8055,7678,15733,white non-hispanic
43980,7,26,44,5,72,77,black
43980,11,0,68,32,47,79,asian
43980,239,110,193,215,327,542,latino
44020,3102,2700,10733,8295,8240,16535,white non-hispanic
44020,15,54,22,15,76,91,black
44020,11,39,22,71,1,72,asian
44020,114,123,84,123,198,321,latino
44060,101703,110743,273153,245243,240356,485599,white non-hispanic
44060,2021,3073,3483,3629,4948,8577,black
44060,2321,3328,5853,6711,4791,11502,asian
44060,10017,9277,9100,13821,14573,28394,latino
44100,35119,34669,105078,90619,84247,174866,white non-hispanic
44100,8482,6728,10126,13384,11952,25336,black
44100,808,1180,1881,1992,1877,3869,asian
44100,1582,1344,1613,2249,2290,4539,latino
44140,97777,128334,292999,270553,248557,519110,white non-hispanic
44140,11484,13944,20289,23633,22084,45717,black
44140,3182,8317,7436,10243,8692,18935,asian
44140,41102,36623,43211,63052,57884,120936,latino
44180,91992,103866,224464,215200,205122,420322,white non-hispanic
44180,2974,3623,3995,4562,6030,10592,black
44180,1383,2400,2282,3515,2550,6065,asian
44180,5136,4799,4229,6924,7240,14164,latino
44220,24798,23344,69185,60615,56712,117327,white non-hispanic
44220,2637,2520,5904,5681,5380,11061,black
44220,185,215,458,523,335,858,asian
44220,1816,1158,1326,2053,2247,4300,latino
44260,3751,14387,10358,13507,14989,28496,white non-hispanic
44260,4455,6736,7137,9911,8417,18328,black
44260,249,822,378,652,797,1449,asian
44260,0,536,277,281,532,813,latino
44300,21553,51153,68280,68022,72964,140986,white non-hispanic
44300,522,3782,2093,2305,4092,6397,black
44300,1452,6075,2134,4539,5122,9661,asian
44300,642,2678,1239,2036,2523,4559,latino
44340,8464,18292,21659,24044,24371,48415,white non-hispanic
44340,4911,8723,7479,11195,9918,21113,black
44340,196,314,571,561,520,1081,asian
44340,937,1115,685,1218,1519,2737,latino
44420,20863,20740,65564,55121,52046,107167,white non-hispanic
44420,1891,2204,4565,3898,4762,8660,black
44420,136,279,430,474,371,845,asian
44420,1452,1253,1420,1859,2266,4125,latino
44460,4219,5339,13520,11035,12043,23078,white non-hispanic
44460,14,29,150,39,154,193,black
44460,47,119,96,159,103,262,asian
44460,542,515,625,901,781,1682,latino
44500,7514,12771,17301,19038,18548,37586,white non-hispanic
44500,153,480,57,408,282,690,black
44500,159,84,71,162,152,314,asian
44500,2900,2859,2680,3926,4513,8439,latino
44540,3938,4952,11207,9317,10780,20097,white non-hispanic
44540,2,177,75,18,236,254,black
44540,109,7,93,96,113,209,asian
44540,873,1147,1382,1431,1971,3402,latino
44580,11489,9633,31891,26907,26106,53013,white non-hispanic
44580,328,271,381,454,526,980,black
44580,50,81,195,195,131,326,asian
44580,2381,1623,2687,3258,3433,6691,latino
44620,12240,18326,35284,32784,33066,65850,white non-hispanic
44620,125,281,98,181,323,504,black
44620,634,637,599,922,948,1870,asian
44620,804,661,677,1050,1092,2142,latino
44660,12081,25377,27938,32174,33222,65396,white non-hispanic
44660,707,1693,827,1355,1872,3227,black
44660,355,2495,720,1638,1932,3570,asian
44660,1134,1723,842,1632,2067,3699,latino
44700,98865,90435,215506,202014,202792,404806,white non-hispanic
44700,13250,12502,24681,25846,24587,50433,black
44700,27564,27391,54404,57197,52162,109359,asian
44700,105063,79583,110960,145388,150218,295606,latino
44740,3525,3650,8724,7951,7948,15899,white non-hispanic
44740,170,219,154,291,252,543,black
44740,640,602,607,856,993,1849,asian
44740,1974,1398,1726,2398,2700,5098,latino
44780,13047,10716,31575,27926,27412,55338,white non-hispanic
44780,464,479,595,714,824,1538,black
44780,61,87,186,152,182,334,asian
44780,2085,1129,1350,2152,2412,4564,latino
44860,7158,5801,17213,15467,14705,30172,white non-hispanic
44860,562,469,1391,1327,1095,2422,black
44860,91,43,120,150,104,254,asian
44860,2303,1522,2034,2762,3097,5859,latino
44900,4953,4193,12492,10874,10764,21638,white non-hispanic
44900,404,847,1315,884,1682,2566,black
44900,27,31,52,70,40,110,asian
44900,506,283,390,459,720,1179,latino
44920,9604,7382,20739,18199,19526,37725,white non-hispanic
44920,18,184,63,168,97,265,black
44920,177,48,429,309,345,654,asian
44920,1809,1222,1491,2065,2457,4522,latino
44940,11374,12138,28311,25917,25906,51823,white non-hispanic
44940,13114,12303,25063,27210,23270,50480,black
44940,144,367,766,794,483,1277,asian
44940,1527,1334,1230,1988,2103,4091,latino
44980,17048,16653,54833,44681,43853,88534,white non-hispanic
44980,521,1011,997,558,1971,2529,black
44980,26,37,260,175,148,323,asian
44980,1117,878,945,1360,1580,2940,latino
45000,4363,7289,13963,9488,16127,25615,white non-hispanic
45000,20,1652,1076,230,2518,2748,black
45000,19,250,194,98,365,463,asian
45000,876,3340,1613,658,5171,5829,latino
45020,3304,2639,7177,6457,6663,13120,white non-hispanic
45020,125,185,444,360,394,754,black
45020,9,0,33,30,12,42,asian
45020,1809,1297,2350,2664,2792,5456,latino
45060,107899,124554,323651,284681,271423,556104,white non-hispanic
45060,16650,16405,22100,28657,26498,55155,black
45060,4905,7260,7376,10174,9367,19541,asian
45060,9294,8756,8235,13256,13029,26285,latino
45140,4070,6109,14685,12731,12133,24864,white non-hispanic
45140,116,369,187,264,408,672,black
45140,55,114,167,151,185,336,asian
45140,1461,970,891,1506,1816,3322,latino
45180,11544,10969,36632,30286,28859,59145,white non-hispanic
45180,6738,7455,15451,15535,14109,29644,black
45180,79,83,307,187,282,469,asian
45180,578,501,728,757,1050,1807,latino
45220,38262,71749,121122,117089,114044,231133,white non-hispanic
45220,28645,44194,51616,66464,57991,124455,black
45220,2039,3658,4284,5006,4975,9981,asian
45220,5664,10036,8140,11780,12060,23840,latino
45300,420012,457742,1457878,1201020,1134612,2335632,white non-hispanic
45300,97020,95340,165306,189397,168269,357666,black
45300,20481,23632,55104,54098,45119,99217,asian
45300,156833,143635,249009,277703,271774,549477,latino
45340,4961,4435,17499,13682,13213,26895,white non-hispanic
45340,6,0,156,41,121,162,black
45340,0,5,96,101,0,101,asian
45340,4417,3654,10553,9295,9329,18624,latino
45380,6715,6291,19406,16091,16321,32412,white non-hispanic
45380,89,219,251,111,448,559,black
45380,48,9,157,142,72,214,asian
45380,154,77,292,212,311,523,latino
45460,32279,37107,85303,77586,77103,154689,white non-hispanic
45460,1175,2927,3520,2882,4740,7622,black
45460,434,804,1056,1248,1046,2294,asian
45460,1030,1305,1322,1607,2050,3657,latino
45500,22557,21261,61166,52778,52206,104984,white non-hispanic
45500,9986,8816,17359,18237,17924,36161,black
45500,228,40,838,768,338,1106,asian
45500,2802,2588,3292,3320,5362,8682,latino
45520,4837,4226,13385,11272,11176,22448,white non-hispanic
45520,72,32,46,50,100,150,black
45520,44,88,94,157,69,226,asian
45520,1757,1193,1513,2062,2401,4463,latino
45540,6419,6966,90165,53117,50433,103550,white non-hispanic
45540,1068,2541,5211,2767,6053,8820,black
45540,69,148,675,504,388,892,asian
45540,1340,1657,3611,2423,4185,6608,latino
45580,3816,3547,10937,9471,8829,18300,white non-hispanic
45580,1989,1496,3985,3912,3558,7470,black
45580,43,34,52,61,68,129,asian
45580,211,283,110,299,305,604,latino
45620,5962,4929,16067,14028,12930,26958,white non-hispanic
45620,4347,3545,8204,8782,7314,16096,black
45620,22,316,37,207,168,375,asian
45620,629,388,553,817,753,1570,latino
45660,11364,11060,29686,26247,25863,52110,white non-hispanic
45660,279,678,516,621,852,1473,black
45660,49,132,126,190,117,307,asian
45660,994,769,956,1279,1440,2719,latino
45700,5678,5909,14195,13170,12612,25782,white non-hispanic
45700,3380,3313,5239,6313,5619,11932,black
45700,78,125,284,220,267,487,asian
45700,1901,1245,1472,2272,2346,4618,latino
45740,4433,4428,12667,11470,10058,21528,white non-hispanic
45740,854,678,1474,1662,1344,3006,black
45740,53,54,0,35,72,107,asian
45740,339,209,261,385,424,809,latino
45780,96103,110663,266300,241925,231141,473066,white non-hispanic
45780,23445,23642,39083,45497,40673,86170,black
45780,2216,3378,4488,5224,4858,10082,asian
45780,14937,11651,13465,20095,19958,40053,latino
45820,44623,39089,115734,102177,97269,199446,white non-hispanic
45820,3790,3568,7074,7449,6983,14432,black
45820,451,689,1225,1382,983,2365,asian
45820,9241,5870,7979,11524,11566,23090,latino
45860,31371,28954,111282,86884,84723,171607,white non-hispanic
45860,832,1012,1716,1669,1891,3560,black
45860,947,779,1820,1806,1740,3546,asian
45860,3513,2768,4229,5107,5403,10510,latino
45900,27150,25823,86907,70980,68900,139880,white non-hispanic
45900,249,407,691,386,961,1347,black
45900,227,185,478,501,389,890,asian
45900,1595,1117,1413,2030,2095,4125,latino
45940,45230,54826,136770,119841,116985,236826,white non-hispanic
45940,19110,19543,37906,40552,36007,76559,black
45940,9280,9734,20998,20452,19560,40012,asian
45940,19504,18232,25421,29687,33470,63157,latino
45980,3111,6348,9536,9650,9345,18995,white non-hispanic
45980,2825,4633,5190,6801,5847,12648,black
45980,200,335,196,370,361,731,asian
45980,72,137,73,76,206,282,latino
46020,15243,14268,61505,46262,44754,91016,white non-hispanic
46020,107,224,251,171,411,582,black
46020,125,234,764,686,437,1123,asian
46020,2878,2267,3964,4372,4737,9109,latino
46060,150939,176115,447445,396467,378032,774499,white non-hispanic
46060,8373,10261,16238,15839,19033,34872,black
46060,4185,9905,13879,14701,13268,27969,asian
46060,114743,105164,148705,188192,180420,368612,latino
46100,19854,18629,53928,47458,44953,92411,white non-hispanic
46100,587,788,1956,1711,1620,3331,black
46100,250,201,441,591,301,892,asian
46100,1497,982,1053,1697,1835,3532,latino
46140,151511,147484,399601,355476,343120,698596,white non-hispanic
46140,22187,20078,35464,40045,37684,77729,black
46140,5785,6687,9821,11542,10751,22293,asian
46140,37163,25735,29149,44198,47849,92047,latino
46180,24235,21142,58423,53244,50556,103800,white non-hispanic
46180,9262,8142,13638,16327,14715,31042,black
46180,265,292,411,492,476,968,asian
46180,1851,1069,1534,2060,2394,4454,latino
46220,27144,46120,76250,75686,73828,149514,white non-hispanic
46220,20575,24110,36271,43923,37033,80956,black
46220,681,1356,1137,1635,1539,3174,asian
46220,2747,2841,2562,4063,4087,8150,latino
46300,27394,21870,48830,49363,48731,98094,white non-hispanic
46300,267,149,140,301,255,556,black
46300,588,336,668,896,696,1592,asian
46300,8360,5943,6504,10014,10793,20807,latino
46340,40961,38501,91455,88075,82842,170917,white non-hispanic
46340,9795,10913,18430,20966,18172,39138,black
46340,937,739,1840,1883,1633,3516,asian
46340,16476,11918,13734,20662,21466,42128,latino
46380,14271,12955,45152,36482,35896,72378,white non-hispanic
46380,58,247,315,189,431,620,black
46380,203,379,927,928,581,1509,asian
46380,7961,5645,7796,10145,11257,21402,latino
46460,6119,5619,18846,15787,14797,30584,white non-hispanic
46460,1196,1081,2420,2431,2266,4697,black
46460,24,31,58,77,36,113,asian
46460,520,318,420,740,518,1258,latino
46500,8282,7082,21485,18605,18244,36849,white non-hispanic
46500,42,163,408,252,361,613,black
46500,16,69,106,104,87,191,asian
46500,226,167,193,283,303,586,latino
46520,35146,68469,105607,91287,117935,209222,white non-hispanic
46520,4618,9960,8670,8896,14352,23248,black
46520,60054,78698,285806,228301,196257,424558,asian
46520,35387,30980,28703,45702,49368,95070,latino
46540,50411,52967,155880,131735,127523,259258,white non-hispanic
46540,4437,5072,5913,6513,8909,15422,black
46540,3270,2767,3616,5100,4553,9653,asian
46540,5015,4175,4633,6420,7403,13823,latino
46620,6490,5541,12001,12055,11977,24032,white non-hispanic
46620,22,6,34,27,35,62,black
46620,103,102,77,226,56,282,asian
46620,6007,4884,8267,9727,9431,19158,latino
46660,18473,24981,42758,43328,42884,86212,white non-hispanic
46660,13236,15843,20234,25897,23416,49313,black
46660,463,836,1001,1212,1088,2300,asian
46660,3075,2779,2836,4205,4485,8690,latino
46700,46282,51681,131388,115466,113885,229351,white non-hispanic
46700,13624,14815,33313,30871,30881,61752,black
46700,12097,14455,39880,36110,30322,66432,asian
46700,37177,31530,43391,54743,57355,112098,latino
46740,3733,3597,12222,10069,9483,19552,white non-hispanic
46740,3136,3061,7138,7155,6180,13335,black
46740,26,112,201,112,227,339,asian
46740,375,175,180,251,479,730,latino
46780,6225,5168,15861,13991,13263,27254,white non-hispanic
46780,106,92,141,126,213,339,black
46780,9,14,68,55,36,91,asian
46780,325,161,370,441,415,856,latino
46820,2001,5640,4832,6281,6192,12473,white non-hispanic
46820,0,191,30,68,153,221,black
46820,20,191,131,117,225,342,asian
46820,74,266,41,162,219,381,latino
46860,10592,7729,13782,15770,16333,32103,white non-hispanic
46860,97,70,22,52,137,189,black
46860,33,67,82,104,78,182,asian
46860,1289,823,886,1392,1606,2998,latino
46900,2335,2267,5931,5376,5157,10533,white non-hispanic
46900,223,283,586,566,526,1092,black
46900,41,68,10,50,69,119,asian
46900,1225,1041,1444,1824,1886,3710,latino
46980,4619,4253,15034,12209,11697,23906,white non-hispanic
46980,8762,8284,14719,17005,14760,31765,black
46980,0,47,221,157,111,268,asian
46980,95,72,148,152,163,315,latino
47020,21641,19536,44483,43416,42244,85660,white non-hispanic
47020,1516,1497,3090,3243,2860,6103,black
47020,196,161,651,550,458,1008,asian
47020,14320,11655,18839,22531,22283,44814,latino
47080,5068,4548,13490,11961,11145,23106,white non-hispanic
47080,2658,2458,4161,5102,4175,9277,black
47080,75,95,105,148,127,275,asian
47080,1486,1021,1220,1744,1983,3727,latino
47180,7500,8518,19539,17570,17987,35557,white non-hispanic
47180,194,646,348,413,775,1188,black
47180,49,112,148,162,147,309,asian
47180,257,218,210,268,417,685,latino
47220,22820,21451,58357,51989,50639,102628,white non-hispanic
47220,6663,8423,14646,13575,16157,29732,black
47220,512,601,968,987,1094,2081,asian
47220,15901,12695,17370,21823,24143,45966,latino
47240,2570,2596,10058,7735,7489,15224,white non-hispanic
47240,170,130,372,459,213,672,black
47240,21,7,25,47,6,53,asian
47240,72,124,84,91,189,280,latino
47260,200044,261952,560953,506799,516150,1022949,white non-hispanic
47260,129790,146001,249872,278670,246993,525663,black
47260,11480,17195,36356,35654,29377,65031,asian
47260,34795,39830,35680,52451,57854,110305,latino
47300,112175,87668,162068,181044,180867,361911,white non-hispanic
47300,2029,1868,3280,3455,3722,7177,black
47300,4241,4094,7746,8314,7767,16081,asian
47300,108575,79485,103807,143503,148364,291867,latino
47340,6400,6184,17909,15646,14847,30493,white non-hispanic
47340,96,118,65,108,171,279,black
47340,21,15,30,37,29,66,asian
47340,290,300,217,340,467,807,latino
47380,46799,54482,100784,102723,99342,202065,white non-hispanic
47380,10642,11236,17881,21653,18106,39759,black
47380,772,1615,1473,1974,1886,3860,asian
47380,23981,19857,23111,33084,33865,66949,latino
47420,4397,4752,12082,10279,10952,21231,white non-hispanic
47420,8,59,44,32,79,111,black
47420,14,15,36,47,18,65,asian
47420,225,127,139,227,264,491,latino
47460,11108,12792,30583,26956,27527,54483,white non-hispanic
47460,71,333,523,191,736,927,black
47460,147,357,523,587,440,1027,asian
47460,4778,3825,4325,6225,6703,12928,latino
47540,10642,8418,25345,22362,22043,44405,white non-hispanic
47540,36,71,56,65,98,163,black
47540,74,55,147,99,177,276,asian
47540,303,189,220,321,391,712,latino
47580,25373,24315,63479,57101,56066,113167,white non-hispanic
47580,15966,17548,27403,33192,27725,60917,black
47580,1147,1155,2553,2673,2182,4855,asian
47580,4390,3541,4399,5864,6466,12330,latino
47620,7649,6839,25000,19708,19780,39488,white non-hispanic
47620,34,73,78,109,76,185,black
47620,58,47,104,110,99,209,asian
47620,144,86,178,187,221,408,latino
47660,10194,16175,21695,23346,24718,48064,white non-hispanic
47660,425,1344,676,1130,1315,2445,black
47660,81,419,304,362,442,804,asian
47660,687,1021,495,900,1303,2203,latino
47700,17456,16053,40433,37440,36502,73942,white non-hispanic
47700,228,154,255,236,401,637,black
47700,102,407,310,383,436,819,asian
47700,2519,1580,2102,2918,3283,6201,latino
47780,8835,6569,15811,15631,15584,31215,white non-hispanic
47780,204,251,148,282,321,603,black
47780,0,0,68,54,14,68,asian
47780,773,383,406,585,977,1562,latino
47820,6023,5419,22242,17354,16330,33684,white non-hispanic
47820,3217,2504,6805,6934,5592,12526,black
47820,42,0,38,34,46,80,asian
47820,1483,901,1191,1758,1817,3575,latino
47900,701036,780178,1841411,1672707,1649918,3322625,white non-hispanic
47900,359242,376622,812010,824033,723841,1547874,black
47900,126093,146454,333144,321629,284062,605691,asian
47900,292673,256737,380751,451335,478826,930161,latino
47920,6217,5293,15431,13747,13194,26941,white non-hispanic
47920,72,78,417,274,293,567,black
47920,94,31,113,158,80,238,asian
47920,222,159,185,263,303,566,latino
47940,29341,39744,79454,75796,72743,148539,white non-hispanic
47940,3832,3427,4870,6433,5696,12129,black
47940,882,1013,1146,1420,1621,3041,asian
47940,2479,1760,1865,3075,3029,6104,latino
47980,6273,5565,14650,13169,13319,26488,white non-hispanic
47980,0,71,70,32,109,141,black
47980,43,29,108,143,37,180,asian
47980,266,155,167,201,387,588,latino
48020,16893,16766,46080,40027,39712,79739,white non-hispanic
48020,161,372,202,301,434,735,black
48020,136,169,265,361,209,570,asian
48020,2376,1525,1990,2829,3062,5891,latino
48060,23456,28104,48841,48578,51823,100401,white non-hispanic
48060,1375,3485,1893,2276,4477,6753,black
48060,516,273,1003,1007,785,1792,asian
48060,2813,3924,1728,3452,5013,8465,latino
48100,5396,5072,11707,10527,11648,22175,white non-hispanic
48100,672,372,1162,817,1389,2206,black
48100,46,0,118,76,88,164,asian
48100,4273,3376,4152,5296,6505,11801,latino
48140,26484,23483,73451,61588,61830,123418,white non-hispanic
48140,404,235,297,383,553,936,black
48140,3073,2519,2106,3773,3925,7698,asian
48140,1547,1080,997,1748,1876,3624,latino
48180,8954,7751,23223,20182,19746,39928,white non-hispanic
48180,3260,3116,5930,6057,6249,12306,black
48180,122,0,312,216,218,434,asian
48180,966,383,1054,805,1598,2403,latino
48220,5540,7109,11041,11921,11769,23690,white non-hispanic
48220,195,400,296,394,497,891,black
48220,84,113,145,230,112,342,asian
48220,2080,1509,1506,2397,2698,5095,latino
48260,20679,21180,70521,57921,54459,112380,white non-hispanic
48260,1054,1134,2682,2509,2361,4870,black
48260,85,111,305,263,238,501,asian
48260,470,468,598,834,702,1536,latino
48300,21002,18368,56603,47852,48121,95973,white non-hispanic
48300,171,63,259,214,279,493,black
48300,229,210,648,731,356,1087,asian
48300,13260,9344,10632,15771,17465,33236,latino
48460,9119,7561,21817,19670,18827,38497,white non-hispanic
48460,22,95,13,59,71,130,black
48460,46,47,95,106,82,188,asian
48460,295,288,240,340,483,823,latino
48500,1479,1351,5118,4184,3764,7948,white non-hispanic
48500,3182,2864,5753,6440,5359,11799,black
48500,23,49,58,29,101,130,asian
48500,79,11,38,76,52,128,latino
48540,25554,26408,83568,69028,66502,135530,white non-hispanic
48540,1084,1439,2359,1619,3263,4882,black
48540,74,146,440,351,309,660,asian
48540,509,391,474,641,733,1374,latino
48580,20035,21988,54339,48284,48078,96362,white non-hispanic
48580,376,481,315,547,625,1172,black
48580,214,268,525,577,430,1007,asian
48580,4442,3114,3817,5353,6020,11373,latino
48620,129307,117022,281045,266621,260753,527374,white non-hispanic
48620,14764,12731,21057,24162,24390,48552,black
48620,5367,6816,11118,12330,10971,23301,asian
48620,32860,22011,25760,39211,41420,80631,latino
48660,25455,31223,64625,59114,62189,121303,white non-hispanic
48660,2970,5055,5729,6137,7617,13754,black
48660,519,934,1427,1412,1468,2880,asian
48660,8634,8129,8978,12003,13738,25741,latino
48700,20406,23371,62434,53937,52274,106211,white non-hispanic
48700,1853,1723,2135,2886,2825,5711,black
48700,188,137,379,414,290,704,asian
48700,889,714,601,1157,1047,2204,latino
48780,6999,7887,13154,12950,15090,28040,white non-hispanic
48780,311,649,170,394,736,1130,black
48780,54,28,136,141,77,218,asian
48780,756,904,346,802,1204,2006,latino
48820,8174,7338,22009,18861,18660,37521,white non-hispanic
48820,893,671,282,781,1065,1846,black
48820,104,133,110,182,165,347,asian
48820,2100,1441,1520,2339,2722,5061,latino
48900,40026,54435,127591,114468,107584,222052,white non-hispanic
48900,9772,9536,20966,21401,18873,40274,black
48900,553,1090,1516,1730,1429,3159,asian
48900,5975,4499,5300,7717,8057,15774,latino
48940,9063,8171,22194,20049,19379,39428,white non-hispanic
48940,151,239,511,375,526,901,black
48940,45,58,65,114,54,168,asian
48940,269,159,236,245,419,664,latino
48980,8122,7486,25771,21678,19701,41379,white non-hispanic
48980,7846,7212,17249,17669,14638,32307,black
48980,75,282,277,300,334,634,asian
48980,3527,2130,2539,3836,4360,8196,latino
49020,26244,24166,70872,60992,60290,121282,white non-hispanic
49020,1415,1401,3537,3027,3326,6353,black
49020,311,464,1035,1030,780,1810,asian
49020,4478,2744,4258,5314,6166,11480,latino
49080,3990,3241,7832,7194,7869,15063,white non-hispanic
49080,0,30,80,15,95,110,black
49080,0,0,43,27,16,43,asian
49080,1683,1115,1722,2172,2348,4520,latino
49100,8287,14964,24508,24167,23592,47759,white non-hispanic
49100,209,399,142,389,361,750,black
49100,319,770,282,694,677,1371,asian
49100,482,500,436,687,731,1418,latino
49180,105274,96503,298555,257646,242686,500332,white non-hispanic
49180,28714,28911,58862,62971,53516,116487,black
49180,2737,2988,5246,5952,5019,10971,asian
49180,28004,16566,21174,32200,33544,65744,latino
49220,14293,12646,42425,35253,34111,69364,white non-hispanic
49220,231,104,149,233,251,484,black
49220,550,463,469,730,752,1482,asian
49220,893,589,572,960,1094,2054,latino
49260,4708,4142,9987,9329,9508,18837,white non-hispanic
49260,1,42,133,19,157,176,black
49260,0,8,31,39,0,39,asian
49260,1037,642,896,1209,1366,2575,latino
49300,26589,23188,60405,55680,54502,110182,white non-hispanic
49300,424,470,716,755,855,1610,black
49300,215,441,482,556,582,1138,asian
49300,790,581,781,945,1207,2152,latino
49340,159149,169337,466331,404656,390161,794817,white non-hispanic
49340,11147,12846,18182,20352,21823,42175,black
49340,9647,11419,19105,20565,19606,40171,asian
49340,33996,29811,37614,50696,50725,101421,latino
49380,4036,3312,9721,8527,8542,17069,white non-hispanic
49380,293,407,248,468,480,948,black
49380,433,401,538,652,720,1372,asian
49380,2333,1816,1714,2769,3094,5863,latino
49420,54869,41801,96914,97130,96454,193584,white non-hispanic
49420,666,673,1071,892,1518,2410,black
49420,621,455,1396,1443,1029,2472,asian
49420,48175,32754,39151,58538,61542,120080,latino
49460,4374,4196,12370,10254,10686,20940,white non-hispanic
49460,51,141,232,62,362,424,black
49460,0,57,93,84,66,150,asian
49460,301,215,325,295,546,841,latino
49620,81483,78104,233678,199496,193769,393265,white non-hispanic
49620,7389,6223,11481,12328,12765,25093,black
49620,1563,1587,3267,3434,2983,6417,asian
49620,11729,8804,10110,14805,15838,30643,latino
49660,88587,88449,292515,240265,229286,469551,white non-hispanic
49660,15722,14495,28618,30823,28012,58835,black
49660,813,1017,1863,1970,1723,3693,asian
49660,5939,4984,6972,8077,9818,17895,latino
49700,30966,28186,62660,61117,60695,121812,white non-hispanic
49700,1092,1138,2224,1950,2504,4454,black
49700,4503,5245,9640,9760,9628,19388,asian
49700,18291,13533,17565,24109,25280,49389,latino
49740,36155,34542,78609,73472,75834,149306,white non-hispanic
49740,758,1652,1857,1545,2722,4267,black
49740,432,769,1461,1366,1296,2662,asian
49740,41758,36356,50351,63634,64831,128465,latino
49780,17511,16297,45349,40872,38285,79157,white non-hispanic
49780,420,791,1462,1178,1495,2673,black
49780,30,174,137,208,133,341,asian
49780,341,218,322,381,500,881,latino
49820,4689,3169,5823,6847,6834,13681,white non-hispanic
49820,20,52,50,79,43,122,black
49820,73,0,29,52,50,102,asian
49820,4728,3284,5548,6784,6776,13560,latino
